   ,合约,日期,前收盘价,前结算价,开盘价,最高价,最低价,收盘价,结算价,涨跌1,涨跌2,成交量,成交金额,持仓量
1,y1001,20100104,7700,7690,7750,7840,7750,7840,7788,150,98,60,467.38,4888
2,y1001,20100105,7840,7788,0,0,0,7788,7788,0,0,0,0,4888
3,y1001,20100106,7788,7788,7850,7850,7850,7850,7850,62,62,22,172.7,4888
4,y1001,20100107,7850,7850,8010,8010,7650,7650,7696,-200,-154,386,2971.14,4514
5,y1001,20100108,7650,7696,7240,7650,7240,7650,7648,-46,-48,568,4344.38,4514
6,y1001,20100111,7650,7648,0,0,0,7648,7648,0,0,0,0,4254
7,y1001,20100112,7648,7648,7734,7750,7600,7600,7712,-48,64,74,570.75,4198
8,y1001,20100113,7600,7712,0,0,0,7712,7712,0,0,0,0,4198
9,y1001,20100114,7712,7712,0,0,0,7712,7712,0,0,0,0,4198
10,y1001,20100115,7712,7712,0,0,0,7712,7680,0,-32,0,0,0
11,y1003,20100104,7700,7668,7722,7752,7720,7752,7742,84,74,48,371.64,726
12,y1003,20100105,7752,7742,7762,7766,7680,7740,7746,-2,4,162,1255.03,726
13,y1003,20100106,7740,7746,7680,7792,7680,7774,7770,28,24,72,559.56,726
14,y1003,20100107,7774,7770,7810,7828,7466,7600,7582,-170,-188,520,3943.23,346
15,y1003,20100108,7600,7582,7552,7666,7430,7636,7588,54,6,158,1199.07,302
16,y1003,20100111,7636,7588,7654,7692,7626,7664,7650,76,62,62,474.34,250
17,y1003,20100112,7664,7650,7504,7602,7450,7600,7556,-50,-94,142,1073.21,238
18,y1003,20100113,7600,7556,7400,7450,7366,7366,7414,-190,-142,78,578.44,222
19,y1003,20100114,7366,7414,7430,7572,7430,7496,7516,82,102,92,691.52,206
20,y1003,20100115,7496,7516,7500,7500,7434,7478,7478,-38,-38,18,134.6,206
21,y1003,20100118,7478,7478,7382,7448,7380,7448,7410,-30,-68,22,163.04,206
22,y1003,20100119,7448,7410,7456,7506,7332,7362,7392,-48,-18,342,2528.39,248
23,y1003,20100120,7362,7392,7388,7388,7260,7266,7302,-126,-90,48,350.5,238
24,y1003,20100121,7266,7302,7234,7340,7232,7262,7268,-40,-34,28,203.51,226
25,y1003,20100122,7262,7268,7180,7558,6978,7320,7224,52,-44,138,997.1,222
26,y1003,20100125,7320,7224,7250,7250,7250,7250,7250,26,26,6,43.5,216
27,y1003,20100126,7250,7250,0,0,0,7250,7250,0,0,0,0,216
28,y1003,20100127,7250,7250,7200,7218,7176,7218,7198,-32,-52,8,57.59,212
29,y1003,20100128,7218,7198,7102,7130,7102,7130,7116,-68,-82,4,28.46,208
30,y1003,20100129,7130,7116,0,0,0,7116,7116,0,0,0,0,208
31,y1003,20100201,7116,7116,7020,7020,6950,6950,7000,-166,-116,14,98,194
32,y1003,20100202,6950,7000,6990,6990,6990,6990,6990,-10,-10,12,83.88,188
33,y1003,20100203,6990,6990,6990,7142,6990,7040,7048,50,58,14,98.69,188
34,y1003,20100204,7040,7048,7130,7130,6774,6966,6958,-82,-90,18,125.27,178
35,y1003,20100205,6966,6958,6884,6960,6884,6950,6930,-8,-28,26,180.22,168
36,y1003,20100208,6950,6930,0,0,0,6930,6930,0,0,0,0,168
37,y1003,20100209,6930,6930,6996,7110,6990,7110,7050,180,120,66,465.38,152
38,y1003,20100210,7110,7050,7104,7104,7082,7082,7092,32,42,4,28.37,150
39,y1003,20100211,7082,7092,6964,7196,6964,7122,7054,30,-38,42,296.32,150
40,y1003,20100212,7122,7054,0,0,0,7054,7054,0,0,0,0,150
41,y1003,20100222,7054,7054,7050,7230,7050,7202,7206,148,152,32,230.62,120
42,y1003,20100223,7202,7206,0,0,0,7206,7206,0,0,0,0,120
43,y1003,20100224,7206,7206,0,0,0,7206,7206,0,0,0,0,120
44,y1003,20100225,7206,7206,7150,7150,7150,7150,7150,-56,-56,2,14.3,120
45,y1003,20100226,7150,7150,7150,7160,7002,7100,7112,-50,-38,10,71.12,120
46,y1003,20100301,7100,7112,7152,7152,7152,7152,7152,40,40,4,28.61,120
47,y1003,20100302,7152,7152,0,0,0,7152,7152,0,0,0,0,120
48,y1003,20100303,7152,7152,0,0,0,7152,7152,0,0,0,0,120
49,y1003,20100304,7152,7152,0,0,0,7152,7152,0,0,0,0,100
50,y1003,20100305,7152,7152,7250,7250,7250,7250,7250,98,98,100,725,100
51,y1003,20100308,7250,7250,0,0,0,7250,7250,0,0,0,0,100
52,y1003,20100309,7250,7250,0,0,0,7250,7250,0,0,0,0,100
53,y1003,20100310,7250,7250,0,0,0,7250,7250,0,0,0,0,100
54,y1003,20100311,7250,7250,0,0,0,7250,7250,0,0,0,0,100
55,y1003,20100312,7250,7250,0,0,0,7250,7246,0,-4,0,0,0
56,y1005,20100104,7838,7796,7858,7932,7858,7902,7892,106,96,25838,203930.89,59476
57,y1005,20100105,7902,7892,7938,7946,7880,7888,7908,-4,16,16926,133851.9,58078
58,y1005,20100106,7888,7908,7900,7988,7864,7940,7940,32,32,26240,208384.88,53778
59,y1005,20100107,7940,7940,7958,8018,7624,7712,7778,-228,-162,38864,302288.01,55016
60,y1005,20100108,7712,7778,7710,7728,7534,7638,7630,-140,-148,24596,187697.03,50726
61,y1005,20100111,7638,7630,7698,7752,7672,7690,7714,60,84,35048,270404.63,52894
62,y1005,20100112,7690,7714,7656,7656,7570,7612,7594,-102,-120,35936,272945.44,53298
63,y1005,20100113,7612,7594,7450,7450,7334,7376,7394,-218,-200,13446,99422.39,50874
64,y1005,20100114,7376,7394,7428,7480,7420,7442,7456,48,62,16192,120752.96,47896
65,y1005,20100115,7442,7456,7408,7462,7362,7408,7408,-48,-48,12210,90468.72,47136
66,y1005,20100118,7408,7408,7400,7400,7270,7352,7314,-56,-94,22750,166393.98,45672
67,y1005,20100119,7352,7314,7376,7422,7358,7382,7388,68,74,9022,66671.46,45018
68,y1005,20100120,7382,7388,7370,7408,7258,7258,7320,-130,-68,12184,89195.88,45122
69,y1005,20100121,7258,7320,7298,7336,7222,7332,7278,12,-42,12092,88025.29,43168
70,y1005,20100122,7332,7278,7278,7366,7180,7320,7276,42,-2,16260,118339.06,41648
71,y1005,20100125,7320,7276,7350,7350,7290,7316,7316,40,40,7998,58526.92,41268
72,y1005,20100126,7316,7316,7300,7316,7206,7212,7260,-104,-56,9078,65920.67,41064
73,y1005,20100127,7212,7260,7250,7280,7218,7270,7250,10,-10,7490,54311.4,40374
74,y1005,20100128,7270,7250,7198,7218,7136,7174,7176,-76,-74,11562,82983.18,42052
75,y1005,20100129,7174,7176,7174,7232,7128,7130,7186,-46,10,11314,81323.31,37504
76,y1005,20100201,7130,7186,7150,7154,7030,7032,7068,-154,-118,11696,82681.51,37846
77,y1005,20100202,7032,7068,7150,7150,7008,7048,7050,-20,-18,9908,69860.31,37320
78,y1005,20100203,7048,7050,7166,7180,7108,7166,7142,116,92,7226,51619.15,36426
79,y1005,20100204,7166,7142,7112,7138,7074,7114,7102,-28,-40,4008,28469.71,36252
80,y1005,20100205,7114,7102,7088,7158,7062,7134,7116,32,14,4222,30050.95,35510
81,y1005,20100208,7134,7116,7168,7240,7168,7238,7212,122,96,6354,45831.29,35694
82,y1005,20100209,7238,7212,7250,7274,7226,7270,7252,58,40,4208,30522.28,35444
83,y1005,20100210,7270,7252,7250,7346,7220,7280,7280,28,28,4414,32140.46,34924
84,y1005,20100211,7280,7280,7318,7358,7278,7290,7322,10,42,5814,42579.88,32510
85,y1005,20100212,7290,7322,7270,7300,7248,7272,7270,-50,-52,1584,11516.66,31940
86,y1005,20100222,7272,7270,7376,7402,7326,7370,7360,100,90,4654,34262.74,31212
87,y1005,20100223,7370,7360,7370,7426,7350,7418,7386,58,26,13630,100695.54,32858
88,y1005,20100224,7418,7386,7390,7390,7340,7368,7370,-18,-16,1582,11661.73,32762
89,y1005,20100225,7368,7370,7398,7422,7308,7330,7362,-40,-8,1734,12769.15,32632
90,y1005,20100226,7330,7362,7338,7348,7310,7320,7330,-42,-32,1060,7771.76,32386
91,y1005,20100301,7320,7330,7350,7430,7346,7352,7374,22,44,2010,14824.66,32122
92,y1005,20100302,7352,7374,7350,7386,7326,7326,7352,-48,-22,1724,12677.59,32170
93,y1005,20100303,7326,7352,7362,7390,7350,7374,7374,22,22,986,7271.32,32108
94,y1005,20100304,7374,7374,7374,7386,7312,7324,7344,-50,-30,1688,12399.01,31236
95,y1005,20100305,7324,7344,7286,7386,7282,7378,7358,34,14,2056,15129.38,29880
96,y1005,20100308,7378,7358,7380,7404,7350,7400,7386,42,28,3188,23548.54,28048
97,y1005,20100309,7400,7386,7386,7442,7378,7438,7408,52,22,3252,24096.38,25830
98,y1005,20100310,7438,7408,7438,7464,7408,7436,7448,28,40,2666,19859.15,24172
99,y1005,20100311,7436,7448,7460,7498,7348,7384,7430,-64,-18,2002,14878.49,23798
100,y1005,20100312,7384,7430,7380,7386,7336,7338,7352,-92,-78,558,4103.36,23598
101,y1005,20100315,7338,7352,7352,7400,7288,7298,7306,-54,-46,1608,11750.38,23524
102,y1005,20100316,7298,7306,7280,7330,7258,7330,7292,24,-14,3038,22157.88,22324
103,y1005,20100317,7330,7292,7330,7370,7328,7336,7346,44,54,2146,15764.96,21242
104,y1005,20100318,7336,7346,7346,7346,7294,7306,7310,-40,-36,1308,9561.75,20626
105,y1005,20100319,7306,7310,7318,7338,7290,7328,7322,18,12,1010,7395.99,20098
106,y1005,20100322,7328,7322,7328,7368,7308,7312,7326,-10,4,2326,17041.12,21018
107,y1005,20100323,7312,7326,7336,7348,7308,7318,7324,-8,-2,574,4204.31,21130
108,y1005,20100324,7318,7324,7326,7332,7112,7310,7296,-14,-28,1170,8538.53,21314
109,y1005,20100325,7310,7296,7310,7360,7306,7318,7340,22,44,1742,12788.1,21150
110,y1005,20100326,7318,7340,7262,7298,7260,7276,7284,-64,-56,816,5944.11,20822
111,y1005,20100329,7276,7284,7276,7298,7264,7268,7274,-16,-10,1340,9749.07,20768
112,y1005,20100330,7268,7274,7288,7364,7262,7336,7312,62,38,2730,19964.83,20758
113,y1005,20100331,7336,7312,7320,7398,7320,7370,7376,58,64,1902,14032.78,19738
114,y1005,20100401,7370,7376,7370,7370,7320,7324,7334,-52,-42,174,1276.38,19726
115,y1005,20100402,7324,7334,7326,7364,7326,7340,7350,6,16,3656,26878.65,16848
116,y1005,20100406,7340,7350,7342,7366,7330,7354,7350,4,0,2062,15157.85,15530
117,y1005,20100407,7354,7350,7354,7468,7354,7448,7438,98,88,2174,16173.99,14276
118,y1005,20100408,7448,7438,7426,7470,7426,7456,7456,18,18,942,7023.96,13514
119,y1005,20100409,7456,7456,7470,7502,7466,7500,7482,44,26,920,6883.53,12828
120,y1005,20100412,7500,7482,7530,7530,7484,7498,7500,16,18,400,3000.05,12794
121,y1005,20100413,7498,7500,7448,7468,7444,7460,7458,-40,-42,54,402.74,12782
122,y1005,20100414,7460,7458,7470,7490,7462,7462,7472,4,14,422,3153.32,12756
123,y1005,20100415,7462,7472,7470,7470,7448,7468,7468,-4,-4,2434,18180.66,12656
124,y1005,20100416,7468,7468,7466,7498,7452,7498,7468,30,0,4498,33591.24,12258
125,y1005,20100419,7498,7468,7466,7466,7370,7382,7426,-86,-42,322,2391.26,11976
126,y1005,20100420,7382,7426,7464,7464,7362,7386,7384,-40,-42,528,3899.34,12372
127,y1005,20100421,7386,7384,7388,7396,7384,7396,7390,12,6,120,886.9,12372
128,y1005,20100422,7396,7390,7388,7416,7374,7400,7388,10,-2,1052,7772.56,11876
129,y1005,20100423,7400,7388,7400,7446,7400,7446,7424,58,36,312,2316.68,11866
130,y1005,20100426,7446,7424,7460,7466,7442,7466,7456,42,32,142,1058.86,11856
131,y1005,20100427,7466,7456,7402,7472,7402,7468,7432,12,-24,2300,17095.41,11860
132,y1005,20100428,7468,7432,7400,7414,7380,7414,7386,-18,-46,128,945.49,11774
133,y1005,20100429,7414,7386,7390,7410,7376,7394,7388,8,2,4374,32323.08,8478
134,y1005,20100430,7394,7388,7388,7670,7360,7670,7402,282,14,306,2265.01,8412
135,y1005,20100504,7670,7402,7080,7420,7080,7420,7250,18,-152,4,29,4
136,y1005,20100505,7420,7250,0,0,0,7250,7250,0,0,0,0,4
137,y1005,20100506,7250,7250,0,0,0,7250,7250,0,0,0,0,4
138,y1005,20100507,7250,7250,0,0,0,7250,7250,0,0,0,0,4
139,y1005,20100510,7250,7250,0,0,0,7250,7250,0,0,0,0,4
140,y1005,20100511,7250,7250,0,0,0,7250,7250,0,0,0,0,4
141,y1005,20100512,7250,7250,0,0,0,7250,7250,0,0,0,0,4
142,y1005,20100513,7250,7250,0,0,0,7250,7250,0,0,0,0,4
143,y1005,20100514,7250,7250,0,0,0,7250,7250,0,0,0,0,4
144,y1005,20100517,7250,7250,0,0,0,7250,7250,0,0,0,0,0
145,y1007,20100104,7830,7816,8096,8096,7844,7962,7958,146,142,108,859.59,382
146,y1007,20100105,7962,7958,8010,8010,7944,7950,7972,-8,14,36,287.06,382
147,y1007,20100106,7950,7972,7950,8030,7888,8014,7940,42,-32,284,2254.98,402
148,y1007,20100107,8014,7940,8000,8040,7700,7748,7798,-192,-142,128,998.22,336
149,y1007,20100108,7748,7798,7688,7700,7556,7678,7642,-120,-156,44,336.28,342
150,y1007,20100111,7678,7642,7750,7750,7702,7720,7726,78,84,16,123.64,342
151,y1007,20100112,7720,7726,7660,7660,7594,7620,7622,-106,-104,192,1463.7,318
152,y1007,20100113,7620,7622,7502,7502,7392,7392,7436,-230,-186,14,104.12,320
153,y1007,20100114,7392,7436,7404,7488,7404,7488,7466,52,30,20,149.33,320
154,y1007,20100115,7488,7466,7406,7406,7406,7406,7406,-60,-60,4,29.62,320
155,y1007,20100118,7406,7406,7396,7400,7360,7360,7360,-46,-46,324,2384.79,640
156,y1007,20100119,7360,7360,7410,7410,7360,7396,7388,36,28,10,73.89,640
157,y1007,20100120,7396,7388,7388,7388,7282,7282,7342,-106,-46,10,73.44,638
158,y1007,20100121,7282,7342,7322,7330,7322,7330,7326,-12,-16,4,29.3,638
159,y1007,20100122,7330,7326,7398,7398,7218,7368,7320,42,-6,110,805.36,652
160,y1007,20100125,7368,7320,7318,7396,7318,7382,7360,62,40,1666,12261.91,2314
161,y1007,20100126,7382,7360,7310,7310,7310,7310,7310,-50,-50,2,14.62,2314
162,y1007,20100127,7310,7310,7280,7290,7228,7282,7278,-28,-32,334,2431.04,2194
163,y1007,20100128,7282,7278,7160,7218,7160,7218,7188,-60,-90,4,28.76,2194
164,y1007,20100129,7218,7188,7236,7236,7164,7164,7206,-24,18,6,43.24,2194
165,y1007,20100201,7164,7206,7082,7142,7078,7078,7088,-128,-118,26,184.3,2196
166,y1007,20100202,7078,7088,7202,7202,7080,7090,7120,2,32,10,71.2,2202
167,y1007,20100203,7090,7120,7208,7260,7154,7260,7226,140,106,38,274.61,2218
168,y1007,20100204,7260,7226,7126,7148,7126,7148,7132,-78,-94,6,42.8,2214
169,y1007,20100205,7148,7132,7150,7178,7150,7170,7156,38,24,546,3907.54,1852
170,y1007,20100208,7170,7156,7330,7330,7234,7252,7260,96,104,10,72.62,1852
171,y1007,20100209,7252,7260,7252,7280,7252,7280,7262,20,2,38,275.98,1844
172,y1007,20100210,7280,7262,7272,7304,7248,7248,7280,-14,18,40,291.24,1840
173,y1007,20100211,7248,7280,7340,7358,7302,7302,7320,22,40,254,1859.34,1592
174,y1007,20100212,7302,7320,7300,7320,7272,7290,7292,-30,-28,82,598.03,1518
175,y1007,20100222,7290,7292,7398,7414,7352,7374,7388,82,96,18,133,1518
176,y1007,20100223,7374,7388,7438,7442,7430,7432,7396,44,8,3020,22337.72,1518
177,y1007,20100224,7432,7396,7392,7400,7392,7400,7396,4,0,804,5947.18,1520
178,y1007,20100225,7400,7396,7390,7390,7332,7376,7348,-20,-48,26,191.08,1516
179,y1007,20100226,7376,7348,7350,7350,7332,7332,7340,-16,-8,4,29.36,1516
180,y1007,20100301,7332,7340,7428,7428,7390,7390,7408,50,68,4,29.64,1516
181,y1007,20100302,7390,7408,7364,7364,7364,7364,7364,-44,-44,6,44.18,1518
182,y1007,20100303,7364,7364,7388,7388,7388,7388,7388,24,24,2,14.78,1518
183,y1007,20100304,7388,7388,7446,7446,7316,7386,7380,-2,-8,14,103.34,1516
184,y1007,20100305,7386,7380,7290,7410,7290,7400,7368,20,-12,10,73.68,1516
185,y1007,20100308,7400,7368,7420,7448,7420,7448,7438,80,70,6,44.63,1516
186,y1007,20100309,7448,7438,7440,7468,7440,7468,7452,30,14,10,74.53,1516
187,y1007,20100310,7468,7452,7460,7488,7456,7470,7468,18,16,248,1852.53,1518
188,y1007,20100311,7470,7468,7480,7480,7398,7400,7410,-68,-58,732,5424.26,1518
189,y1007,20100312,7400,7410,7428,7428,7354,7402,7378,-8,-32,368,2715.24,1518
190,y1007,20100315,7402,7378,7350,7350,7320,7320,7342,-58,-36,480,3524.4,1518
191,y1007,20100316,7320,7342,7320,7350,7320,7342,7340,0,-2,1460,10717.51,1506
192,y1007,20100317,7342,7340,7490,7490,7374,7400,7442,60,102,22,163.72,1512
193,y1007,20100318,7400,7442,7380,7380,7336,7342,7348,-100,-94,20,146.99,1508
194,y1007,20100319,7342,7348,7350,7362,7350,7362,7356,14,8,12,88.27,1502
195,y1007,20100322,7362,7356,7370,7378,7370,7378,7358,22,2,6008,44210.19,1498
196,y1007,20100323,7378,7358,0,0,0,7358,7356,0,-2,7500,55179.45,1498
197,y1007,20100324,7358,7356,0,0,0,7356,7356,0,0,0,0,1498
198,y1007,20100325,7356,7356,7370,7402,7370,7402,7392,46,36,8,59.14,1498
199,y1007,20100326,7402,7392,7358,7358,7358,7358,7358,-34,-34,2,14.72,1498
200,y1007,20100329,7358,7358,7356,7356,7356,7356,7356,-2,-2,4,29.42,1498
201,y1007,20100330,7356,7356,7350,7458,7350,7450,7410,94,54,10,74.11,1498
202,y1007,20100331,7450,7410,7456,7482,7456,7480,7472,70,62,12,89.68,1498
203,y1007,20100401,7480,7472,0,0,0,7472,7472,0,0,0,0,1498
204,y1007,20100402,7472,7472,0,0,0,7472,7472,0,0,0,0,1498
205,y1007,20100406,7472,7472,7588,7588,7432,7476,7508,4,36,20,150.2,1498
206,y1007,20100407,7476,7508,7536,7576,7502,7554,7548,46,40,98,739.84,1504
207,y1007,20100408,7554,7548,7562,7562,7562,7562,7562,14,14,10,75.62,1504
208,y1007,20100409,7562,7562,7576,7608,7548,7578,7576,16,14,62,469.71,1486
209,y1007,20100412,7578,7576,7666,7666,7594,7602,7616,26,40,22,167.59,1482
210,y1007,20100413,7602,7616,7560,7580,7552,7560,7560,-56,-56,270,2041.46,1232
211,y1007,20100414,7560,7560,7582,7582,7564,7582,7576,22,16,18,136.37,1230
212,y1007,20100415,7582,7576,0,0,0,7576,7576,0,0,0,0,1230
213,y1007,20100416,7576,7576,0,0,0,7576,7576,0,0,0,0,1230
214,y1007,20100419,7576,7576,7520,7520,7520,7520,7520,-56,-56,2,15.04,1232
215,y1007,20100420,7520,7520,7464,7504,7462,7466,7466,-54,-54,22,164.29,1232
216,y1007,20100421,7466,7466,7470,7496,7470,7496,7478,30,12,6,44.87,1232
217,y1007,20100422,7496,7478,7484,7502,7484,7502,7496,24,18,16,119.96,1230
218,y1007,20100423,7502,7496,7524,7524,7524,7524,7524,28,28,2,15.05,1230
219,y1007,20100426,7524,7524,7618,7618,7618,7618,7618,94,94,4,30.47,1230
220,y1007,20100427,7618,7618,7504,7552,7504,7552,7528,-66,-90,4,30.11,1230
221,y1007,20100428,7552,7528,7552,7636,7478,7486,7548,-42,20,66,498.28,1220
222,y1007,20100429,7486,7548,7442,7460,7442,7456,7450,-92,-98,40,298.06,1206
223,y1007,20100430,7456,7450,7482,7482,7482,7482,7482,32,32,2,14.96,1206
224,y1007,20100504,7482,7482,0,0,0,7482,7482,0,0,0,0,1206
225,y1007,20100505,7482,7482,0,0,0,7482,7482,0,0,0,0,1206
226,y1007,20100506,7482,7482,7450,7450,7430,7430,7442,-52,-40,6,44.66,1202
227,y1007,20100507,7430,7442,7302,7302,7302,7302,7302,-140,-140,2,14.6,1200
228,y1007,20100510,7302,7302,0,0,0,7302,7302,0,0,0,0,1200
229,y1007,20100511,7302,7302,0,0,0,7302,7302,0,0,0,0,1200
230,y1007,20100512,7302,7302,7396,7396,7380,7380,7388,78,86,4,29.55,1198
231,y1007,20100513,7380,7388,0,0,0,7388,7388,0,0,0,0,1198
232,y1007,20100514,7388,7388,7386,7386,7358,7368,7366,-20,-22,34,250.49,1170
233,y1007,20100517,7368,7366,7280,7280,7190,7224,7230,-142,-136,6,43.39,1168
234,y1007,20100518,7224,7230,7258,7258,7240,7240,7248,10,18,36,260.93,1148
235,y1007,20100519,7240,7248,7222,7222,7146,7188,7196,-60,-52,88,633.4,1168
236,y1007,20100520,7188,7196,7286,7286,7286,7286,7286,90,90,4,29.14,1164
237,y1007,20100521,7286,7286,7258,7270,7258,7270,7262,-16,-24,6,43.57,1158
238,y1007,20100524,7270,7262,7222,7286,7210,7276,7262,14,0,24,174.31,1150
239,y1007,20100525,7276,7262,0,0,0,7262,7262,0,0,0,0,1150
240,y1007,20100526,7262,7262,0,0,0,7262,7262,0,0,0,0,1150
241,y1007,20100527,7262,7262,7230,7250,7230,7250,7240,-12,-22,10,72.4,1140
242,y1007,20100528,7250,7240,7222,7222,7220,7220,7220,-20,-20,28,202.18,1158
243,y1007,20100531,7220,7220,7178,7178,7134,7176,7170,-44,-50,16,114.74,1144
244,y1007,20100601,7176,7170,7120,7142,7120,7142,7140,-28,-30,984,7027.68,164
245,y1007,20100602,7142,7140,0,0,0,7140,7140,0,0,0,0,164
246,y1007,20100603,7140,7140,7162,7202,7162,7202,7188,62,48,20,143.77,148
247,y1007,20100604,7202,7188,7226,7270,7226,7250,7254,62,66,16,116.06,132
248,y1007,20100607,7250,7254,0,0,0,7254,7254,0,0,0,0,132
249,y1007,20100608,7254,7254,0,0,0,7254,7254,0,0,0,0,132
250,y1007,20100609,7254,7254,7188,7188,7014,7188,7138,-66,-116,100,713.84,142
251,y1007,20100610,7188,7138,0,0,0,7138,7138,0,0,0,0,142
252,y1007,20100611,7138,7138,6830,7200,6830,7198,7138,60,0,16,114.22,136
253,y1007,20100617,7198,7138,7182,7300,7182,7300,7290,162,152,38,277.08,106
254,y1007,20100618,7300,7290,0,0,0,7290,7290,0,0,0,0,106
255,y1007,20100621,7290,7290,0,0,0,7290,7304,0,14,16,116.88,106
256,y1007,20100622,7290,7304,7268,7368,7268,7368,7318,64,14,4,29.27,104
257,y1007,20100623,7368,7318,7350,7368,7250,7250,7268,-68,-50,64,465.21,100
258,y1007,20100624,7250,7268,7282,7282,7282,7282,7282,14,14,40,291.28,100
259,y1007,20100625,7282,7282,0,0,0,7282,7282,0,0,0,0,100
260,y1007,20100628,7282,7282,7000,7000,7000,7000,7000,-282,-282,2,14,100
261,y1007,20100629,7000,7000,7120,7120,7074,7074,7108,74,108,8,56.87,98
262,y1007,20100630,7074,7108,7106,7136,7106,7136,7106,28,-2,64,454.84,96
263,y1007,20100701,7136,7106,7002,7002,7002,7002,7002,-104,-104,28,196.06,58
264,y1007,20100702,7002,7002,0,0,0,7002,7002,0,0,0,0,58
265,y1007,20100705,7002,7002,0,0,0,7002,7002,0,0,0,0,58
266,y1007,20100706,7002,7002,0,0,0,7002,7002,0,0,0,0,58
267,y1007,20100707,7002,7002,0,0,0,7002,7002,0,0,0,0,58
268,y1007,20100708,7002,7002,0,0,0,7002,7002,0,0,0,0,58
269,y1007,20100709,7002,7002,0,0,0,7002,7002,0,0,0,0,58
270,y1007,20100712,7002,7002,0,0,0,7002,7002,0,0,0,0,58
271,y1007,20100713,7002,7002,0,0,0,7002,7002,0,0,0,0,58
272,y1007,20100714,7002,7002,0,0,0,7002,7002,0,0,0,0,0
273,y1008,20100104,7956,7904,8002,8082,8002,8044,8042,140,138,6,48.26,74
274,y1008,20100105,8044,8042,8068,8068,8068,8068,8068,26,26,2,16.14,76
275,y1008,20100106,8068,8068,8088,8088,8088,8088,8088,20,20,2,16.18,74
276,y1008,20100107,8088,8088,8146,8146,7802,7860,7968,-228,-120,106,844.72,114
277,y1008,20100108,7860,7968,7834,7858,7708,7828,7772,-140,-196,34,264.31,120
278,y1008,20100111,7828,7772,7844,7898,7822,7850,7852,78,80,8,62.83,118
279,y1008,20100112,7850,7852,7720,7790,7692,7746,7742,-106,-110,46,356.2,122
280,y1008,20100113,7746,7742,7572,7608,7510,7558,7564,-184,-178,28,211.82,130
281,y1008,20100114,7558,7564,7602,7602,7602,7602,7602,38,38,4,30.41,130
282,y1008,20100115,7602,7602,7488,7548,7488,7548,7518,-54,-84,52,390.94,130
283,y1008,20100118,7548,7518,7402,7502,7402,7502,7460,-16,-58,10,74.6,130
284,y1008,20100119,7502,7460,7520,7556,7482,7500,7506,40,46,24,180.17,128
285,y1008,20100120,7500,7506,7482,7554,7406,7408,7448,-98,-58,38,283.03,140
286,y1008,20100121,7408,7448,7388,7450,7388,7450,7426,2,-22,16,118.83,130
287,y1008,20100122,7450,7426,7452,7512,7372,7484,7436,58,10,76,565.15,100
288,y1008,20100125,7484,7436,7568,7568,7432,7498,7490,62,54,80,599.21,100
289,y1008,20100126,7498,7490,7448,7448,7360,7360,7382,-130,-108,14,103.37,102
290,y1008,20100127,7360,7382,7418,7436,7388,7426,7402,44,20,26,192.47,100
291,y1008,20100128,7426,7402,7398,7398,7330,7374,7354,-28,-48,18,132.4,100
292,y1008,20100129,7374,7354,7372,7372,7322,7352,7346,-2,-8,36,264.49,104
293,y1008,20100201,7352,7346,7278,7278,7234,7234,7256,-112,-90,4,29.02,104
294,y1008,20100202,7234,7256,7248,7248,7248,7248,7248,-8,-8,2,14.5,102
295,y1008,20100203,7248,7248,7288,7378,7288,7378,7312,130,64,16,117.02,100
296,y1008,20100204,7378,7312,7324,7324,7244,7250,7256,-62,-56,124,899.75,180
297,y1008,20100205,7250,7256,7278,7324,7266,7324,7278,68,22,172,1252.14,296
298,y1008,20100208,7324,7278,7406,7406,7334,7402,7352,124,74,594,4368.07,826
299,y1008,20100209,7402,7352,7390,7390,7388,7388,7388,36,36,68,502.39,890
300,y1008,20100210,7388,7388,7410,7474,7380,7420,7422,32,34,190,1410.36,966
301,y1008,20100211,7420,7422,7516,7516,7426,7474,7478,52,56,112,837.57,884
302,y1008,20100212,7474,7478,7460,7460,7394,7410,7416,-68,-62,22,163.19,864
303,y1008,20100222,7410,7416,7518,7538,7512,7536,7522,120,106,42,316,872
304,y1008,20100223,7536,7522,7548,7580,7548,7580,7558,58,36,16,120.94,864
305,y1008,20100224,7580,7558,7530,7530,7512,7530,7524,-28,-34,56,421.45,862
306,y1008,20100225,7530,7524,7516,7516,7460,7460,7460,-64,-64,374,2790.56,1236
307,y1008,20100226,7460,7460,0,0,0,7460,7460,0,0,0,0,1236
308,y1008,20100301,7460,7460,7518,7564,7514,7514,7548,54,88,20,151,1234
309,y1008,20100302,7514,7548,7540,7540,7540,7540,7540,-8,-8,2,15.08,1234
310,y1008,20100303,7540,7540,0,0,0,7540,7540,0,0,0,0,1234
311,y1008,20100304,7540,7540,7460,7460,7460,7460,7460,-80,-80,6,44.76,1238
312,y1008,20100305,7460,7460,7494,7500,7494,7500,7494,40,34,8,59.96,1238
313,y1008,20100308,7500,7494,0,0,0,7494,7494,0,0,0,0,1238
314,y1008,20100309,7494,7494,7546,7564,7546,7564,7558,70,64,6,45.35,1236
315,y1008,20100310,7564,7558,7606,7612,7590,7598,7598,40,40,152,1154.92,1256
316,y1008,20100311,7598,7598,7630,7630,7550,7576,7594,-22,-4,44,334.18,1266
317,y1008,20100312,7576,7594,7514,7532,7498,7522,7520,-72,-74,1366,10273.62,1258
318,y1008,20100315,7522,7520,7450,7450,7420,7420,7424,-100,-96,332,2465.36,1490
319,y1008,20100316,7420,7424,7378,7420,7306,7420,7368,-4,-56,1090,8031.68,1478
320,y1008,20100317,7420,7368,7450,7460,7450,7460,7454,92,86,4,29.82,1474
321,y1008,20100318,7460,7454,7410,7410,7382,7382,7406,-72,-48,680,5036.74,2060
322,y1008,20100319,7382,7406,7400,7610,7388,7442,7406,36,0,130,962.9,2126
323,y1008,20100322,7442,7406,7424,7464,7424,7448,7444,42,38,322,2397.3,1960
324,y1008,20100323,7448,7444,7460,7522,7460,7522,7492,78,48,22,164.86,1958
325,y1008,20100324,7522,7492,7484,7484,7422,7422,7452,-70,-40,4,29.81,1958
326,y1008,20100325,7422,7452,7496,7496,7454,7496,7484,44,32,8,59.88,1958
327,y1008,20100326,7496,7484,7362,7420,7362,7420,7390,-64,-94,4,29.56,1958
328,y1008,20100329,7420,7390,7482,7482,7446,7446,7464,56,74,4,29.86,1958
329,y1008,20100330,7446,7464,7468,7578,7448,7504,7530,40,66,62,466.87,1958
330,y1008,20100331,7504,7530,7312,7598,7312,7584,7556,54,26,178,1345.05,1884
331,y1008,20100401,7584,7556,7460,7530,7460,7530,7498,-26,-58,6,44.99,1882
332,y1008,20100402,7530,7498,7528,7550,7520,7520,7530,22,32,8,60.25,1876
333,y1008,20100406,7520,7530,7550,7550,7550,7550,7550,20,20,6,45.3,1876
334,y1008,20100407,7550,7550,7560,7684,7560,7684,7608,134,58,10,76.1,1876
335,y1008,20100408,7684,7608,7642,7642,7642,7642,7642,34,34,2,15.28,1876
336,y1008,20100409,7642,7642,7664,7708,7664,7708,7686,66,44,12,92.23,1876
337,y1008,20100412,7708,7686,7694,7702,7688,7692,7692,6,6,116,892.4,1804
338,y1008,20100413,7692,7692,7716,7716,7642,7642,7694,-50,2,36,277.02,1820
339,y1008,20100414,7642,7694,0,0,0,7694,7694,0,0,0,0,1820
340,y1008,20100415,7694,7694,7620,7636,7620,7636,7628,-58,-66,10,76.3,1814
341,y1008,20100416,7636,7628,7626,7626,7626,7626,7626,-2,-2,10,76.26,1814
342,y1008,20100419,7626,7626,7550,7550,7550,7550,7550,-76,-76,10,75.5,1806
343,y1008,20100420,7550,7550,0,0,0,7550,7550,0,0,0,0,1806
344,y1008,20100421,7550,7550,7554,7558,7518,7542,7542,-8,-8,24,181.04,1796
345,y1008,20100422,7542,7542,7516,7548,7516,7548,7532,6,-10,4,30.13,1798
346,y1008,20100423,7548,7532,7558,7608,7558,7606,7600,74,68,14,106.4,1796
347,y1008,20100426,7606,7600,0,0,0,7600,7600,0,0,0,0,1796
348,y1008,20100427,7600,7600,0,0,0,7600,7600,0,0,0,0,1796
349,y1008,20100428,7600,7600,7660,7872,7456,7550,7652,-50,52,544,4163.49,1828
350,y1008,20100429,7550,7652,7552,7588,7552,7572,7574,-80,-78,52,393.88,1804
351,y1008,20100430,7572,7574,7604,7604,7532,7556,7556,-18,-18,344,2599.43,1470
352,y1008,20100504,7556,7556,7536,7536,7478,7478,7534,-78,-22,542,4084.4,930
353,y1008,20100505,7478,7534,0,0,0,7534,7534,0,0,0,0,930
354,y1008,20100506,7534,7534,0,0,0,7534,7534,0,0,0,0,930
355,y1008,20100507,7534,7534,7380,7380,7380,7380,7380,-154,-154,284,2095.92,652
356,y1008,20100510,7380,7380,7496,7496,7496,7496,7496,116,116,2,14.99,652
357,y1008,20100511,7496,7496,0,0,0,7496,7496,0,0,0,0,652
358,y1008,20100512,7496,7496,0,0,0,7496,7496,0,0,0,0,652
359,y1008,20100513,7496,7496,7522,7522,7326,7456,7430,-40,-66,10,74.3,648
360,y1008,20100514,7456,7430,7434,7434,7366,7434,7410,4,-20,42,311.25,650
361,y1008,20100517,7434,7410,7234,7234,7234,7234,7234,-176,-176,2,14.47,650
362,y1008,20100518,7234,7234,7352,7352,7252,7252,7302,18,68,4,29.21,650
363,y1008,20100519,7252,7302,7164,7290,7164,7260,7230,-42,-72,20,144.6,646
364,y1008,20100520,7260,7230,7288,7398,7288,7396,7360,166,130,6,44.16,648
365,y1008,20100521,7396,7360,0,0,0,7360,7360,0,0,0,0,648
366,y1008,20100524,7360,7360,0,0,0,7360,7360,0,0,0,0,648
367,y1008,20100525,7360,7360,0,0,0,7360,7360,0,0,0,0,648
368,y1008,20100526,7360,7360,0,0,0,7360,7360,0,0,0,0,648
369,y1008,20100527,7360,7360,7320,7320,7320,7320,7320,-40,-40,2,14.64,646
370,y1008,20100528,7320,7320,7404,7590,7288,7304,7372,-16,52,72,530.89,648
371,y1008,20100531,7304,7372,0,0,0,7372,7372,0,0,0,0,648
372,y1008,20100601,7372,7372,0,0,0,7372,7372,0,0,0,0,648
373,y1008,20100602,7372,7372,0,0,0,7372,7372,0,0,0,0,648
374,y1008,20100603,7372,7372,0,0,0,7372,7372,0,0,0,0,648
375,y1008,20100604,7372,7372,7302,7418,7274,7274,7330,-98,-42,6,43.99,648
376,y1008,20100607,7274,7330,7182,7206,7118,7118,7178,-212,-152,14,100.5,648
377,y1008,20100608,7118,7178,7276,7276,7276,7276,7276,98,98,6,43.66,648
378,y1008,20100609,7276,7276,7104,7180,7104,7180,7132,-96,-144,12,85.59,648
379,y1008,20100610,7180,7132,7190,7190,7190,7190,7190,58,58,2,14.38,648
380,y1008,20100611,7190,7190,7190,7190,7190,7190,7190,0,0,18,129.42,640
381,y1008,20100617,7190,7190,7300,7300,7204,7220,7278,30,88,26,189.27,620
382,y1008,20100618,7220,7278,0,0,0,7278,7278,0,0,0,0,620
383,y1008,20100621,7278,7278,7192,7366,7192,7366,7286,88,8,10,72.88,620
384,y1008,20100622,7366,7286,0,0,0,7286,7286,0,0,0,0,620
385,y1008,20100623,7286,7286,0,0,0,7286,7286,0,0,0,0,620
386,y1008,20100624,7286,7286,0,0,0,7286,7286,0,0,0,0,620
387,y1008,20100625,7286,7286,0,0,0,7286,7286,0,0,0,0,620
388,y1008,20100628,7286,7286,0,0,0,7286,7286,0,0,0,0,620
389,y1008,20100629,7286,7286,0,0,0,7286,7286,0,0,0,0,620
390,y1008,20100630,7286,7286,7280,7280,7280,7280,7280,-6,-6,2,14.56,620
391,y1008,20100701,7280,7280,7120,7164,7100,7100,7124,-180,-156,14,99.75,620
392,y1008,20100702,7100,7124,0,0,0,7124,7124,0,0,0,0,620
393,y1008,20100705,7124,7124,0,0,0,7124,7124,0,0,0,0,620
394,y1008,20100706,7124,7124,0,0,0,7124,7124,0,0,0,0,620
395,y1008,20100707,7124,7124,6980,6980,6980,6980,6980,-144,-144,2,13.96,620
396,y1008,20100708,6980,6980,7094,7102,7094,7102,7096,122,116,24,170.33,620
397,y1008,20100709,7102,7096,7110,7110,7110,7110,7110,14,14,2,14.22,620
398,y1008,20100712,7110,7110,7052,7052,7052,7052,7052,-58,-58,4,28.21,620
399,y1008,20100713,7052,7052,7050,7050,7050,7050,7050,-2,-2,14,98.7,620
400,y1008,20100714,7050,7050,7080,7080,7080,7080,7080,30,30,4,28.32,620
401,y1008,20100715,7080,7080,7102,7102,7102,7102,7102,22,22,12,85.22,620
402,y1008,20100716,7102,7102,7200,7250,7200,7250,7230,148,128,52,376.02,604
403,y1008,20100719,7250,7230,0,0,0,7230,7230,0,0,0,0,604
404,y1008,20100720,7230,7230,0,0,0,7230,7230,0,0,0,0,604
405,y1008,20100721,7230,7230,0,0,0,7230,7230,0,0,0,0,604
406,y1008,20100722,7230,7230,7298,7298,7298,7298,7298,68,68,510,3721.98,94
407,y1008,20100723,7298,7298,7102,7368,7102,7358,7276,60,-22,6,43.66,94
408,y1008,20100726,7358,7276,7498,7498,7498,7498,7498,222,222,2,15,94
409,y1008,20100727,7498,7498,0,0,0,7498,7498,0,0,0,0,94
410,y1008,20100728,7498,7498,0,0,0,7498,7498,0,0,0,0,94
411,y1008,20100729,7498,7498,7400,7400,7400,7400,7400,-98,-98,94,695.6,60
412,y1008,20100730,7400,7400,7200,7336,7200,7336,7290,-64,-110,6,43.74,54
413,y1008,20100802,7336,7290,0,0,0,7290,7290,0,0,0,0,0
414,y1008,20100803,7290,7290,0,0,0,7290,7290,0,0,0,0,0
415,y1008,20100804,7290,7290,0,0,0,7290,7290,0,0,0,0,0
416,y1008,20100805,7290,7290,0,0,0,7290,7290,0,0,0,0,0
417,y1008,20100806,7290,7290,0,0,0,7290,7290,0,0,0,0,0
418,y1008,20100809,7290,7290,0,0,0,7290,7290,0,0,0,0,0
419,y1008,20100810,7290,7290,0,0,0,7290,7290,0,0,0,0,0
420,y1008,20100811,7290,7290,0,0,0,7290,7290,0,0,0,0,0
421,y1008,20100812,7290,7290,0,0,0,7290,7290,0,0,0,0,0
422,y1008,20100813,7290,7290,0,0,0,7290,7290,0,0,0,0,0
423,y1009,20100104,7968,7918,8030,8092,7990,8050,8046,132,128,922828,7426531.04,681238
424,y1009,20100105,8050,8046,8088,8090,8020,8056,8062,10,16,789080,6361726.84,667422
425,y1009,20100106,8056,8062,8030,8140,8016,8090,8096,28,34,1015520,8223148.96,698598
426,y1009,20100107,8090,8096,8100,8184,7774,7860,7970,-236,-126,1455800,11603888.34,644090
427,y1009,20100108,7860,7970,7860,7878,7652,7744,7762,-226,-208,1145050,8889001.59,649448
428,y1009,20100111,7744,7762,7844,7884,7794,7802,7842,40,80,691840,5425685.44,649770
429,y1009,20100112,7802,7842,7742,7768,7694,7726,7730,-116,-112,669838,5178778.7,666748
430,y1009,20100113,7726,7730,7560,7574,7450,7498,7516,-232,-214,756186,5684203.02,632390
431,y1009,20100114,7498,7516,7568,7616,7540,7552,7572,36,56,764352,5788760.8,672004
432,y1009,20100115,7552,7572,7520,7584,7466,7498,7528,-74,-44,809754,6097400.3,700094
433,y1009,20100118,7498,7528,7420,7464,7382,7456,7426,-72,-102,759174,5638584.43,695966
434,y1009,20100119,7456,7426,7484,7532,7448,7480,7486,54,60,642806,4812904.62,709824
435,y1009,20100120,7480,7486,7488,7508,7350,7358,7414,-128,-72,871050,6458136.05,719066
436,y1009,20100121,7358,7414,7350,7450,7306,7442,7376,28,-38,940496,6937875.03,745280
437,y1009,20100122,7442,7376,7370,7486,7288,7452,7388,76,12,1153020,8519067.2,726924
438,y1009,20100125,7452,7388,7428,7468,7410,7424,7436,36,48,886210,6591622.3,755720
439,y1009,20100126,7424,7436,7418,7438,7330,7334,7378,-102,-58,797526,5884569.28,738286
440,y1009,20100127,7334,7378,7364,7416,7336,7406,7378,28,0,926436,6836523.54,740150
441,y1009,20100128,7406,7378,7320,7352,7270,7326,7320,-52,-58,858372,6284501.81,742188
442,y1009,20100129,7326,7320,7318,7376,7270,7270,7328,-50,8,714280,5234743.69,731446
443,y1009,20100201,7270,7328,7290,7304,7178,7182,7222,-146,-106,649768,4693728.16,743420
444,y1009,20100202,7182,7222,7250,7278,7154,7174,7200,-48,-22,558656,4022800.53,720766
445,y1009,20100203,7174,7200,7300,7320,7244,7316,7282,116,82,590502,4301161.85,708662
446,y1009,20100204,7316,7282,7248,7288,7218,7270,7250,-12,-32,526208,3815497.21,674464
447,y1009,20100205,7270,7250,7210,7320,7210,7282,7268,32,18,655352,4763118.1,659320
448,y1009,20100208,7282,7268,7332,7380,7332,7368,7358,100,90,406266,2990023.84,643320
449,y1009,20100209,7368,7358,7400,7406,7358,7386,7376,28,18,327076,2412634.19,629342
450,y1009,20100210,7386,7376,7416,7420,7334,7366,7376,-10,0,395742,2919766.44,610322
451,y1009,20100211,7366,7376,7400,7474,7396,7432,7440,56,64,326020,2425609.37,565142
452,y1009,20100212,7432,7440,7436,7438,7362,7400,7400,-40,-40,215670,1596218.88,553448
453,y1009,20100222,7400,7400,7530,7532,7450,7500,7496,100,96,406084,3044309.22,535480
454,y1009,20100223,7500,7496,7500,7578,7490,7578,7544,82,48,446122,3366249.68,561712
455,y1009,20100224,7578,7544,7502,7534,7488,7512,7514,-32,-30,300046,2255000.59,559342
456,y1009,20100225,7512,7514,7570,7576,7438,7462,7498,-52,-16,485478,3640816.62,583512
457,y1009,20100226,7462,7498,7462,7488,7424,7438,7460,-60,-38,314592,2347007.29,575794
458,y1009,20100301,7438,7460,7550,7562,7480,7488,7514,28,54,444350,3339035.94,575132
459,y1009,20100302,7488,7514,7492,7528,7466,7472,7494,-42,-20,456906,3424343.01,560182
460,y1009,20100303,7472,7494,7512,7546,7494,7536,7524,42,30,443176,3335177.38,572696
461,y1009,20100304,7536,7524,7526,7540,7450,7458,7492,-66,-32,431046,3229431.48,569542
462,y1009,20100305,7458,7492,7456,7542,7424,7520,7488,28,-4,479752,3592493.56,569912
463,y1009,20100308,7520,7488,7506,7560,7498,7544,7532,56,44,460324,3467676.22,573236
464,y1009,20100309,7544,7532,7532,7592,7512,7582,7554,50,22,590396,4460539.08,531828
465,y1009,20100310,7582,7554,7558,7614,7550,7586,7588,32,34,519526,3942424.08,511072
466,y1009,20100311,7586,7588,7634,7654,7492,7542,7564,-46,-24,711900,5385824.29,510148
467,y1009,20100312,7542,7564,7500,7536,7474,7488,7500,-76,-64,422498,3169052.94,501220
468,y1009,20100315,7488,7500,7450,7494,7436,7468,7462,-32,-38,400118,2986156.4,512330
469,y1009,20100316,7468,7462,7444,7484,7424,7482,7452,20,-10,407026,3033458.96,533366
470,y1009,20100317,7482,7452,7500,7522,7482,7500,7502,48,50,356080,2671684.17,548578
471,y1009,20100318,7500,7502,7512,7516,7426,7444,7460,-58,-42,420440,3136710.71,524946
472,y1009,20100319,7444,7460,7452,7484,7444,7478,7466,18,6,296500,2214124.06,528954
473,y1009,20100322,7478,7466,7460,7528,7454,7500,7498,34,32,351584,2636830.45,533714
474,y1009,20100323,7500,7498,7530,7542,7488,7508,7514,10,16,330838,2486433.37,510262
475,y1009,20100324,7508,7514,7500,7524,7472,7518,7500,4,-14,362754,2720981.94,503078
476,y1009,20100325,7518,7500,7500,7562,7500,7522,7528,22,28,499104,3758023.15,538446
477,y1009,20100326,7522,7528,7480,7496,7456,7484,7476,-44,-52,325682,2435342.35,547424
478,y1009,20100329,7484,7476,7502,7518,7480,7502,7498,26,22,227100,1703159.05,540966
479,y1009,20100330,7502,7498,7526,7632,7476,7578,7560,80,62,976896,7385614.08,489402
480,y1009,20100331,7578,7560,7580,7646,7562,7574,7604,14,44,963800,7329268.25,513790
481,y1009,20100401,7574,7604,7530,7594,7526,7574,7566,-30,-38,464392,3513929.13,506126
482,y1009,20100402,7574,7566,7600,7612,7580,7600,7596,34,30,262770,1996033.78,501644
483,y1009,20100406,7600,7596,7602,7638,7588,7604,7612,8,16,334058,2543082.58,495868
484,y1009,20100407,7604,7612,7630,7728,7618,7714,7692,102,80,799390,6149708.66,523650
485,y1009,20100408,7714,7692,7702,7746,7690,7692,7714,0,22,512662,3955451.92,487126
486,y1009,20100409,7692,7714,7708,7766,7700,7750,7738,36,24,503652,3897398.45,502516
487,y1009,20100412,7750,7738,7788,7794,7732,7752,7758,14,20,383382,2974857.18,484276
488,y1009,20100413,7752,7758,7712,7734,7674,7720,7708,-38,-50,383080,2953384.02,478798
489,y1009,20100414,7720,7708,7736,7750,7706,7706,7728,-2,20,306154,2366473.05,454220
490,y1009,20100415,7706,7728,7724,7726,7692,7706,7708,-22,-20,200284,1543869.75,440336
491,y1009,20100416,7706,7708,7716,7736,7702,7716,7718,8,10,207044,1598199.4,416856
492,y1009,20100419,7716,7718,7688,7692,7600,7610,7640,-108,-78,199836,1526900.75,404428
493,y1009,20100420,7610,7640,7632,7660,7602,7630,7628,-10,-12,172586,1316648.82,380132
494,y1009,20100421,7630,7628,7636,7648,7614,7646,7636,18,8,112366,858121.78,356712
495,y1009,20100422,7646,7636,7634,7650,7630,7640,7640,4,4,68504,523477.86,338722
496,y1009,20100423,7640,7640,7640,7710,7640,7702,7686,62,46,138328,1063295.03,304450
497,y1009,20100426,7702,7686,7724,7734,7706,7708,7714,22,28,71144,548898.18,288792
498,y1009,20100427,7708,7714,7696,7724,7682,7708,7704,-6,-10,76396,588618.4,270322
499,y1009,20100428,7708,7704,7660,7660,7610,7634,7632,-70,-72,83898,640408.86,243528
500,y1009,20100429,7634,7632,7602,7634,7596,7610,7616,-22,-16,57232,435898.72,240342
501,y1009,20100430,7610,7616,7630,7636,7580,7626,7608,10,-8,50546,384599.38,232858
502,y1009,20100504,7626,7608,7600,7620,7584,7600,7602,-8,-6,20134,153086.91,228738
503,y1009,20100505,7600,7602,7568,7628,7552,7624,7598,22,-4,39600,300930.82,217876
504,y1009,20100506,7624,7598,7630,7656,7548,7556,7608,-42,10,38598,293725.29,214818
505,y1009,20100507,7556,7608,7500,7500,7424,7434,7448,-174,-160,75946,565749.12,196064
506,y1009,20100510,7434,7448,7472,7520,7462,7518,7484,70,36,28024,209762.94,193424
507,y1009,20100511,7518,7484,7518,7526,7474,7474,7500,-10,16,30086,225678.44,191612
508,y1009,20100512,7474,7500,7488,7534,7480,7518,7518,18,18,24120,181362.62,187286
509,y1009,20100513,7518,7518,7526,7526,7458,7498,7494,-20,-24,24000,179876.78,183268
510,y1009,20100514,7498,7494,7480,7488,7448,7454,7464,-40,-30,19672,146848.25,179548
511,y1009,20100517,7454,7464,7412,7420,7270,7304,7334,-160,-130,52874,387865.34,164812
512,y1009,20100518,7304,7334,7330,7388,7296,7386,7340,52,6,31862,233898.04,154636
513,y1009,20100519,7386,7340,7350,7376,7328,7350,7350,10,10,14624,107507.57,150568
514,y1009,20100520,7350,7350,7370,7420,7370,7402,7398,52,48,13256,98071.37,147662
515,y1009,20100521,7402,7398,7368,7434,7362,7428,7410,30,12,23500,174137.42,142906
516,y1009,20100524,7428,7410,7416,7444,7398,7410,7412,0,2,16820,124700.84,143638
517,y1009,20100525,7410,7412,7404,7408,7330,7330,7356,-82,-56,15862,116702.82,145012
518,y1009,20100526,7330,7356,7344,7382,7314,7376,7352,20,-4,12922,95021.83,141094
519,y1009,20100527,7376,7352,7388,7400,7360,7396,7380,44,28,13422,99063.22,136866
520,y1009,20100528,7396,7380,7410,7426,7372,7384,7400,4,20,11188,82809.89,135432
521,y1009,20100531,7384,7400,7360,7360,7324,7332,7344,-68,-56,15416,113238.36,135466
522,y1009,20100601,7332,7344,7334,7380,7294,7320,7334,-24,-10,11794,86507.77,134204
523,y1009,20100602,7320,7334,7336,7366,7308,7364,7342,30,8,9054,66486.15,132024
524,y1009,20100603,7364,7342,7358,7388,7334,7368,7362,26,20,14486,106666.97,126534
525,y1009,20100604,7368,7362,7370,7426,7370,7412,7406,50,44,20706,153349.54,122766
526,y1009,20100607,7412,7406,7328,7328,7186,7252,7260,-154,-146,32014,232453.01,118242
527,y1009,20100608,7252,7260,7268,7298,7238,7288,7284,28,24,27150,197773.92,121170
528,y1009,20100609,7288,7284,7278,7306,7236,7294,7266,10,-18,14502,105387.14,119278
529,y1009,20100610,7294,7266,7298,7310,7266,7284,7290,18,24,13916,101463.78,117174
530,y1009,20100611,7284,7290,7296,7300,7260,7266,7286,-24,-4,6076,44270.81,114162
531,y1009,20100617,7266,7286,7366,7378,7332,7336,7356,50,70,12312,90568.03,110202
532,y1009,20100618,7336,7356,7350,7380,7348,7366,7362,10,6,7042,51856.71,108160
533,y1009,20100621,7366,7362,7388,7478,7388,7454,7436,92,74,10334,76845.57,104260
534,y1009,20100622,7454,7436,7452,7454,7422,7436,7434,0,-2,6114,45460.67,102182
535,y1009,20100623,7436,7434,7436,7436,7386,7408,7404,-26,-30,9628,71288.42,97350
536,y1009,20100624,7408,7404,7408,7414,7388,7390,7398,-14,-6,5896,43625.62,94512
537,y1009,20100625,7390,7398,7390,7448,7352,7366,7370,-32,-28,3262,24044.2,93370
538,y1009,20100628,7366,7370,7354,7388,7350,7350,7366,-20,-4,3496,25758.2,92406
539,y1009,20100629,7350,7366,7348,7348,7260,7270,7308,-96,-58,14320,104677.1,86690
540,y1009,20100630,7270,7308,7244,7244,7196,7224,7218,-84,-90,15568,112382.04,78422
541,y1009,20100701,7224,7218,7208,7242,7170,7178,7224,-40,6,10194,73647.27,70170
542,y1009,20100702,7178,7224,7178,7200,7154,7190,7176,-34,-48,4982,35758.87,68786
543,y1009,20100705,7190,7176,7188,7188,7160,7160,7174,-16,-2,3622,25989.87,67230
544,y1009,20100706,7160,7174,7132,7158,7062,7150,7126,-24,-48,3048,21720.44,66142
545,y1009,20100707,7150,7126,7142,7164,7134,7140,7138,14,12,3562,25426.75,64326
546,y1009,20100708,7140,7138,7178,7230,7178,7194,7200,56,62,3360,24194.39,63072
547,y1009,20100709,7194,7200,7218,7228,7198,7226,7212,26,12,4396,31709.19,61310
548,y1009,20100712,7226,7212,7242,7260,7212,7240,7230,28,18,5902,42681.96,58092
549,y1009,20100713,7240,7230,7232,7246,7204,7234,7224,4,-6,7046,50901.74,54510
550,y1009,20100714,7234,7224,7260,7270,7238,7258,7248,34,24,3494,25328.63,53244
551,y1009,20100715,7258,7248,7260,7276,7242,7244,7258,-4,10,2248,16319.15,51648
552,y1009,20100716,7244,7258,7300,7360,7294,7352,7326,94,68,9436,69130.52,46468
553,y1009,20100719,7352,7326,7332,7344,7318,7344,7328,18,2,3612,26472.52,45804
554,y1009,20100720,7344,7328,7328,7352,7296,7346,7324,18,-4,3278,24008.58,44020
555,y1009,20100721,7346,7324,7390,7390,7326,7348,7346,24,22,4114,30223.68,41828
556,y1009,20100722,7348,7346,7332,7370,7328,7366,7344,20,-2,2982,21901.85,39378
557,y1009,20100723,7366,7344,7384,7422,7380,7404,7402,60,58,4240,31390.5,37164
558,y1009,20100726,7404,7402,7394,7450,7394,7420,7426,18,24,5436,40376.78,33396
559,y1009,20100727,7420,7426,7404,7424,7342,7346,7386,-80,-40,5604,41401.36,31578
560,y1009,20100728,7346,7386,7370,7398,7356,7384,7382,-2,-4,3168,23391.89,30796
561,y1009,20100729,7384,7382,7428,7450,7400,7442,7428,60,46,4432,32926.39,28598
562,y1009,20100730,7442,7428,7448,7496,7438,7450,7460,22,32,2126,15863.43,27272
563,y1009,20100802,7450,7460,7538,7620,7520,7614,7574,154,114,4732,35841.49,26544
564,y1009,20100803,7614,7574,7612,7630,7562,7616,7606,42,32,3638,27677.42,25998
565,y1009,20100804,7616,7606,7638,7690,7610,7660,7660,54,54,1954,14971.28,26020
566,y1009,20100805,7660,7660,7690,7726,7600,7616,7634,-44,-26,2006,15314.36,24950
567,y1009,20100806,7616,7634,7680,7768,7624,7766,7692,132,58,3040,23384.61,24170
568,y1009,20100809,7766,7692,7760,7932,7726,7898,7870,206,178,5358,42167.9,23292
569,y1009,20100810,7898,7870,7852,7880,7800,7826,7838,-44,-32,1664,13044.1,22300
570,y1009,20100811,7826,7838,7822,7868,7800,7802,7832,-36,-6,550,4308.45,22180
571,y1009,20100812,7802,7832,7770,7832,7764,7808,7810,-24,-22,2698,21072.24,19750
572,y1009,20100813,7808,7810,7800,7960,7800,7930,7904,120,94,4196,33170.54,18514
573,y1009,20100816,7930,7904,7988,8108,7972,7990,7998,86,94,3402,27212.23,17750
574,y1009,20100817,7990,7998,7878,7962,7878,7960,7932,-38,-66,2854,22638.74,17398
575,y1009,20100818,7960,7932,7956,8010,7864,7864,7958,-68,26,1158,9217.63,16862
576,y1009,20100819,7864,7958,7906,8148,7820,7868,7898,-90,-60,1840,14533.74,16808
577,y1009,20100820,7868,7898,7764,7792,7650,7692,7752,-206,-146,2094,16234,15100
578,y1009,20100823,7692,7752,7666,7730,7666,7694,7704,-58,-48,166,1279.17,15092
579,y1009,20100824,7694,7704,7668,7746,7634,7658,7696,-46,-8,696,5357.78,14956
580,y1009,20100825,7658,7696,7690,7718,7600,7658,7652,-38,-44,506,3872.86,14672
581,y1009,20100826,7658,7652,7666,7720,7624,7676,7666,24,14,1330,10198.35,14400
582,y1009,20100827,7676,7666,7676,7730,7630,7686,7688,20,22,586,4506.34,14146
583,y1009,20100830,7686,7688,7760,7800,7708,7756,7754,68,66,1290,10003.6,13590
584,y1009,20100831,7756,7754,7700,7706,7548,7700,7662,-54,-92,576,4413.84,13064
585,y1009,20100901,7700,7662,7700,7700,7640,7650,7676,-12,14,64,491.36,7206
586,y1009,20100902,7650,7676,7640,7640,7640,7640,7640,-36,-36,16,122.24,5042
587,y1009,20100903,7640,7640,0,0,0,7640,7640,0,0,0,0,4712
588,y1009,20100906,7640,7640,7640,7640,7530,7530,7566,-110,-74,600,4540,4236
589,y1009,20100907,7530,7566,0,0,0,7566,7566,0,0,0,0,3036
590,y1009,20100908,7566,7566,0,0,0,7566,7566,0,0,0,0,3036
591,y1009,20100909,7566,7566,0,0,0,7566,7566,0,0,0,0,3036
592,y1009,20100910,7566,7566,0,0,0,7566,7566,0,0,0,0,3036
593,y1009,20100913,7566,7566,0,0,0,7566,7566,0,0,0,0,2350
594,y1009,20100914,7566,7566,0,0,0,7566,7578,0,12,0,0,0
595,y1011,20100104,8034,8002,8054,8176,8054,8168,8114,166,112,84,681.66,480
596,y1011,20100105,8168,8114,8154,8154,8084,8084,8094,-30,-20,14,113.34,482
597,y1011,20100106,8084,8094,8004,8200,8004,8184,8124,90,30,64,520.06,452
598,y1011,20100107,8184,8124,8152,8380,7894,7922,8110,-202,-14,88,713.82,454
599,y1011,20100108,7922,8110,7906,7992,7786,7858,7836,-252,-274,152,1191.34,456
600,y1011,20100111,7858,7836,7992,7992,7900,7900,7932,64,96,18,142.8,458
601,y1011,20100112,7900,7932,7804,7856,7772,7856,7806,-76,-126,22,171.77,462
602,y1011,20100113,7856,7806,7680,7680,7540,7610,7608,-196,-198,46,349.97,470
603,y1011,20100114,7610,7608,7660,7698,7650,7688,7676,80,68,40,307.1,472
604,y1011,20100115,7688,7676,7650,7658,7560,7570,7624,-106,-52,848,6466.16,1296
605,y1011,20100118,7570,7624,7524,7568,7478,7568,7548,-56,-76,636,4801.28,1894
606,y1011,20100119,7568,7548,7596,7638,7564,7606,7590,58,42,16,121.44,1890
607,y1011,20100120,7606,7590,0,0,0,7590,7590,0,0,0,0,1890
608,y1011,20100121,7590,7590,7400,7546,7400,7540,7522,-50,-68,258,1941.05,2134
609,y1011,20100122,7540,7522,7468,7540,7364,7504,7452,-18,-70,122,909.37,2104
610,y1011,20100125,7504,7452,7500,7540,7446,7506,7500,54,48,830,6225.04,1298
611,y1011,20100126,7506,7500,7522,7522,7370,7370,7460,-130,-40,568,4238.08,1818
612,y1011,20100127,7370,7460,7392,7480,7392,7480,7420,20,-40,28,207.78,1824
613,y1011,20100128,7480,7420,7420,7420,7358,7360,7414,-60,-6,238,1764.76,1594
614,y1011,20100129,7360,7414,7434,7438,7316,7336,7398,-78,-16,126,932.25,1620
615,y1011,20100201,7336,7398,7308,7308,7236,7248,7258,-150,-140,56,406.51,1616
616,y1011,20100202,7248,7258,7258,7300,7200,7200,7278,-58,20,578,4207.22,1116
617,y1011,20100203,7200,7278,7350,7368,7322,7332,7334,54,56,30,220.07,1116
618,y1011,20100204,7332,7334,7242,7316,7242,7298,7272,-36,-62,40,290.92,1126
619,y1011,20100205,7298,7272,7248,7310,7172,7310,7286,38,14,68,495.53,1126
620,y1011,20100208,7310,7286,7358,7378,7352,7378,7364,92,78,46,338.78,1112
621,y1011,20100209,7378,7364,7382,7392,7360,7386,7372,22,8,56,412.89,1112
622,y1011,20100210,7386,7372,7412,7444,7352,7374,7400,2,28,50,370.02,1084
623,y1011,20100211,7374,7400,7410,7480,7410,7440,7446,40,46,32,238.31,1082
624,y1011,20100212,7440,7446,7430,7440,7400,7440,7424,-6,-22,18,133.66,1070
625,y1011,20100222,7440,7424,7482,7512,7482,7512,7500,88,76,18,135,1066
626,y1011,20100223,7512,7500,7572,7594,7538,7566,7526,66,26,3068,23093.33,1074
627,y1011,20100224,7566,7526,7514,7548,7514,7536,7524,10,-2,936,7043.71,1072
628,y1011,20100225,7536,7524,7588,7588,7458,7512,7532,-12,8,38,286.22,1066
629,y1011,20100226,7512,7532,7544,7544,7500,7500,7526,-32,-6,90,677.37,1082
630,y1011,20100301,7500,7526,7550,7584,7496,7564,7554,38,28,12,90.66,1078
631,y1011,20100302,7564,7554,7568,7568,7530,7560,7552,6,-2,14,105.75,1082
632,y1011,20100303,7560,7552,7552,7604,7552,7604,7568,52,16,12,90.83,1082
633,y1011,20100304,7604,7568,7590,7590,7494,7494,7586,-74,18,128,971.1,1194
634,y1011,20100305,7494,7586,7450,7590,7450,7590,7550,4,-36,132,996.76,1104
635,y1011,20100308,7590,7550,7626,7626,7568,7580,7594,30,44,412,3129.05,1074
636,y1011,20100309,7580,7594,7610,7646,7582,7646,7606,52,12,1376,10466.52,1072
637,y1011,20100310,7646,7606,7612,7730,7612,7652,7636,46,30,142,1084.44,1066
638,y1011,20100311,7652,7636,7724,7724,7600,7626,7650,-10,14,42,321.33,1076
639,y1011,20100312,7626,7650,7590,7618,7558,7560,7566,-90,-84,502,3798.19,1082
640,y1011,20100315,7560,7566,7538,7538,7520,7538,7536,-28,-30,108,814.07,984
641,y1011,20100316,7538,7536,7482,7546,7482,7546,7510,10,-26,338,2538.69,988
642,y1011,20100317,7546,7510,0,0,0,7510,7510,0,0,0,0,988
643,y1011,20100318,7510,7510,7552,7552,7526,7526,7528,16,18,14,105.42,990
644,y1011,20100319,7526,7528,7546,7546,7544,7544,7544,16,16,4,30.18,990
645,y1011,20100322,7544,7544,7582,7598,7570,7580,7548,36,4,6026,45488.17,994
646,y1011,20100323,7580,7548,7588,7588,7580,7584,7556,36,8,7532,56918.49,978
647,y1011,20100324,7584,7556,7526,7786,7526,7560,7614,4,58,58,441.64,982
648,y1011,20100325,7560,7614,7610,7612,7600,7612,7600,-2,-14,1010,7676.1,1982
649,y1011,20100326,7612,7600,7610,7610,7510,7566,7572,-34,-28,32,242.36,1980
650,y1011,20100329,7566,7572,7566,7566,7550,7566,7562,-6,-10,8,60.5,1982
651,y1011,20100330,7566,7562,7562,7656,7522,7654,7598,92,36,32,243.15,1974
652,y1011,20100331,7654,7598,7644,7710,7580,7666,7646,68,48,2538,19410.49,1976
653,y1011,20100401,7666,7646,7666,7666,7624,7624,7640,-22,-6,46,351.47,1986
654,y1011,20100402,7624,7640,7624,7666,7624,7640,7644,0,4,24,183.47,1976
655,y1011,20100406,7640,7644,7612,7804,7612,7664,7692,20,48,238,1831.16,1976
656,y1011,20100407,7664,7692,7710,7796,7674,7766,7718,74,26,200,1543.86,1996
657,y1011,20100408,7766,7718,7794,7794,7722,7750,7746,32,28,268,2076.34,1988
658,y1011,20100409,7750,7746,7774,7798,7720,7798,7780,52,34,446,3470.32,1670
659,y1011,20100412,7798,7780,7804,7818,7774,7798,7800,18,20,116,904.83,1648
660,y1011,20100413,7798,7800,7792,7834,7724,7834,7764,34,-36,144,1118.05,1752
661,y1011,20100414,7834,7764,7780,7884,7774,7774,7792,10,28,154,1200.01,1770
662,y1011,20100415,7774,7792,7756,7780,7750,7750,7762,-42,-30,42,326.01,1762
663,y1011,20100416,7750,7762,7798,7798,7726,7778,7770,16,8,300,2331.37,1656
664,y1011,20100419,7778,7770,7846,7846,7604,7666,7754,-104,-16,374,2900.17,1724
665,y1011,20100420,7666,7754,7704,7794,7682,7704,7732,-50,-22,660,5103.4,1708
666,y1011,20100421,7704,7732,7674,7732,7674,7730,7718,-2,-14,788,6082.13,2284
667,y1011,20100422,7730,7718,7720,7738,7720,7722,7724,4,6,108,834.32,2258
668,y1011,20100423,7722,7724,7754,7798,7718,7770,7762,46,38,148,1148.97,2258
669,y1011,20100426,7770,7762,7820,7820,7762,7782,7790,20,28,98,763.51,2250
670,y1011,20100427,7782,7790,7774,7790,7752,7786,7776,-4,-14,130,1011.13,2248
671,y1011,20100428,7786,7776,7740,7846,7652,7712,7718,-64,-58,228,1759.99,2240
672,y1011,20100429,7712,7718,7720,7722,7650,7692,7704,-26,-14,62,477.74,2256
673,y1011,20100430,7692,7704,7720,7724,7666,7706,7708,2,4,152,1171.75,2278
674,y1011,20100504,7706,7708,7718,7718,7672,7686,7690,-22,-18,158,1215.21,2264
675,y1011,20100505,7686,7690,7686,7706,7646,7706,7690,16,0,106,815.26,2246
676,y1011,20100506,7706,7690,7712,7746,7652,7652,7698,-38,8,116,893.08,2264
677,y1011,20100507,7652,7698,7670,7670,7464,7464,7524,-234,-174,384,2889.47,2288
678,y1011,20100510,7464,7524,7608,7608,7526,7590,7560,66,36,190,1436.44,2284
679,y1011,20100511,7590,7560,7552,7600,7538,7538,7564,-22,4,90,680.93,2310
680,y1011,20100512,7538,7564,7562,7614,7562,7604,7596,40,32,86,653.34,2284
681,y1011,20100513,7604,7596,7606,7612,7544,7584,7570,-12,-26,112,847.89,2288
682,y1011,20100514,7584,7570,7526,7590,7526,7526,7550,-44,-20,126,951.33,2310
683,y1011,20100517,7526,7550,7468,7504,7334,7406,7376,-144,-174,370,2729.72,2336
684,y1011,20100518,7406,7376,7442,7468,7378,7468,7426,92,50,520,3861.94,2310
685,y1011,20100519,7468,7426,7450,7456,7402,7428,7436,2,10,352,2617.69,2322
686,y1011,20100520,7428,7436,7464,7510,7464,7482,7486,46,50,20,149.76,2324
687,y1011,20100521,7482,7486,7454,7546,7454,7534,7498,48,12,132,989.83,2306
688,y1011,20100524,7534,7498,7502,7534,7472,7484,7498,-14,0,98,734.87,2296
689,y1011,20100525,7484,7498,7500,7500,7402,7402,7440,-96,-58,38,282.78,2276
690,y1011,20100526,7402,7440,7470,7470,7402,7436,7434,-4,-6,34,252.8,2278
691,y1011,20100527,7436,7434,7470,7518,7450,7508,7480,74,46,46,344.16,2304
692,y1011,20100528,7508,7480,7520,7544,7470,7492,7502,12,22,116,870.32,2308
693,y1011,20100531,7492,7502,7400,7470,7400,7456,7436,-46,-66,84,624.73,2334
694,y1011,20100601,7456,7436,7470,7470,7386,7386,7434,-50,-2,148,1100.5,2318
695,y1011,20100602,7386,7434,7468,7468,7384,7438,7430,4,-4,92,683.62,2318
696,y1011,20100603,7438,7430,7470,7474,7420,7468,7442,38,12,126,937.91,2290
697,y1011,20100604,7468,7442,7460,7494,7442,7488,7470,46,28,72,537.93,2286
698,y1011,20100607,7488,7470,7488,7488,7228,7324,7320,-146,-150,146,1068.74,2278
699,y1011,20100608,7324,7320,7294,7384,7292,7356,7342,36,22,124,910.59,2302
700,y1011,20100609,7356,7342,7312,7344,7304,7330,7326,-12,-16,62,454.3,2298
701,y1011,20100610,7330,7326,7354,7372,7326,7326,7344,0,18,78,572.84,2300
702,y1011,20100611,7326,7344,7356,7442,7356,7362,7398,18,54,244,1805.36,2390
703,y1011,20100617,7362,7398,7456,7456,7422,7422,7434,24,36,284,2111.48,2114
704,y1011,20100618,7422,7434,7478,7478,7426,7426,7444,-8,10,68,506.32,2102
705,y1011,20100621,7426,7444,7496,7564,7472,7564,7516,120,72,474,3563.28,2060
706,y1011,20100622,7564,7516,7510,7560,7454,7504,7520,-12,4,136,1022.77,2066
707,y1011,20100623,7504,7520,7504,7512,7456,7476,7486,-44,-34,90,673.88,2048
708,y1011,20100624,7476,7486,7476,7498,7476,7480,7486,-6,0,36,269.56,2050
709,y1011,20100625,7480,7486,7466,7470,7438,7452,7458,-34,-28,142,1059.18,2058
710,y1011,20100628,7452,7458,7482,7486,7452,7460,7472,2,14,224,1673.73,2116
711,y1011,20100629,7460,7472,7444,7444,7364,7368,7402,-104,-70,70,518.2,2132
712,y1011,20100630,7368,7402,7416,7416,7112,7332,7234,-70,-168,662,4789.63,2104
713,y1011,20100701,7332,7234,7342,7342,7248,7266,7302,32,68,116,847.16,2076
714,y1011,20100702,7266,7302,7308,7308,7260,7304,7278,2,-24,72,524.02,2074
715,y1011,20100705,7304,7278,7296,7296,7242,7242,7250,-36,-28,226,1638.78,2174
716,y1011,20100706,7242,7250,7230,7264,7198,7260,7228,10,-22,212,1532.45,2192
717,y1011,20100707,7260,7228,7264,7264,7232,7232,7240,4,12,40,289.63,2192
718,y1011,20100708,7232,7240,7268,7336,7268,7272,7288,32,48,224,1632.54,2152
719,y1011,20100709,7272,7288,7336,7336,7290,7316,7312,28,24,32,233.99,2150
720,y1011,20100712,7316,7312,7330,7420,7308,7308,7336,-4,24,178,1306.06,2148
721,y1011,20100713,7308,7336,7320,7432,7306,7342,7362,6,26,324,2385.45,2300
722,y1011,20100714,7342,7362,7370,7380,7350,7360,7360,-2,-2,252,1854.94,2316
723,y1011,20100715,7360,7360,7354,7376,7350,7350,7362,-10,2,48,353.46,2314
724,y1011,20100716,7350,7362,7430,7430,7370,7422,7384,60,22,350,2584.48,2284
725,y1011,20100719,7422,7384,7430,7430,7382,7398,7402,14,18,60,444.2,2284
726,y1011,20100720,7398,7402,7410,7410,7366,7408,7394,6,-8,104,768.99,2284
727,y1011,20100721,7408,7394,7410,7420,7386,7386,7410,-8,16,50,370.54,2280
728,y1011,20100722,7386,7410,7376,7418,7376,7414,7394,4,-16,86,636.05,2280
729,y1011,20100723,7414,7394,7480,7528,7460,7518,7492,124,98,722,5409.9,2642
730,y1011,20100726,7518,7492,7520,7578,7512,7552,7550,60,58,148,1117.54,2714
731,y1011,20100727,7552,7550,7542,7542,7478,7478,7504,-72,-46,84,630.48,2718
732,y1011,20100728,7478,7504,7470,7512,7470,7506,7502,2,-2,70,525.15,2682
733,y1011,20100729,7506,7502,7506,7584,7506,7572,7536,70,34,612,4612.9,2246
734,y1011,20100730,7572,7536,7540,7612,7538,7580,7574,44,38,42,318.18,2244
735,y1011,20100802,7580,7574,7612,7704,7606,7686,7680,112,106,160,1229.1,2212
736,y1011,20100803,7686,7680,7628,7818,7628,7724,7730,44,50,466,3602.38,2240
737,y1011,20100804,7724,7730,7784,7784,7718,7748,7762,18,32,138,1071.3,2216
738,y1011,20100805,7748,7762,7788,7806,7640,7684,7740,-78,-22,110,851.55,2192
739,y1011,20100806,7684,7740,7688,7848,7686,7848,7766,108,26,72,559.16,2178
740,y1011,20100809,7848,7766,7872,8024,7872,7998,7956,232,190,118,939.04,2216
741,y1011,20100810,7998,7956,8034,8034,7900,7906,7934,-50,-22,272,2158.33,2328
742,y1011,20100811,7906,7934,7894,7940,7868,7868,7918,-66,-16,78,617.72,2318
743,y1011,20100812,7868,7918,7832,7876,7830,7876,7840,-42,-78,398,3120.34,1956
744,y1011,20100813,7876,7840,7936,8040,7930,8008,7984,168,144,180,1437.36,1942
745,y1011,20100816,8008,7984,8052,8082,8036,8044,8056,60,72,104,838,1908
746,y1011,20100817,8044,8056,7956,8028,7940,8004,7974,-52,-82,86,685.85,1840
747,y1011,20100818,8004,7974,8070,8078,7904,7906,8002,-68,28,374,2992.94,1840
748,y1011,20100819,7906,8002,7966,7966,7900,7902,7926,-100,-76,48,380.48,1830
749,y1011,20100820,7902,7926,7856,7856,7740,7740,7818,-186,-108,182,1422.91,1784
750,y1011,20100823,7740,7818,7798,7800,7756,7786,7776,-32,-42,110,855.36,1782
751,y1011,20100824,7786,7776,7742,7868,7706,7706,7758,-70,-18,282,2187.98,1734
752,y1011,20100825,7706,7758,7748,7772,7686,7686,7732,-72,-26,12,92.78,1734
753,y1011,20100826,7686,7732,7748,7750,7716,7750,7728,18,-4,60,463.79,1722
754,y1011,20100827,7750,7728,7750,7806,7750,7800,7782,72,54,16,124.53,1722
755,y1011,20100830,7800,7782,7808,7884,7808,7854,7848,72,66,6,47.09,1724
756,y1011,20100831,7854,7848,7790,7790,7740,7754,7762,-94,-86,40,310.48,1730
757,y1011,20100901,7754,7762,7770,7790,7706,7714,7750,-48,-12,68,527,1726
758,y1011,20100902,7714,7750,7772,7794,7732,7732,7766,-18,16,46,357.3,1722
759,y1011,20100903,7732,7766,7776,7828,7776,7812,7814,46,48,50,390.77,1702
760,y1011,20100906,7812,7814,7836,7868,7822,7856,7832,42,18,100,783.32,1700
761,y1011,20100907,7856,7832,7802,7826,7802,7826,7810,-6,-22,26,203.09,1700
762,y1011,20100908,7826,7810,7850,7878,7840,7878,7860,68,50,8,62.89,1700
763,y1011,20100909,7878,7860,7840,7860,7682,7798,7770,-62,-90,238,1849.33,1760
764,y1011,20100910,7798,7770,7840,7840,7814,7814,7816,44,46,20,156.36,1746
765,y1011,20100913,7814,7816,7808,7810,7786,7786,7790,-30,-26,98,763.5,1700
766,y1011,20100914,7786,7790,7794,7826,7750,7826,7792,36,2,114,888.36,1654
767,y1011,20100915,7826,7792,0,0,0,7792,7792,0,0,0,0,1654
768,y1011,20100916,7792,7792,7784,7874,7784,7828,7828,36,36,100,782.8,1616
769,y1011,20100917,7828,7828,7850,7856,7762,7830,7830,2,2,370,2897.69,1316
770,y1011,20100920,7830,7830,7890,7890,7890,7890,7890,60,60,6,47.34,1316
771,y1011,20100921,7890,7890,0,0,0,7890,7890,0,0,0,0,1316
772,y1011,20100927,7890,7890,7890,8260,7890,8260,8212,370,322,40,328.48,1286
773,y1011,20100928,8260,8212,8214,8280,8214,8258,8250,46,38,50,412.52,1266
774,y1011,20100929,8258,8250,8248,8344,8200,8212,8226,-38,-24,62,510.07,1234
775,y1011,20100930,8212,8226,8232,8268,8232,8250,8244,24,18,206,1698.26,1040
776,y1011,20101008,8250,8244,0,0,0,8244,8244,0,0,0,0,1040
777,y1011,20101011,8244,8244,8244,8244,8244,8244,8244,0,0,2,16.49,1040
778,y1011,20101012,8244,8244,0,0,0,8244,8244,0,0,0,0,1040
779,y1011,20101013,8244,8244,8572,8572,8572,8572,8572,328,328,124,1062.93,918
780,y1011,20101014,8572,8572,8890,8890,8756,8800,8774,228,202,702,6160.58,618
781,y1011,20101015,8800,8774,9022,9022,8672,8820,8750,46,-24,32,280.03,596
782,y1011,20101018,8820,8750,0,0,0,8750,8750,0,0,0,0,596
783,y1011,20101019,8750,8750,0,0,0,8750,8750,0,0,0,0,596
784,y1011,20101020,8750,8750,8562,9096,8562,8964,8830,214,80,80,706.42,594
785,y1011,20101021,8964,8830,9180,9180,9042,9080,9100,250,270,18,163.81,594
786,y1011,20101022,9080,9100,9100,9100,8990,9100,9080,0,-20,12,108.98,594
787,y1011,20101025,9100,9080,9000,9430,9000,9280,9346,200,266,226,2112.27,394
788,y1011,20101026,9280,9346,9200,9486,9150,9150,9222,-196,-124,16,147.58,396
789,y1011,20101027,9150,9222,9200,9200,9200,9200,9200,-22,-22,2,18.4,396
790,y1011,20101028,9200,9200,9200,9200,8904,8904,9150,-296,-50,12,109.81,386
791,y1011,20101029,8904,9150,8936,8950,8936,8950,8942,-200,-208,4,35.77,382
792,y1011,20101101,8950,8942,8900,8900,8900,8900,8900,-42,-42,4,35.6,174
793,y1011,20101102,8900,8900,0,0,0,8900,8900,0,0,0,0,148
794,y1011,20101103,8900,8900,0,0,0,8900,8900,0,0,0,0,148
795,y1011,20101104,8900,8900,0,0,0,8900,8900,0,0,0,0,148
796,y1011,20101105,8900,8900,0,0,0,8900,8900,0,0,0,0,148
797,y1011,20101108,8900,8900,0,0,0,8900,8900,0,0,0,0,148
798,y1011,20101109,8900,8900,0,0,0,8900,8900,0,0,0,0,148
799,y1011,20101110,8900,8900,0,0,0,8900,8900,0,0,0,0,148
800,y1011,20101111,8900,8900,9100,9428,9100,9428,9316,528,416,6,55.9,148
801,y1011,20101112,9428,9316,9500,9502,9500,9502,9250,186,-66,4,38,0
802,y1012,20100104,8008,8016,8066,8166,8066,8158,8130,142,114,8,65.04,16
803,y1012,20100105,8158,8130,0,0,0,8130,8130,0,0,0,0,16
804,y1012,20100106,8130,8130,8150,8180,8150,8180,8168,50,38,6,49.02,16
805,y1012,20100107,8180,8168,7950,7950,7932,7932,7938,-236,-230,6,47.63,16
806,y1012,20100108,7932,7938,7888,7888,7888,7888,7888,-50,-50,2,15.78,16
807,y1012,20100111,7888,7888,8080,8080,8080,8080,8080,192,192,2,16.16,18
808,y1012,20100112,8080,8080,7956,7990,7956,7990,7974,-90,-106,6,47.85,22
809,y1012,20100113,7990,7974,7684,7784,7684,7716,7740,-258,-234,8,61.93,24
810,y1012,20100114,7716,7740,7790,7790,7786,7788,7788,48,48,10,77.88,34
811,y1012,20100115,7788,7788,7700,7700,7642,7642,7650,-146,-138,24,183.64,36
812,y1012,20100118,7642,7650,7680,7680,7666,7666,7672,16,22,4,30.69,40
813,y1012,20100119,7666,7672,7744,7744,7676,7676,7710,4,38,4,30.84,40
814,y1012,20100120,7676,7710,7644,7644,7644,7644,7644,-66,-66,20,152.88,40
815,y1012,20100121,7644,7644,7560,7600,7560,7600,7586,-44,-58,6,45.52,38
816,y1012,20100122,7600,7586,0,0,0,7586,7586,0,0,0,0,38
817,y1012,20100125,7586,7586,7568,7600,7568,7600,7578,14,-8,600,4547.4,638
818,y1012,20100126,7600,7578,7516,7516,7516,7516,7516,-62,-62,2,15.03,640
819,y1012,20100127,7516,7516,7494,7566,7470,7566,7520,50,4,8,60.16,640
820,y1012,20100128,7566,7520,7390,7390,7390,7390,7390,-130,-130,2,14.78,638
821,y1012,20100129,7390,7390,0,0,0,7390,7390,0,0,0,0,638
822,y1012,20100201,7390,7390,7296,7296,7296,7296,7296,-94,-94,2,14.59,638
823,y1012,20100202,7296,7296,7426,7426,7228,7228,7296,-68,0,8,58.37,636
824,y1012,20100203,7228,7296,0,0,0,7296,7296,0,0,0,0,636
825,y1012,20100204,7296,7296,0,0,0,7296,7296,0,0,0,0,636
826,y1012,20100205,7296,7296,7352,7392,7312,7320,7340,24,44,18,132.13,636
827,y1012,20100208,7320,7340,7468,7468,7466,7466,7466,126,126,76,567.42,654
828,y1012,20100209,7466,7466,7440,7488,7440,7488,7440,22,-26,212,1577.38,862
829,y1012,20100210,7488,7440,0,0,0,7440,7440,0,0,0,0,862
830,y1012,20100211,7440,7440,7444,7498,7444,7498,7446,58,6,232,1727.68,852
831,y1012,20100212,7498,7446,7452,7548,7444,7548,7452,102,6,452,3369.12,438
832,y1012,20100222,7548,7452,7526,7530,7526,7530,7526,78,74,12,90.32,428
833,y1012,20100223,7530,7526,0,0,0,7526,7526,0,0,0,0,428
834,y1012,20100224,7526,7526,0,0,0,7526,7526,0,0,0,0,428
835,y1012,20100225,7526,7526,7646,7646,7566,7566,7606,40,80,4,30.42,430
836,y1012,20100226,7566,7606,0,0,0,7606,7606,0,0,0,0,430
837,y1012,20100301,7606,7606,7644,7644,7616,7616,7630,10,24,4,30.52,432
838,y1012,20100302,7616,7630,7658,7658,7546,7546,7610,-84,-20,6,45.66,432
839,y1012,20100303,7546,7610,7620,7660,7620,7660,7640,50,30,4,30.56,432
840,y1012,20100304,7660,7640,0,0,0,7640,7640,0,0,0,0,432
841,y1012,20100305,7640,7640,7552,7612,7552,7612,7582,-28,-58,4,30.33,432
842,y1012,20100308,7612,7582,7570,7570,7570,7570,7570,-12,-12,4,30.28,434
843,y1012,20100309,7570,7570,7600,7682,7600,7682,7612,112,42,128,974.49,432
844,y1012,20100310,7682,7612,7700,7702,7644,7660,7670,48,58,2082,15972.37,434
845,y1012,20100311,7660,7670,7696,7720,7602,7620,7638,-50,-32,2416,18457.92,434
846,y1012,20100312,7620,7638,7590,7620,7580,7584,7598,-54,-40,1926,14635.84,434
847,y1012,20100315,7584,7598,7624,7624,7536,7552,7568,-46,-30,3604,27280.43,434
848,y1012,20100316,7552,7568,7550,7560,7520,7544,7542,-24,-26,3480,26247.48,434
849,y1012,20100317,7544,7542,0,0,0,7542,7542,0,0,0,0,434
850,y1012,20100318,7542,7542,0,0,0,7542,7542,0,0,0,0,434
851,y1012,20100319,7542,7542,7512,7602,7512,7528,7560,-14,18,44,332.7,434
852,y1012,20100322,7528,7560,0,0,0,7560,7560,0,0,0,0,434
853,y1012,20100323,7560,7560,0,0,0,7560,7560,0,0,0,0,434
854,y1012,20100324,7560,7560,0,0,0,7560,7530,0,-30,2,15.06,436
855,y1012,20100325,7560,7530,0,0,0,7530,7530,0,0,0,0,436
856,y1012,20100326,7530,7530,0,0,0,7530,7692,0,162,2,15.38,434
857,y1012,20100329,7530,7692,0,0,0,7692,7692,0,0,0,0,434
858,y1012,20100330,7692,7692,0,0,0,7692,7692,0,0,0,0,434
859,y1012,20100331,7692,7692,7698,7698,7698,7698,7698,6,6,722,5557.96,1154
860,y1012,20100401,7698,7698,7616,7686,7616,7686,7650,-12,-48,4,30.6,1154
861,y1012,20100402,7686,7650,7664,7666,7664,7666,7664,16,14,8,61.32,1148
862,y1012,20100406,7666,7664,0,0,0,7664,7664,0,0,0,0,1148
863,y1012,20100407,7664,7664,7776,7776,7776,7776,7776,112,112,4,31.1,1146
864,y1012,20100408,7776,7776,0,0,0,7776,7776,0,0,0,0,1146
865,y1012,20100409,7776,7776,7776,7846,7776,7784,7814,8,38,204,1594.18,1146
866,y1012,20100412,7784,7814,7868,7868,7868,7868,7868,54,54,2,15.74,1148
867,y1012,20100413,7868,7868,7804,7804,7760,7760,7796,-108,-72,14,109.14,1140
868,y1012,20100414,7760,7796,0,0,0,7796,7796,0,0,0,0,1140
869,y1012,20100415,7796,7796,7760,7760,7760,7760,7760,-36,-36,2,15.52,1140
870,y1012,20100416,7760,7760,7848,7848,7742,7834,7804,74,44,106,827.33,1140
871,y1012,20100419,7834,7804,0,0,0,7804,7804,0,0,0,0,1140
872,y1012,20100420,7804,7804,7730,7786,7730,7786,7758,-18,-46,4,31.03,1140
873,y1012,20100421,7786,7758,0,0,0,7758,7758,0,0,0,0,1140
874,y1012,20100422,7758,7758,0,0,0,7758,7758,0,0,0,0,1140
875,y1012,20100423,7758,7758,0,0,0,7758,7758,0,0,0,0,1140
876,y1012,20100426,7758,7758,7964,7964,7742,7900,7874,142,116,56,441.03,1158
877,y1012,20100427,7900,7874,0,0,0,7874,7824,0,-50,2,15.65,1160
878,y1012,20100428,7874,7824,0,0,0,7824,7844,0,20,2,15.69,1158
879,y1012,20100429,7824,7844,7724,7778,7724,7750,7750,-94,-94,16,124.01,1158
880,y1012,20100430,7750,7750,0,0,0,7750,7822,0,72,2,15.64,1160
881,y1012,20100504,7750,7822,7756,7756,7724,7740,7734,-82,-88,228,1763.61,946
882,y1012,20100505,7740,7734,0,0,0,7734,7734,0,0,0,0,946
883,y1012,20100506,7734,7734,7730,7730,7700,7700,7722,-34,-12,12,92.68,944
884,y1012,20100507,7700,7722,7620,7620,7544,7544,7580,-178,-142,16,121.3,932
885,y1012,20100510,7544,7580,7556,7642,7556,7642,7588,62,8,6,45.53,928
886,y1012,20100511,7642,7588,0,0,0,7588,7588,0,0,0,0,928
887,y1012,20100512,7588,7588,7600,7600,7600,7600,7600,12,12,2,15.2,926
888,y1012,20100513,7600,7600,0,0,0,7600,7600,0,0,0,0,926
889,y1012,20100514,7600,7600,0,0,0,7600,7600,0,0,0,0,926
890,y1012,20100517,7600,7600,7454,7498,7444,7446,7450,-154,-150,88,655.72,904
891,y1012,20100518,7446,7450,7532,7538,7452,7480,7480,30,30,208,1556.06,1104
892,y1012,20100519,7480,7480,0,0,0,7480,7480,0,0,0,0,1104
893,y1012,20100520,7480,7480,7506,7506,7506,7506,7506,26,26,2,15.01,1104
894,y1012,20100521,7506,7506,7560,7650,7560,7650,7604,144,98,4,30.42,1102
895,y1012,20100524,7650,7604,7502,7502,7502,7502,7502,-102,-102,2,15,1100
896,y1012,20100525,7502,7502,7458,7548,7458,7548,7502,46,0,4,30.01,1100
897,y1012,20100526,7548,7502,7598,7598,7472,7472,7512,-30,10,8,60.1,1100
898,y1012,20100527,7472,7512,7472,7572,7472,7572,7504,60,-8,6,45.03,1102
899,y1012,20100528,7572,7504,7582,7582,7582,7582,7582,78,78,4,30.33,1102
900,y1012,20100531,7582,7582,7500,7560,7500,7560,7530,-22,-52,4,30.12,1104
901,y1012,20100601,7560,7530,7468,7530,7468,7492,7492,-38,-38,1066,7987.1,2166
902,y1012,20100602,7492,7492,7502,7502,7502,7502,7502,10,10,120,900.24,2046
903,y1012,20100603,7502,7502,0,0,0,7502,7502,0,0,0,0,2046
904,y1012,20100604,7502,7502,7550,7576,7484,7484,7536,-18,34,6,45.22,2044
905,y1012,20100607,7484,7536,7380,7380,7378,7380,7378,-156,-158,10,73.79,2042
906,y1012,20100608,7380,7378,7380,7432,7380,7430,7412,52,34,10,74.13,2040
907,y1012,20100609,7430,7412,7410,7410,7330,7374,7370,-38,-42,6,44.23,2038
908,y1012,20100610,7374,7370,7450,7450,7420,7420,7420,50,50,502,3724.9,1536
909,y1012,20100611,7420,7420,7468,7468,7468,7468,7468,48,48,18,134.42,1554
910,y1012,20100617,7468,7468,0,0,0,7468,7468,0,0,0,0,1554
911,y1012,20100618,7468,7468,0,0,0,7468,7468,0,0,0,0,1554
912,y1012,20100621,7468,7468,7550,7668,7550,7668,7560,200,92,114,861.94,1448
913,y1012,20100622,7668,7560,7602,7602,7582,7582,7600,22,40,348,2645.46,1794
914,y1012,20100623,7582,7600,0,0,0,7600,7600,0,0,0,0,1794
915,y1012,20100624,7600,7600,0,0,0,7600,7600,0,0,0,0,1794
916,y1012,20100625,7600,7600,7540,7552,7540,7552,7550,-48,-50,304,2295.78,2096
917,y1012,20100628,7552,7550,0,0,0,7550,7550,0,0,0,0,2096
918,y1012,20100629,7550,7550,7500,7500,7500,7500,7500,-50,-50,2,15,2098
919,y1012,20100630,7500,7500,7378,7386,7378,7378,7380,-122,-120,6,44.28,2100
920,y1012,20100701,7378,7380,7398,7398,7398,7398,7398,18,18,346,2559.71,1754
921,y1012,20100702,7398,7398,7354,7354,7346,7346,7350,-52,-48,64,470.49,1756
922,y1012,20100705,7346,7350,7304,7358,7304,7318,7316,-32,-34,10,73.18,1756
923,y1012,20100706,7318,7316,0,0,0,7316,7316,0,0,0,0,1756
924,y1012,20100707,7316,7316,0,0,0,7316,7316,0,0,0,0,1756
925,y1012,20100708,7316,7316,7414,7414,7370,7370,7390,54,74,16,118.24,1760
926,y1012,20100709,7370,7390,7242,7408,7242,7372,7316,-18,-74,8,58.53,1762
927,y1012,20100712,7372,7316,7398,7398,7394,7394,7396,78,80,4,29.58,1760
928,y1012,20100713,7394,7396,0,0,0,7396,7396,0,0,0,0,1760
929,y1012,20100714,7396,7396,7252,7400,7252,7400,7302,4,-94,58,423.6,1784
930,y1012,20100715,7400,7302,0,0,0,7302,7302,0,0,0,0,1784
931,y1012,20100716,7302,7302,7498,7540,7498,7540,7538,238,236,600,4523.03,2312
932,y1012,20100719,7540,7538,7528,7528,7460,7460,7516,-78,-22,24,180.42,2312
933,y1012,20100720,7460,7516,0,0,0,7516,7516,0,0,0,0,2312
934,y1012,20100721,7516,7516,7518,7518,7502,7502,7504,-14,-12,10,75.05,2314
935,y1012,20100722,7502,7504,7520,7528,7512,7520,7518,16,14,24,180.45,2330
936,y1012,20100723,7520,7518,7546,7564,7546,7562,7556,44,38,638,4821.02,1930
937,y1012,20100726,7562,7556,7560,7610,7560,7600,7574,44,18,128,969.56,1898
938,y1012,20100727,7600,7574,7504,7504,7500,7500,7502,-74,-72,26,195.08,1892
939,y1012,20100728,7500,7502,7532,7532,7532,7532,7532,30,30,10,75.32,1882
940,y1012,20100729,7532,7532,7600,7600,7600,7600,7600,68,68,4,30.4,1882
941,y1012,20100730,7600,7600,7614,7614,7546,7594,7588,-6,-12,8,60.71,1882
942,y1012,20100802,7594,7588,7650,7748,7650,7722,7678,134,90,18,138.22,1882
943,y1012,20100803,7722,7678,7748,7750,7700,7750,7724,72,46,82,633.48,1922
944,y1012,20100804,7750,7724,0,0,0,7724,7724,0,0,0,0,1922
945,y1012,20100805,7724,7724,7874,7882,7874,7882,7876,158,152,6,47.26,1922
946,y1012,20100806,7882,7876,7746,7828,7742,7828,7778,-48,-98,28,217.83,1922
947,y1012,20100809,7828,7778,7862,8020,7862,8020,7986,242,208,68,543.05,1920
948,y1012,20100810,8020,7986,7982,7982,7982,7982,7982,-4,-4,12,95.78,1920
949,y1012,20100811,7982,7982,8028,8028,7940,7960,7980,-22,-2,16,127.68,1920
950,y1012,20100812,7960,7980,7988,7988,7900,7900,7946,-80,-34,8,63.58,1920
951,y1012,20100813,7900,7946,7980,8172,7980,8052,8120,106,174,26,211.16,1930
952,y1012,20100816,8052,8120,8170,8170,8068,8120,8124,0,4,118,958.72,1838
953,y1012,20100817,8120,8124,8120,8260,8020,8056,8122,-68,-2,120,974.84,1838
954,y1012,20100818,8056,8122,8150,8150,8090,8138,8104,16,-18,14,113.48,1828
955,y1012,20100819,8138,8104,7874,7956,7874,7956,7910,-148,-194,18,142.38,1824
956,y1012,20100820,7956,7910,7838,7906,7822,7830,7878,-80,-32,58,456.97,1854
957,y1012,20100823,7830,7878,7870,7870,7830,7830,7850,-48,-28,10,78.5,1852
958,y1012,20100824,7830,7850,7734,7838,7734,7838,7808,-12,-42,14,109.32,1838
959,y1012,20100825,7838,7808,7840,7850,7740,7740,7742,-68,-66,1104,8547.97,2916
960,y1012,20100826,7740,7742,7866,7880,7758,7758,7814,16,72,70,547.08,2920
961,y1012,20100827,7758,7814,7898,7898,7836,7870,7870,56,56,40,314.87,2920
962,y1012,20100830,7870,7870,7936,7936,7936,7936,7936,66,66,4,31.74,2916
963,y1012,20100831,7936,7936,7808,7894,7808,7848,7842,-88,-94,1296,10164.13,1882
964,y1012,20100901,7848,7842,7828,7942,7782,7810,7844,-32,2,104,815.94,1868
965,y1012,20100902,7810,7844,7884,7898,7798,7898,7848,54,4,172,1349.86,1784
966,y1012,20100903,7898,7848,7898,7966,7850,7906,7900,58,52,118,932.22,1794
967,y1012,20100906,7906,7900,8010,8016,7938,7986,7984,86,84,572,4567.2,1852
968,y1012,20100907,7986,7984,7936,7986,7886,7984,7948,0,-36,66,524.58,1848
969,y1012,20100908,7984,7948,7980,7982,7960,7960,7960,12,12,208,1655.84,1644
970,y1012,20100909,7960,7960,7940,7940,7684,7842,7824,-118,-136,126,985.93,1678
971,y1012,20100910,7842,7824,7862,7898,7862,7870,7870,46,46,60,472.24,1652
972,y1012,20100913,7870,7870,7850,7860,7850,7860,7854,-10,-16,24,188.54,1634
973,y1012,20100914,7860,7854,7892,7892,7892,7892,7892,38,38,2,15.78,1634
974,y1012,20100915,7892,7892,0,0,0,7892,7892,0,0,0,0,1634
975,y1012,20100916,7892,7892,0,0,0,7892,7892,0,0,0,0,1634
976,y1012,20100917,7892,7892,0,0,0,7892,7892,0,0,0,0,1634
977,y1012,20100920,7892,7892,7986,8068,7986,8048,8044,156,152,496,3990.2,1226
978,y1012,20100921,8048,8044,8002,8004,7962,7962,7996,-82,-48,28,223.9,1236
979,y1012,20100927,7962,7996,8266,8266,8204,8266,8234,270,238,46,378.78,1232
980,y1012,20100928,8266,8234,8268,8270,8266,8270,8268,36,34,32,264.62,1204
981,y1012,20100929,8270,8268,8260,8260,8200,8230,8214,-38,-54,58,476.45,1152
982,y1012,20100930,8230,8214,0,0,0,8214,8214,0,0,0,0,1152
983,y1012,20101008,8214,8214,0,0,0,8214,8214,0,0,0,0,1152
984,y1012,20101011,8214,8214,8542,8542,8542,8542,8542,328,328,2,17.08,1150
985,y1012,20101012,8542,8542,0,0,0,8542,8542,0,0,0,0,1150
986,y1012,20101013,8542,8542,0,0,0,8542,8542,0,0,0,0,1150
987,y1012,20101014,8542,8542,8782,8782,8782,8782,8782,240,240,4,35.13,1150
988,y1012,20101015,8782,8782,8764,8798,8750,8798,8774,16,-8,98,859.95,1072
989,y1012,20101018,8798,8774,0,0,0,8774,8774,0,0,0,0,1072
990,y1012,20101019,8774,8774,0,0,0,8774,8774,0,0,0,0,1072
991,y1012,20101020,8774,8774,8700,8848,8700,8848,8736,74,-38,22,192.2,1056
992,y1012,20101021,8848,8736,8950,8950,8948,8948,8948,212,212,6,53.69,1054
993,y1012,20101022,8948,8948,8950,8950,8950,8950,8950,2,2,4,35.8,1054
994,y1012,20101025,8950,8950,9080,9190,8980,9100,9094,150,144,14,127.32,1054
995,y1012,20101026,9100,9094,9200,9200,9018,9018,9152,-76,58,30,274.61,1044
996,y1012,20101027,9018,9152,9200,9200,9080,9130,9104,-22,-48,36,327.8,1040
997,y1012,20101028,9130,9104,9040,9040,9004,9004,9022,-100,-82,4,36.09,1042
998,y1012,20101029,9004,9022,9002,9002,8792,8830,8838,-192,-184,54,477.32,1000
999,y1012,20101101,8830,8838,8850,8850,8850,8850,8850,12,12,4,35.4,996
1000,y1012,20101102,8850,8850,9034,9040,9034,9040,9036,190,186,6,54.22,990
1001,y1012,20101103,9040,9036,0,0,0,9036,9036,0,0,0,0,990
1002,y1012,20101104,9036,9036,9100,9100,9100,9100,9100,64,64,2,18.2,990
1003,y1012,20101105,9100,9100,9250,9464,9250,9464,9304,364,204,824,7667.28,184
1004,y1012,20101108,9464,9304,9676,9676,9676,9676,9676,372,372,44,425.74,142
1005,y1012,20101109,9676,9676,9772,9786,9492,9492,9774,-184,98,108,1055.68,42
1006,y1012,20101110,9492,9774,9880,9880,9880,9880,9880,106,106,16,158.08,28
1007,y1012,20101111,9880,9880,0,0,0,9880,9880,0,0,0,0,28
1008,y1012,20101112,9880,9880,10274,10274,9500,9500,9926,-380,46,48,476.45,28
1009,y1012,20101115,9500,9926,10000,10098,9530,9530,9786,-396,-140,24,234.87,38
1010,y1012,20101116,9530,9786,9530,9588,9500,9588,9538,-198,-248,6,57.24,36
1011,y1012,20101117,9588,9538,0,0,0,9538,9538,0,0,0,0,36
1012,y1012,20101118,9538,9538,9400,9400,9158,9158,9202,-380,-336,22,202.45,26
1013,y1012,20101119,9158,9202,9100,9100,9100,9100,9100,-102,-102,4,36.4,22
1014,y1012,20101122,9100,9100,9458,9458,8800,8800,9082,-300,-18,14,127.15,16
1015,y1012,20101123,8800,9082,8900,8900,8900,8900,8900,-182,-182,8,71.2,10
1016,y1012,20101124,8900,8900,8900,8900,8900,8900,8900,0,0,6,53.4,4
1017,y1012,20101125,8900,8900,9120,9120,9120,9120,9120,220,220,2,18.24,2
1018,y1012,20101126,9120,9120,0,0,0,9120,9120,0,0,0,0,2
1019,y1012,20101129,9120,9120,0,0,0,9120,9120,0,0,0,0,2
1020,y1012,20101130,9120,9120,8574,8574,8574,8574,8574,-546,-546,2,17.15,2
1021,y1012,20101201,8574,8574,0,0,0,8574,8574,0,0,0,0,0
1022,y1012,20101202,8574,8574,0,0,0,8574,8574,0,0,0,0,0
1023,y1012,20101203,8574,8574,0,0,0,8574,8574,0,0,0,0,0
1024,y1012,20101206,8574,8574,0,0,0,8574,8574,0,0,0,0,0
1025,y1012,20101207,8574,8574,0,0,0,8574,8574,0,0,0,0,0
1026,y1012,20101208,8574,8574,0,0,0,8574,8574,0,0,0,0,0
1027,y1012,20101209,8574,8574,0,0,0,8574,8574,0,0,0,0,0
1028,y1012,20101210,8574,8574,0,0,0,8574,8574,0,0,0,0,0
1029,y1012,20101213,8574,8574,0,0,0,8574,8574,0,0,0,0,0
1030,y1012,20101214,8574,8574,0,0,0,8574,8574,0,0,0,0,0
1031,y1101,20100118,,7572,7580,7704,7502,7600,7578,28,6,2728,20677.15,1486
1032,y1101,20100119,7600,7578,7620,7690,7612,7618,7662,40,84,1680,12875.44,2244
1033,y1101,20100120,7618,7662,7640,7646,7508,7508,7566,-154,-96,1688,12774.46,3622
1034,y1101,20100121,7508,7566,7450,7594,7450,7588,7530,22,-36,688,5181.23,3922
1035,y1101,20100122,7588,7530,7532,7610,7450,7570,7514,40,-16,1040,7815.4,3996
1036,y1101,20100125,7570,7514,7560,7580,7528,7548,7556,34,42,1378,10414.59,4640
1037,y1101,20100126,7548,7556,7548,7550,7448,7448,7498,-108,-58,514,3854.35,4760
1038,y1101,20100127,7448,7498,7490,7522,7460,7514,7496,16,-2,786,5892.26,4910
1039,y1101,20100128,7514,7496,7414,7454,7388,7438,7428,-58,-68,704,5229.76,5264
1040,y1101,20100129,7438,7428,7434,7490,7382,7392,7438,-36,10,902,6710.39,5626
1041,y1101,20100201,7392,7438,7404,7406,7300,7332,7356,-106,-82,3796,27924.65,6682
1042,y1101,20100202,7332,7356,7356,7450,7308,7318,7344,-38,-12,1998,14676.56,7684
1043,y1101,20100203,7318,7344,7432,7452,7280,7452,7392,108,48,5162,38159.08,9846
1044,y1101,20100204,7452,7392,7380,7414,7360,7384,7378,-8,-14,1326,9784.69,10204
1045,y1101,20100205,7384,7378,7304,7424,7304,7388,7392,10,14,2734,20214.63,11734
1046,y1101,20100208,7388,7392,7450,7484,7440,7474,7468,82,76,1866,13938.24,12478
1047,y1101,20100209,7474,7468,7498,7522,7460,7510,7504,42,36,7462,55998.75,12870
1048,y1101,20100210,7510,7504,7520,7552,7472,7506,7536,2,32,5178,39026.15,14262
1049,y1101,20100211,7506,7536,7550,7620,7538,7568,7582,32,46,1716,13012.13,14440
1050,y1101,20100212,7568,7582,7554,7578,7504,7540,7534,-42,-48,1504,11331.3,14646
1051,y1101,20100222,7540,7534,7650,7664,7600,7638,7630,104,96,3434,26204.62,15642
1052,y1101,20100223,7638,7630,7640,7702,7636,7702,7664,72,34,7586,58149.83,16280
1053,y1101,20100224,7702,7664,7664,7664,7620,7634,7634,-30,-30,3416,26081.56,16934
1054,y1101,20100225,7634,7634,7666,7690,7562,7586,7630,-48,-4,4074,31085.39,17640
1055,y1101,20100226,7586,7630,7590,7604,7560,7570,7578,-60,-52,2660,20158.34,18310
1056,y1101,20100301,7570,7578,7682,7684,7612,7628,7640,50,62,2650,20249.51,18302
1057,y1101,20100302,7628,7640,7640,7668,7606,7624,7632,-16,-8,3442,26272.26,18802
1058,y1101,20100303,7624,7632,7660,7688,7640,7678,7670,46,38,3224,24729.95,19032
1059,y1101,20100304,7678,7670,7670,7684,7598,7616,7630,-54,-40,4766,36366.47,19038
1060,y1101,20100305,7616,7630,7618,7686,7574,7670,7638,40,8,4872,37212.67,20104
1061,y1101,20100308,7670,7638,7668,7720,7662,7706,7694,68,56,13768,105941.36,24940
1062,y1101,20100309,7706,7694,7694,7754,7678,7746,7720,52,26,12100,93423.08,28182
1063,y1101,20100310,7746,7720,7710,7760,7708,7738,7740,18,20,11366,87982.11,29004
1064,y1101,20100311,7738,7740,7798,7798,7640,7682,7706,-58,-34,13780,106196.82,28252
1065,y1101,20100312,7682,7706,7628,7676,7602,7610,7638,-96,-68,10626,81179.06,31928
1066,y1101,20100315,7610,7638,7590,7634,7566,7588,7610,-50,-28,26422,201104.03,35060
1067,y1101,20100316,7588,7610,7550,7610,7520,7606,7564,-4,-46,29400,222429.69,42624
1068,y1101,20100317,7606,7564,7628,7646,7614,7632,7630,68,66,9300,70967.44,45694
1069,y1101,20100318,7632,7630,7632,7642,7560,7574,7596,-56,-34,25178,191270.44,45038
1070,y1101,20100319,7574,7596,7574,7618,7574,7616,7604,20,8,9316,70840.16,45908
1071,y1101,20100322,7616,7604,7602,7656,7592,7624,7632,20,28,14878,113549.87,47066
1072,y1101,20100323,7624,7632,7650,7674,7632,7646,7654,14,22,19668,150571.41,49392
1073,y1101,20100324,7646,7654,7646,7652,7596,7632,7626,-22,-28,24244,184926.46,50752
1074,y1101,20100325,7632,7626,7620,7680,7602,7654,7654,28,28,23278,178205.32,53436
1075,y1101,20100326,7654,7654,7620,7626,7588,7612,7606,-42,-48,14152,107652.71,55134
1076,y1101,20100329,7612,7606,7628,7640,7590,7614,7608,8,2,21654,164781.58,64686
1077,y1101,20100330,7614,7608,7630,7734,7596,7692,7666,84,58,53194,407838.96,70870
1078,y1101,20100331,7692,7666,7650,7742,7650,7688,7704,22,38,66164,509849.21,78120
1079,y1101,20100401,7688,7704,7660,7702,7630,7670,7670,-34,-34,38128,292443.82,88156
1080,y1101,20100402,7670,7670,7700,7714,7682,7702,7694,32,24,21900,168499.42,94078
1081,y1101,20100406,7702,7694,7714,7738,7692,7710,7716,16,22,31020,239386.62,95628
1082,y1101,20100407,7710,7716,7742,7846,7732,7838,7808,122,92,122930,959911.25,114620
1083,y1101,20100408,7838,7808,7810,7860,7804,7806,7830,-2,22,73482,575449.13,114362
1084,y1101,20100409,7806,7830,7830,7880,7812,7862,7848,32,18,77014,604555.65,122796
1085,y1101,20100412,7862,7848,7896,7904,7852,7882,7878,34,30,74502,587066.83,128316
1086,y1101,20100413,7882,7878,7822,7848,7780,7836,7822,-42,-56,102482,801657.97,132858
1087,y1101,20100414,7836,7822,7856,7888,7832,7844,7862,22,40,175614,1380939.26,167532
1088,y1101,20100415,7844,7862,7830,7866,7822,7842,7844,-20,-18,130286,1022182.04,172568
1089,y1101,20100416,7842,7844,7860,7904,7844,7896,7878,52,34,246806,1944355.49,197546
1090,y1101,20100419,7896,7878,7860,7876,7760,7760,7810,-118,-68,296868,2318595.35,193798
1091,y1101,20100420,7760,7810,7800,7830,7784,7808,7808,-2,-2,278168,2172472.84,230116
1092,y1101,20100421,7808,7808,7808,7868,7790,7854,7832,46,24,356916,2795491.3,257676
1093,y1101,20100422,7854,7832,7848,7874,7828,7848,7852,16,20,336952,2646006.3,276454
1094,y1101,20100423,7848,7852,7868,7966,7854,7942,7932,90,80,769652,6105472.01,357812
1095,y1101,20100426,7942,7932,7980,7986,7930,7942,7956,10,24,514990,4097969.84,382764
1096,y1101,20100427,7942,7956,7926,7970,7904,7950,7936,-6,-20,613814,4872108.95,412556
1097,y1101,20100428,7950,7936,7876,7902,7826,7866,7874,-70,-62,536804,4227692.89,391936
1098,y1101,20100429,7866,7874,7842,7872,7820,7830,7844,-44,-30,428048,3357968.02,383130
1099,y1101,20100430,7830,7844,7860,7868,7796,7868,7840,24,-4,441396,3461056.45,399616
1100,y1101,20100504,7868,7840,7836,7850,7812,7828,7832,-12,-8,310912,2435410.7,410240
1101,y1101,20100505,7828,7832,7788,7866,7770,7864,7834,32,2,483192,3786070.14,446486
1102,y1101,20100506,7864,7834,7870,7900,7760,7770,7832,-64,-2,626428,4907422.35,422558
1103,y1101,20100507,7770,7832,7680,7718,7602,7620,7648,-212,-184,630374,4821907.74,385508
1104,y1101,20100510,7620,7648,7674,7732,7652,7732,7680,84,32,411118,3158171.91,367300
1105,y1101,20100511,7732,7680,7716,7726,7664,7670,7690,-10,10,481488,3703462.03,369592
1106,y1101,20100512,7670,7690,7690,7748,7676,7720,7722,30,32,529938,4092946.42,369712
1107,y1101,20100513,7720,7722,7728,7734,7644,7704,7688,-18,-34,516662,3972939.44,382238
1108,y1101,20100514,7704,7688,7676,7686,7634,7642,7658,-46,-30,373674,2862291.36,377606
1109,y1101,20100517,7642,7658,7600,7616,7422,7472,7494,-186,-164,787354,5900753.75,352338
1110,y1101,20100518,7472,7494,7490,7546,7448,7542,7504,48,10,498282,3739394.42,338868
1111,y1101,20100519,7542,7504,7492,7544,7478,7512,7512,8,8,369510,2776116.16,339792
1112,y1101,20100520,7512,7512,7552,7598,7542,7562,7570,50,58,391970,2967243.6,343198
1113,y1101,20100521,7562,7570,7520,7612,7520,7606,7568,36,-2,416874,3155721.24,349512
1114,y1101,20100524,7606,7568,7588,7624,7576,7598,7598,30,30,404172,3071023.34,344250
1115,y1101,20100525,7598,7598,7588,7588,7510,7520,7548,-78,-50,370860,2799514.24,343022
1116,y1101,20100526,7520,7548,7560,7582,7502,7574,7544,26,-4,357592,2698104.22,345704
1117,y1101,20100527,7574,7544,7596,7600,7556,7594,7576,50,32,313744,2377464.21,341846
1118,y1101,20100528,7594,7576,7630,7630,7566,7580,7596,4,20,256722,1950369.32,328048
1119,y1101,20100531,7580,7596,7548,7550,7508,7510,7530,-86,-66,254784,1918606.22,333288
1120,y1101,20100601,7510,7530,7518,7572,7472,7504,7520,-26,-10,513236,3859797.26,351086
1121,y1101,20100602,7504,7520,7518,7566,7496,7560,7534,40,14,431364,3250388.75,335564
1122,y1101,20100603,7560,7534,7566,7588,7522,7558,7552,24,18,414168,3128502.72,333318
1123,y1101,20100604,7558,7552,7564,7626,7558,7596,7596,44,44,530998,4034246.5,343718
1124,y1101,20100607,7596,7596,7440,7458,7380,7434,7424,-162,-172,577568,4288853.63,323240
1125,y1101,20100608,7434,7424,7434,7462,7428,7448,7444,24,20,276396,2057527.66,319442
1126,y1101,20100609,7448,7444,7440,7462,7386,7450,7424,6,-20,519428,3856613.56,331122
1127,y1101,20100610,7450,7424,7452,7470,7424,7430,7442,6,18,280188,2085415.98,321654
1128,y1101,20100611,7430,7442,7430,7456,7406,7410,7434,-32,-8,181260,1347530.61,323564
1129,y1101,20100617,7410,7434,7520,7530,7494,7510,7514,76,80,233088,1751747.11,304360
1130,y1101,20100618,7510,7514,7524,7558,7516,7542,7540,28,26,266112,2006485.62,309258
1131,y1101,20100621,7542,7540,7578,7662,7564,7642,7620,102,80,436086,3323061.83,337972
1132,y1101,20100622,7642,7620,7600,7638,7600,7618,7616,-2,-4,180852,1377371.7,332720
1133,y1101,20100623,7618,7616,7574,7618,7574,7598,7594,-18,-22,249362,1894100.54,330452
1134,y1101,20100624,7598,7594,7580,7608,7576,7580,7590,-14,-4,196244,1489817.27,336612
1135,y1101,20100625,7580,7590,7562,7576,7544,7560,7562,-30,-28,195242,1476497.01,341116
1136,y1101,20100628,7560,7562,7558,7586,7538,7542,7564,-20,2,189472,1433374.58,345146
1137,y1101,20100629,7542,7564,7528,7542,7454,7460,7496,-104,-68,288726,2164542.6,353566
1138,y1101,20100630,7460,7496,7382,7428,7382,7420,7408,-76,-88,215392,1595974.2,355738
1139,y1101,20100701,7420,7408,7418,7444,7356,7360,7406,-48,-2,228376,1691725.89,372812
1140,y1101,20100702,7360,7406,7350,7390,7338,7382,7366,-24,-40,273418,2014263.57,375468
1141,y1101,20100705,7382,7366,7378,7382,7336,7338,7362,-28,-4,166166,1223388.22,383586
1142,y1101,20100706,7338,7362,7306,7354,7270,7342,7306,-20,-56,324684,2372434.73,383262
1143,y1101,20100707,7342,7306,7340,7354,7312,7332,7332,26,26,199256,1461101.6,380948
1144,y1101,20100708,7332,7332,7410,7428,7384,7394,7404,62,72,216852,1605976,377174
1145,y1101,20100709,7394,7404,7416,7446,7400,7438,7422,34,18,197692,1467407.3,366234
1146,y1101,20100712,7438,7422,7478,7484,7420,7426,7454,4,32,195920,1460594.05,339134
1147,y1101,20100713,7426,7454,7440,7466,7414,7440,7442,-14,-12,271446,2020108.47,340080
1148,y1101,20100714,7440,7442,7488,7490,7464,7478,7472,36,30,162770,1216480.12,333800
1149,y1101,20100715,7478,7472,7476,7510,7462,7474,7482,2,10,162076,1212953.56,329180
1150,y1101,20100716,7474,7482,7552,7576,7530,7576,7554,94,72,257846,1948228.72,339464
1151,y1101,20100719,7576,7554,7548,7564,7538,7562,7546,8,-8,136572,1030803.08,330044
1152,y1101,20100720,7562,7546,7520,7564,7506,7554,7534,8,-12,222082,1673217.25,329280
1153,y1101,20100721,7554,7534,7594,7596,7538,7558,7566,24,32,194268,1470114.04,331834
1154,y1101,20100722,7558,7566,7560,7596,7540,7586,7570,20,4,243204,1841232.37,340124
1155,y1101,20100723,7586,7570,7600,7646,7600,7624,7624,54,54,198730,1515453.12,336650
1156,y1101,20100726,7624,7624,7630,7686,7616,7648,7658,24,34,286246,2192500.52,347498
1157,y1101,20100727,7648,7658,7620,7636,7556,7562,7596,-96,-62,214594,1630283.56,328690
1158,y1101,20100728,7562,7596,7568,7606,7562,7600,7588,4,-8,132142,1002931.84,315854
1159,y1101,20100729,7600,7588,7638,7688,7618,7674,7656,86,68,244562,1872544.95,309412
1160,y1101,20100730,7674,7656,7698,7738,7682,7692,7706,36,50,191636,1476923.35,314412
1161,y1101,20100802,7692,7706,7780,7868,7760,7842,7822,136,116,262754,2055620.32,310614
1162,y1101,20100803,7842,7822,7850,7876,7800,7846,7842,24,20,218280,1711899.95,295554
1163,y1101,20100804,7846,7842,7900,7930,7842,7876,7888,34,46,243252,1919013.3,283560
1164,y1101,20100805,7876,7888,7914,7960,7822,7836,7880,-52,-8,195052,1537064.74,273918
1165,y1101,20100806,7836,7880,7860,8018,7840,8008,7910,128,30,228092,1804426.14,271692
1166,y1101,20100809,8008,7910,8008,8178,7978,8146,8092,236,182,383156,3100727.4,257874
1167,y1101,20100810,8146,8092,8100,8146,8050,8070,8088,-22,-4,210398,1701892.75,230260
1168,y1101,20100811,8070,8088,8082,8128,8046,8052,8094,-36,6,132748,1074476.13,228174
1169,y1101,20100812,8052,8094,8050,8086,8006,8044,8046,-50,-48,125302,1008386.45,227870
1170,y1101,20100813,8044,8046,8088,8218,8060,8208,8144,162,98,129080,1051462.96,224654
1171,y1101,20100816,8208,8144,8254,8318,8226,8228,8262,84,118,149754,1237507.35,228676
1172,y1101,20100817,8228,8262,8150,8210,8144,8206,8178,-56,-84,97450,797037.56,220362
1173,y1101,20100818,8206,8178,8226,8260,8090,8114,8172,-64,-6,131174,1071963.46,206946
1174,y1101,20100819,8114,8172,8120,8132,8046,8110,8096,-62,-76,122810,994357.19,195272
1175,y1101,20100820,8110,8096,8000,8010,7898,7906,7970,-190,-126,95210,758914.92,181592
1176,y1101,20100823,7906,7970,7922,7962,7894,7920,7934,-50,-36,73606,584033.7,175858
1177,y1101,20100824,7920,7934,7896,7960,7866,7886,7922,-48,-12,58612,464344.82,171484
1178,y1101,20100825,7886,7922,7900,7942,7836,7858,7896,-64,-26,57596,454836.54,165064
1179,y1101,20100826,7858,7896,7886,7924,7876,7918,7896,22,0,47242,373091.54,160852
1180,y1101,20100827,7918,7896,7950,7990,7926,7988,7956,92,60,50744,403792.82,157274
1181,y1101,20100830,7988,7956,8052,8084,8030,8064,8060,108,104,38904,313585.03,154928
1182,y1101,20100831,8064,8060,8008,8008,7910,7912,7944,-148,-116,34820,276674.67,149620
1183,y1101,20100901,7912,7944,7898,7974,7888,7918,7936,-26,-8,33488,265762.77,145702
1184,y1101,20100902,7918,7936,7940,7976,7928,7972,7952,36,16,27772,220869.13,147890
1185,y1101,20100903,7972,7952,7970,8064,7970,8050,8018,98,66,43702,350484.64,147902
1186,y1101,20100906,8050,8018,8098,8130,8070,8090,8098,72,80,38038,308101.82,134224
1187,y1101,20100907,8090,8098,8120,8142,8066,8140,8104,42,6,39552,320606.53,133784
1188,y1101,20100908,8140,8104,8192,8210,8112,8122,8160,18,56,33910,276713.24,126564
1189,y1101,20100909,8122,8160,8158,8170,7836,8020,8028,-140,-132,58912,473030.8,127278
1190,y1101,20100910,8020,8028,8042,8080,8010,8058,8048,30,20,22560,181576.04,123994
1191,y1101,20100913,8058,8048,8040,8070,8012,8064,8028,16,-20,34150,274184.04,123396
1192,y1101,20100914,8064,8028,8052,8096,8012,8026,8052,-2,24,22970,184961.71,119422
1193,y1101,20100915,8026,8052,8068,8074,8020,8036,8048,-16,-4,19780,159219.32,115952
1194,y1101,20100916,8036,8048,8048,8096,7988,8030,8052,-18,4,21162,170424.94,115818
1195,y1101,20100917,8030,8052,8038,8072,8038,8058,8058,6,6,19646,158318.44,112982
1196,y1101,20100920,8058,8058,8178,8358,8178,8298,8286,240,228,38760,321224.78,101134
1197,y1101,20100921,8298,8286,8290,8294,8196,8252,8240,-34,-46,18464,152174.23,97150
1198,y1101,20100927,8252,8240,8520,8634,8450,8496,8534,256,294,21972,187541.4,94128
1199,y1101,20100928,8496,8534,8496,8584,8362,8580,8522,46,-12,12176,103774.74,93316
1200,y1101,20100929,8580,8522,8526,8526,8364,8426,8436,-96,-86,11006,92865.75,91440
1201,y1101,20100930,8426,8436,8418,8468,8352,8458,8424,22,-12,9022,76008.06,88016
1202,y1101,20101008,8458,8424,8430,8496,8400,8428,8466,4,42,13360,113115.65,88156
1203,y1101,20101011,8428,8466,8804,8804,8804,8804,8804,338,338,704,6198.02,87598
1204,y1101,20101012,8804,8804,8850,8890,8712,8848,8832,44,28,14284,126160.95,83438
1205,y1101,20101013,8848,8832,8850,8918,8822,8860,8856,28,24,6304,55832.37,82624
1206,y1101,20101014,8860,8856,8900,8968,8870,8938,8910,82,54,10094,89954.37,80400
1207,y1101,20101015,8938,8910,8950,8996,8886,8976,8944,66,34,20448,182900.38,68980
1208,y1101,20101018,8976,8944,8850,8890,8778,8812,8830,-132,-114,7294,64416.96,68084
1209,y1101,20101019,8812,8830,8838,8980,8838,8910,8926,80,96,9238,82459.22,66820
1210,y1101,20101020,8910,8926,8736,8912,8728,8888,8838,-38,-88,9340,82561.34,64596
1211,y1101,20101021,8888,8838,9088,9138,9010,9050,9070,212,232,8528,77360.37,61398
1212,y1101,20101022,9050,9070,9030,9108,9030,9076,9072,6,2,5488,49789.98,59968
1213,y1101,20101025,9076,9072,9198,9320,9166,9270,9242,198,170,12396,114586.7,55562
1214,y1101,20101026,9270,9242,9268,9274,9196,9252,9244,10,2,4274,39511.04,54812
1215,y1101,20101027,9252,9244,9286,9336,9008,9012,9156,-232,-88,6192,56700.62,53452
1216,y1101,20101028,9012,9156,9072,9182,9072,9174,9146,18,-10,3504,32048.05,51950
1217,y1101,20101029,9174,9146,9126,9154,8984,9000,9044,-146,-102,5770,52186.62,49738
1218,y1101,20101101,9000,9044,9068,9182,9066,9158,9162,114,118,7826,71707.11,44702
1219,y1101,20101102,9158,9162,9172,9202,9110,9152,9150,-10,-12,3082,28201.48,44082
1220,y1101,20101103,9152,9150,9162,9200,9118,9138,9172,-12,22,2794,25629.97,42396
1221,y1101,20101104,9138,9172,9196,9424,9166,9420,9302,248,130,10972,102080.7,34120
1222,y1101,20101105,9420,9302,9602,9674,9568,9674,9648,372,346,1880,18141.52,33254
1223,y1101,20101108,9674,9648,9652,9880,9560,9784,9772,136,124,5050,49352.94,33014
1224,y1101,20101109,9784,9772,9686,9938,9686,9900,9836,128,64,4070,40033.22,30160
1225,y1101,20101110,9900,9836,9990,10200,9834,9882,9976,46,140,5634,56215.14,25588
1226,y1101,20101111,9882,9976,9984,10046,9856,9912,9976,-64,0,1986,19814.78,24660
1227,y1101,20101112,9912,9976,9920,9920,9578,9618,9662,-358,-314,4164,40238.8,23298
1228,y1101,20101115,9618,9662,9662,9718,9416,9626,9614,-36,-48,4306,41398.83,20922
1229,y1101,20101116,9626,9614,9698,9750,9550,9566,9632,-48,18,5322,51271.72,17772
1230,y1101,20101117,9566,9632,9250,9350,9248,9248,9274,-384,-358,1440,13355.06,17504
1231,y1101,20101118,9248,9274,9588,9606,9004,9272,9266,-2,-8,2230,20663.65,16428
1232,y1101,20101119,9272,9266,9332,9374,9086,9270,9244,4,-22,1124,10390.59,16532
1233,y1101,20101122,9270,9244,9198,9198,9070,9070,9102,-174,-142,2318,21100.23,16182
1234,y1101,20101123,9070,9102,9108,9126,8928,8954,9028,-148,-74,1220,11016.58,15850
1235,y1101,20101124,8954,9028,9030,9168,9000,9168,9060,140,32,1104,10002.59,15184
1236,y1101,20101125,9168,9060,9168,9280,9112,9146,9226,86,166,1192,10999.24,14318
1237,y1101,20101126,9146,9226,9152,9166,8990,9066,9104,-160,-122,600,5462.87,13996
1238,y1101,20101129,9066,9104,9138,9150,9010,9146,9070,42,-34,692,6276.7,13548
1239,y1101,20101130,9146,9070,9150,9208,9070,9208,9128,138,58,742,6773.06,13168
1240,y1101,20101201,9208,9128,9180,9268,9170,9250,9222,122,94,1608,14829.36,13080
1241,y1101,20101202,9250,9222,9350,9400,9310,9348,9350,126,128,2794,26123.96,10900
1242,y1101,20101203,9348,9350,9322,9360,9282,9358,9340,8,-10,452,4222.28,10876
1243,y1101,20101206,9358,9340,9392,9426,9380,9408,9402,68,62,836,7860.72,10730
1244,y1101,20101207,9408,9402,9418,9418,9380,9418,9390,16,-12,952,8940.26,10244
1245,y1101,20101208,9418,9390,9322,9358,9280,9280,9322,-110,-68,396,3691.94,10188
1246,y1101,20101209,9280,9322,9388,9388,9308,9310,9332,-12,10,344,3210.35,10046
1247,y1101,20101210,9310,9332,9290,9346,9290,9346,9312,14,-20,1612,15014.07,8850
1248,y1101,20101213,9346,9312,9330,9550,9330,9534,9488,222,176,324,3074.12,8634
1249,y1101,20101214,9534,9488,9616,9628,9570,9628,9580,140,92,1014,9715.75,7754
1250,y1101,20101215,9628,9580,9638,9698,9580,9598,9632,18,52,386,3718.66,7644
1251,y1101,20101216,9598,9632,9554,9628,9554,9628,9624,-4,-8,52,500.54,7626
1252,y1101,20101217,9628,9624,9676,9740,9670,9682,9694,58,70,792,7678.4,7182
1253,y1101,20101220,9682,9694,9750,9840,9680,9700,9770,6,76,1896,18524.5,5974
1254,y1101,20101221,9700,9770,9700,9730,9690,9710,9720,-60,-50,1408,13686.22,4992
1255,y1101,20101222,9710,9720,9552,10302,9552,9810,9900,90,180,336,3326.92,5034
1256,y1101,20101223,9810,9900,9924,9998,9902,9952,9928,52,28,120,1191.42,5080
1257,y1101,20101224,9952,9928,9912,9952,9802,9914,9878,-14,-50,162,1600.38,5126
1258,y1101,20101227,9914,9878,9930,9970,9930,9960,9948,82,70,418,4158.37,5404
1259,y1101,20101228,9960,9948,10012,10140,10012,10100,10082,152,134,82,826.72,5402
1260,y1101,20101229,10100,10082,10002,10040,9936,9960,9988,-122,-94,292,2916.55,5484
1261,y1101,20101230,9960,9988,9850,10128,9850,10128,10002,140,14,128,1280.29,5548
1262,y1101,20101231,10128,10002,10056,10138,10054,10120,10074,118,72,242,2438.35,5512
1263,y1103,20100315,,7696,0,0,0,7696,7696,0,0,0,0,0
1264,y1103,20100316,7696,7696,0,0,0,7696,7696,0,0,0,0,0
1265,y1103,20100317,7696,7696,0,0,0,7696,7696,0,0,0,0,0
1266,y1103,20100318,7696,7696,0,0,0,7696,7696,0,0,0,0,0
1267,y1103,20100319,7696,7696,0,0,0,7696,7696,0,0,0,0,0
1268,y1103,20100322,7696,7696,7898,7898,7700,7700,7798,4,102,4,31.2,0
1269,y1103,20100323,7700,7798,0,0,0,7798,7798,0,0,0,0,0
1270,y1103,20100324,7798,7798,0,0,0,7798,7798,0,0,0,0,0
1271,y1103,20100325,7798,7798,0,0,0,7798,7798,0,0,0,0,0
1272,y1103,20100326,7798,7798,7582,7746,7582,7746,7664,-52,-134,100,766.4,0
1273,y1103,20100329,7746,7664,0,0,0,7664,7664,0,0,0,0,0
1274,y1103,20100330,7664,7664,0,0,0,7664,7664,0,0,0,0,0
1275,y1103,20100331,7664,7664,0,0,0,7664,7664,0,0,0,0,0
1276,y1103,20100401,7664,7664,7746,7746,7746,7746,7746,82,82,2,15.49,2
1277,y1103,20100402,7746,7746,7798,7798,7798,7798,7798,52,52,2,15.6,2
1278,y1103,20100406,7798,7798,7880,7880,7880,7880,7880,82,82,4,31.52,6
1279,y1103,20100407,7880,7880,7882,7882,7882,7882,7882,2,2,4,31.53,2
1280,y1103,20100408,7882,7882,0,0,0,7882,7882,0,0,0,0,2
1281,y1103,20100409,7882,7882,7900,7940,7900,7940,7920,58,38,4,31.68,4
1282,y1103,20100412,7940,7920,0,0,0,7920,7920,0,0,0,0,4
1283,y1103,20100413,7920,7920,7800,7800,7800,7800,7800,-120,-120,240,1872,244
1284,y1103,20100414,7800,7800,0,0,0,7800,7800,0,0,0,0,244
1285,y1103,20100415,7800,7800,0,0,0,7800,7800,0,0,0,0,244
1286,y1103,20100416,7800,7800,0,0,0,7800,7800,0,0,0,0,244
1287,y1103,20100419,7800,7800,7922,7926,7800,7802,7850,2,50,18,141.32,250
1288,y1103,20100420,7802,7850,7900,7900,7870,7870,7884,20,34,6,47.31,248
1289,y1103,20100421,7870,7884,0,0,0,7884,7884,0,0,0,0,248
1290,y1103,20100422,7884,7884,7810,7900,7810,7900,7872,16,-12,24,188.95,256
1291,y1103,20100423,7900,7872,7960,7960,7946,7946,7950,74,78,6,47.7,256
1292,y1103,20100426,7946,7950,7998,8000,7998,7998,7998,48,48,10,79.98,262
1293,y1103,20100427,7998,7998,8068,8068,8010,8028,8034,30,36,10,80.35,264
1294,y1103,20100428,8028,8034,7968,7978,7902,7978,7974,-56,-60,46,366.82,302
1295,y1103,20100429,7978,7974,7978,7978,7712,7922,7910,-52,-64,50,395.58,296
1296,y1103,20100430,7922,7910,7910,7926,7900,7926,7912,16,2,18,142.42,296
1297,y1103,20100504,7926,7912,0,0,0,7912,7912,0,0,0,0,296
1298,y1103,20100505,7912,7912,7900,7910,7862,7910,7882,-2,-30,24,189.18,300
1299,y1103,20100506,7910,7882,7878,7878,7878,7878,7878,-4,-4,4,31.51,300
1300,y1103,20100507,7878,7878,7700,7762,7668,7690,7728,-188,-150,48,370.96,320
1301,y1103,20100510,7690,7728,7768,7796,7748,7796,7774,68,46,44,342.12,320
1302,y1103,20100511,7796,7774,7634,7778,7634,7736,7710,-38,-64,52,400.94,324
1303,y1103,20100512,7736,7710,7854,7856,7778,7778,7828,68,118,8,62.63,328
1304,y1103,20100513,7778,7828,7818,7818,7750,7778,7766,-50,-62,36,279.59,344
1305,y1103,20100514,7778,7766,7750,7750,7730,7730,7742,-36,-24,6,46.46,348
1306,y1103,20100517,7730,7742,7640,7708,7508,7550,7596,-192,-146,58,440.66,366
1307,y1103,20100518,7550,7596,7592,7720,7574,7630,7594,34,-2,38,288.64,344
1308,y1103,20100519,7630,7594,7604,7634,7590,7590,7600,-4,6,248,1885.26,584
1309,y1103,20100520,7590,7600,7650,7660,7650,7660,7652,60,52,10,76.53,584
1310,y1103,20100521,7660,7652,7706,7712,7640,7670,7674,18,22,122,936.24,590
1311,y1103,20100524,7670,7674,7718,7728,7650,7650,7698,-24,24,6,46.19,592
1312,y1103,20100525,7650,7698,7650,7650,7604,7604,7628,-94,-70,38,289.89,576
1313,y1103,20100526,7604,7628,7712,7712,7604,7636,7638,8,10,8,61.11,582
1314,y1103,20100527,7636,7638,7628,7650,7602,7650,7626,12,-12,6,45.76,580
1315,y1103,20100528,7650,7626,7626,7646,7616,7646,7628,20,2,6,45.78,580
1316,y1103,20100531,7646,7628,7592,7592,7592,7592,7594,-36,-34,4,30.38,578
1317,y1103,20100601,7592,7594,0,0,0,7594,7594,0,0,0,0,578
1318,y1103,20100602,7594,7594,7596,7596,7590,7590,7592,-4,-2,4,30.37,578
1319,y1103,20100603,7590,7592,7620,7620,7620,7620,7612,28,20,4,30.45,576
1320,y1103,20100604,7620,7612,7650,7664,7650,7664,7662,52,50,204,1563.4,772
1321,y1103,20100607,7664,7662,7412,7552,7412,7466,7472,-196,-190,60,448.33,768
1322,y1103,20100608,7466,7472,7500,7500,7448,7494,7468,22,-4,332,2479.92,1084
1323,y1103,20100609,7494,7468,7470,7524,7468,7518,7502,50,34,226,1695.75,1016
1324,y1103,20100610,7518,7502,0,0,0,7502,7502,0,0,0,0,1016
1325,y1103,20100611,7502,7502,7488,7518,7488,7500,7500,-2,-2,614,4605.04,412
1326,y1103,20100617,7500,7500,7562,7562,7562,7562,7562,62,62,2,15.12,412
1327,y1103,20100618,7562,7562,7590,7604,7590,7590,7596,28,34,452,3433.78,860
1328,y1103,20100621,7590,7596,7650,7698,7626,7698,7664,102,68,22,168.61,858
1329,y1103,20100622,7698,7664,7662,7688,7658,7674,7680,10,16,512,3932.56,930
1330,y1103,20100623,7674,7680,7650,7650,7650,7650,7650,-30,-30,4,30.6,930
1331,y1103,20100624,7650,7650,7642,7642,7642,7642,7642,-8,-8,4,30.57,930
1332,y1103,20100625,7642,7642,7590,7590,7590,7590,7590,-52,-52,4,30.36,934
1333,y1103,20100628,7590,7590,7578,7616,7578,7598,7596,8,6,528,4011.74,1454
1334,y1103,20100629,7598,7596,7554,7554,7528,7528,7540,-68,-56,4,30.16,1450
1335,y1103,20100630,7528,7540,7440,7456,7440,7456,7442,-84,-98,10,74.43,1448
1336,y1103,20100701,7456,7442,7440,7442,7440,7442,7440,0,-2,20,148.81,1448
1337,y1103,20100702,7442,7440,7392,7392,7392,7392,7392,-48,-48,2,14.78,1448
1338,y1103,20100705,7392,7392,0,0,0,7392,7392,0,0,0,0,1448
1339,y1103,20100706,7392,7392,7268,7378,7268,7360,7328,-32,-64,30,219.88,1450
1340,y1103,20100707,7360,7328,0,0,0,7328,7328,0,0,0,0,1450
1341,y1103,20100708,7328,7328,0,0,0,7328,7328,0,0,0,0,1450
1342,y1103,20100709,7328,7328,7372,7456,7372,7428,7398,100,70,92,680.77,1422
1343,y1103,20100712,7428,7398,7474,7478,7432,7432,7458,34,60,32,238.66,1422
1344,y1103,20100713,7432,7458,7420,7420,7420,7420,7420,-38,-38,4,29.68,1422
1345,y1103,20100714,7420,7420,0,0,0,7420,7420,0,0,0,0,1422
1346,y1103,20100715,7420,7420,7504,7504,7492,7496,7498,76,78,32,239.94,1410
1347,y1103,20100716,7496,7498,0,0,0,7498,7498,0,0,0,0,1410
1348,y1103,20100719,7498,7498,7562,7562,7562,7562,7562,64,64,300,2268.6,1710
1349,y1103,20100720,7562,7562,7526,7526,7526,7526,7526,-36,-36,2,15.05,1710
1350,y1103,20100721,7526,7526,7550,7550,7550,7550,7550,24,24,2,15.1,1710
1351,y1103,20100722,7550,7550,7530,7618,7530,7618,7588,68,38,602,4568.8,2286
1352,y1103,20100723,7618,7588,7630,7650,7630,7650,7630,62,42,60,457.92,2264
1353,y1103,20100726,7650,7630,7646,7708,7646,7694,7668,64,38,42,322.08,2264
1354,y1103,20100727,7694,7668,7630,7630,7610,7616,7624,-52,-44,14,106.75,2258
1355,y1103,20100728,7616,7624,7626,7626,7626,7626,7626,2,2,6,45.76,2254
1356,y1103,20100729,7626,7626,7688,7688,7688,7688,7688,62,62,6,46.13,2248
1357,y1103,20100730,7688,7688,7732,7790,7702,7714,7722,26,34,224,1729.9,2426
1358,y1103,20100802,7714,7722,7882,7882,7882,7882,7882,160,160,10,78.82,2416
1359,y1103,20100803,7882,7882,7908,7954,7902,7902,7930,20,48,22,174.49,2404
1360,y1103,20100804,7902,7930,8100,8100,7902,7964,8002,34,72,114,912.23,2464
1361,y1103,20100805,7964,8002,7992,7992,7900,7900,7962,-102,-40,64,509.66,2460
1362,y1103,20100806,7900,7962,7974,8062,7974,8062,8024,100,62,40,321.02,2448
1363,y1103,20100809,8062,8024,8102,8284,8088,8264,8202,240,178,122,1000.88,2460
1364,y1103,20100810,8264,8202,8210,8210,8168,8174,8180,-28,-22,46,376.32,2420
1365,y1103,20100811,8174,8180,8256,8256,8192,8196,8210,16,30,24,197.06,2434
1366,y1103,20100812,8196,8210,8122,8152,8084,8134,8126,-76,-84,158,1284.12,2386
1367,y1103,20100813,8134,8126,8330,8338,8320,8320,8328,194,202,78,649.68,2410
1368,y1103,20100816,8320,8328,8350,8388,8286,8314,8344,-14,16,144,1201.68,2404
1369,y1103,20100817,8314,8344,8228,8284,8194,8252,8230,-92,-114,82,674.98,2374
1370,y1103,20100818,8252,8230,8268,8336,8118,8118,8202,-112,-28,188,1542,2396
1371,y1103,20100819,8118,8202,8140,8190,8092,8134,8134,-68,-68,52,423.04,2394
1372,y1103,20100820,8134,8134,8058,8058,7930,7964,7978,-170,-156,96,766,2412
1373,y1103,20100823,7964,7978,8016,8028,7958,8000,7998,22,20,394,3151.67,2590
1374,y1103,20100824,8000,7998,7940,8000,7918,7918,7988,-80,-10,312,2492.53,2356
1375,y1103,20100825,7918,7988,7968,7974,7884,7906,7932,-82,-56,136,1078.91,2382
1376,y1103,20100826,7906,7932,7930,8020,7924,8020,7932,88,0,174,1380.48,2234
1377,y1103,20100827,8020,7932,7988,8046,7984,8030,8024,98,92,74,593.8,2226
1378,y1103,20100830,8030,8024,8078,8130,8078,8118,8114,94,90,32,259.71,2234
1379,y1103,20100831,8118,8114,8002,8008,7990,7996,7998,-118,-116,36,287.98,2232
1380,y1103,20100901,7996,7998,8008,8040,7954,7962,7980,-36,-18,678,5411.2,2772
1381,y1103,20100902,7962,7980,7986,8000,7986,7986,7992,6,12,8,63.94,2766
1382,y1103,20100903,7986,7992,8054,8108,8008,8108,8070,116,78,66,532.72,2740
1383,y1103,20100906,8108,8070,8124,8200,8124,8170,8164,100,94,28,228.62,2750
1384,y1103,20100907,8170,8164,8184,8228,8144,8228,8190,64,26,46,376.79,2744
1385,y1103,20100908,8228,8190,8436,8436,8206,8206,8228,16,38,222,1827.05,2646
1386,y1103,20100909,8206,8228,8206,8206,7982,8090,8078,-138,-150,136,1098.69,2672
1387,y1103,20100910,8090,8078,8136,8136,8086,8130,8128,52,50,44,357.69,2660
1388,y1103,20100913,8130,8128,8112,8112,8106,8106,8110,-22,-18,8,64.88,2656
1389,y1103,20100914,8106,8110,8140,8178,8110,8120,8152,10,42,40,326.14,2654
1390,y1103,20100915,8120,8152,8130,8146,8100,8146,8116,-6,-36,48,389.58,2650
1391,y1103,20100916,8146,8116,8186,8186,8080,8082,8106,-34,-10,948,7684.82,1720
1392,y1103,20100917,8082,8106,8146,8146,8112,8112,8128,6,22,132,1073.05,1736
1393,y1103,20100920,8112,8128,8374,8446,8014,8406,8344,278,216,368,3071.31,1708
1394,y1103,20100921,8406,8344,8400,8400,8400,8400,8400,56,56,2,16.8,1710
1395,y1103,20100927,8400,8400,8786,8786,8606,8630,8744,230,344,72,629.66,1752
1396,y1103,20100928,8630,8744,8624,8682,8624,8680,8660,-64,-84,12,103.94,1752
1397,y1103,20100929,8680,8660,8638,8638,8404,8482,8556,-178,-104,250,2139.12,1564
1398,y1103,20100930,8482,8556,8516,8540,8480,8500,8536,-56,-20,236,2014.56,1548
1399,y1103,20101008,8500,8536,8618,8618,8434,8524,8558,-12,22,42,359.52,1574
1400,y1103,20101011,8524,8558,8890,8900,8722,8900,8860,342,302,32,283.57,1572
1401,y1103,20101012,8900,8860,8810,8948,8810,8906,8872,46,12,56,496.92,1548
1402,y1103,20101013,8906,8872,8872,9000,8872,8902,8964,30,92,60,537.86,1562
1403,y1103,20101014,8902,8964,8992,9032,8972,9020,8996,56,32,84,755.8,1526
1404,y1103,20101015,9020,8996,8990,9040,8936,9012,8990,16,-6,24,215.76,1528
1405,y1103,20101018,9012,8990,8926,8978,8900,8978,8918,-12,-72,204,1819.31,1500
1406,y1103,20101019,8978,8918,8880,9188,8880,9058,9028,140,110,80,722.36,1538
1407,y1103,20101020,9058,9028,8844,9016,8844,8996,8936,-32,-92,32,286.01,1546
1408,y1103,20101021,8996,8936,9234,9282,9064,9190,9180,254,244,126,1156.91,1522
1409,y1103,20101022,9190,9180,9200,9264,9178,9190,9212,10,32,10,92.12,1520
1410,y1103,20101025,9190,9212,9376,9566,9294,9380,9436,168,224,86,811.64,1538
1411,y1103,20101026,9380,9436,9400,9470,9256,9332,9398,-104,-38,228,2143.03,1362
1412,y1103,20101027,9332,9398,9372,9372,9230,9230,9262,-168,-136,74,685.52,1348
1413,y1103,20101028,9230,9262,0,0,0,9262,9262,0,0,0,0,1348
1414,y1103,20101029,9262,9262,9200,9284,9086,9118,9168,-144,-94,26,238.38,1344
1415,y1103,20101101,9118,9168,0,0,0,9168,9168,0,0,0,0,1344
1416,y1103,20101102,9168,9168,9382,9382,9210,9316,9314,148,146,34,316.7,1344
1417,y1103,20101103,9316,9314,9364,9364,9312,9312,9344,-2,30,8,74.76,1344
1418,y1103,20101104,9312,9344,9374,9640,9374,9640,9546,296,202,40,381.87,1350
1419,y1103,20101105,9640,9546,9748,9926,9514,9926,9820,380,274,236,2317.96,1436
1420,y1103,20101108,9926,9820,10198,10198,9674,9992,10012,172,192,618,6188.64,1058
1421,y1103,20101109,9992,10012,9888,10092,9888,10020,10022,8,10,212,2124.74,982
1422,y1103,20101110,10020,10022,10214,10214,10002,10040,10128,18,106,42,425.46,982
1423,y1103,20101111,10040,10128,10092,10158,10074,10074,10114,-54,-14,12,121.37,980
1424,y1103,20101112,10074,10114,9732,9848,9710,9710,9718,-404,-396,82,796.89,972
1425,y1103,20101115,9710,9718,9444,9498,9400,9498,9458,-220,-260,72,680.98,930
1426,y1103,20101116,9498,9458,9634,9634,9394,9444,9534,-14,76,36,343.26,944
1427,y1103,20101117,9444,9534,9154,9154,9154,9154,9154,-380,-380,10,91.54,944
1428,y1103,20101118,9154,9154,8814,9256,8814,9090,9052,-64,-102,112,1013.88,946
1429,y1103,20101119,9090,9052,9082,9272,9082,9098,9120,46,68,26,237.15,948
1430,y1103,20101122,9098,9120,9196,9196,9000,9000,9048,-120,-72,16,144.77,948
1431,y1103,20101123,9000,9048,9088,9090,8864,8866,8966,-182,-82,44,394.55,944
1432,y1103,20101124,8866,8966,8950,9032,8950,9032,8994,66,28,88,791.64,948
1433,y1103,20101125,9032,8994,9086,9194,9066,9080,9094,86,100,18,163.7,946
1434,y1103,20101126,9080,9094,9248,9248,8768,8884,9014,-210,-80,44,396.64,946
1435,y1103,20101129,8884,9014,9000,9070,8932,9070,9064,56,50,432,3915.76,1322
1436,y1103,20101130,9070,9064,9070,9120,9070,9120,9070,56,6,158,1433.36,1172
1437,y1103,20101201,9120,9070,9098,9250,9098,9250,9246,180,176,416,3847.16,760
1438,y1103,20101202,9250,9246,9362,9362,9350,9350,9354,104,108,6,56.13,760
1439,y1103,20101203,9350,9354,9350,9350,9322,9322,9340,-32,-14,6,56.04,760
1440,y1103,20101206,9322,9340,9432,9432,9430,9430,9430,90,90,6,56.58,756
1441,y1103,20101207,9430,9430,9438,9478,9438,9478,9456,48,26,14,132.4,754
1442,y1103,20101208,9478,9456,9448,9516,9350,9416,9410,-40,-46,36,338.76,734
1443,y1103,20101209,9416,9410,0,0,0,9410,9410,0,0,0,0,734
1444,y1103,20101210,9410,9410,0,0,0,9410,9410,0,0,0,0,734
1445,y1103,20101213,9410,9410,9498,9588,9474,9578,9518,168,108,12,114.22,734
1446,y1103,20101214,9578,9518,9650,9820,9616,9616,9676,98,158,22,212.91,732
1447,y1103,20101215,9616,9676,9696,9790,9650,9652,9692,-24,16,22,213.24,732
1448,y1103,20101216,9652,9692,9640,9640,9566,9566,9610,-126,-82,16,153.76,722
1449,y1103,20101217,9566,9610,9566,9566,9484,9484,9524,-126,-86,4,38.1,720
1450,y1103,20101220,9484,9524,9484,9748,9484,9628,9624,104,100,22,211.77,726
1451,y1103,20101221,9628,9624,9700,9766,9700,9766,9720,142,96,22,213.88,710
1452,y1103,20101222,9766,9720,9810,9924,9800,9800,9808,80,88,70,686.62,648
1453,y1103,20101223,9800,9808,9910,10038,9910,10000,9956,192,148,22,219.04,652
1454,y1103,20101224,10000,9956,10046,10046,10046,10046,10046,90,90,2,20.09,652
1455,y1103,20101227,10046,10046,10080,10080,9854,10032,10012,-14,-34,10,100.13,646
1456,y1103,20101228,10032,10012,10226,10226,10102,10202,10178,190,166,12,122.14,644
1457,y1103,20101229,10202,10178,10080,10080,10080,10080,10080,-98,-98,8,80.64,640
1458,y1103,20101230,10080,10080,9984,10064,9984,10064,9992,-16,-88,514,5136.16,126
1459,y1103,20101231,10064,9992,10116,10268,10056,10080,10112,88,120,40,404.5,130
1460,y1105,20100518,,7658,7620,7660,7560,7654,7616,-4,-42,166,1264.32,128
1461,y1105,20100519,7654,7616,7632,7632,7632,7632,7632,16,16,2,15.26,130
1462,y1105,20100520,7632,7632,7686,7696,7650,7650,7650,18,18,664,5080.84,722
1463,y1105,20100521,7650,7650,7644,7696,7620,7690,7658,40,8,454,3477.32,918
1464,y1105,20100524,7690,7658,7682,7700,7658,7692,7686,34,28,628,4827.64,1228
1465,y1105,20100525,7692,7686,7684,7684,7620,7620,7652,-66,-34,338,2586.39,1326
1466,y1105,20100526,7620,7652,7652,7660,7604,7654,7636,2,-16,1270,9699.73,2312
1467,y1105,20100527,7654,7636,7670,7674,7638,7666,7654,30,18,1820,13932.24,3454
1468,y1105,20100528,7666,7654,7688,7696,7640,7652,7672,-2,18,1570,12047.18,4330
1469,y1105,20100531,7652,7672,7630,7652,7600,7604,7624,-68,-48,1942,14809.27,4628
1470,y1105,20100601,7604,7624,7612,7660,7574,7604,7604,-20,-20,1904,14480.16,5112
1471,y1105,20100602,7604,7604,7618,7668,7610,7668,7646,64,42,2396,18323.02,5732
1472,y1105,20100603,7668,7646,7666,7686,7630,7670,7658,24,12,588,4503.75,5696
1473,y1105,20100604,7670,7658,7678,7728,7666,7692,7692,34,34,1294,9954.76,5808
1474,y1105,20100607,7692,7692,7600,7600,7470,7516,7522,-176,-170,3144,23651.58,6878
1475,y1105,20100608,7516,7522,7524,7536,7518,7526,7524,4,2,1314,9888.33,7070
1476,y1105,20100609,7526,7524,7520,7532,7462,7520,7502,-4,-22,2844,21337.4,7436
1477,y1105,20100610,7520,7502,7522,7532,7494,7496,7504,-6,2,1942,14576.29,7824
1478,y1105,20100611,7496,7504,7498,7512,7470,7470,7494,-34,-10,996,7464.6,7962
1479,y1105,20100617,7470,7494,7560,7578,7540,7562,7562,68,68,1198,9061.14,8022
1480,y1105,20100618,7562,7562,7570,7606,7568,7580,7584,18,22,1816,13774.07,9062
1481,y1105,20100621,7580,7584,7610,7692,7610,7678,7662,94,78,5974,45773.02,11368
1482,y1105,20100622,7678,7662,7640,7676,7640,7654,7652,-8,-10,3112,23814.97,11888
1483,y1105,20100623,7654,7652,7636,7656,7612,7628,7630,-24,-22,4804,36661.99,13764
1484,y1105,20100624,7628,7630,7630,7640,7612,7618,7624,-12,-6,3722,28383.56,14718
1485,y1105,20100625,7618,7624,7602,7608,7570,7582,7594,-42,-30,6710,50956.81,16960
1486,y1105,20100628,7582,7594,7580,7596,7548,7548,7572,-46,-22,10680,80874.67,21204
1487,y1105,20100629,7548,7572,7542,7552,7462,7478,7500,-94,-72,13210,99076.06,24192
1488,y1105,20100630,7478,7500,7420,7442,7392,7422,7422,-78,-78,13558,100632.97,30452
1489,y1105,20100701,7422,7422,7400,7460,7370,7374,7430,-48,8,14004,104057.33,31954
1490,y1105,20100702,7374,7430,7360,7394,7346,7388,7372,-42,-58,10902,80390.05,33678
1491,y1105,20100705,7388,7372,7382,7382,7328,7334,7352,-38,-20,15476,113801.54,39088
1492,y1105,20100706,7334,7352,7310,7334,7270,7324,7300,-28,-52,11066,80790.58,40322
1493,y1105,20100707,7324,7300,7310,7326,7270,7298,7296,-2,-4,36200,264127.52,58136
1494,y1105,20100708,7298,7296,7370,7384,7326,7330,7348,34,52,31514,231600.15,72516
1495,y1105,20100709,7330,7348,7350,7412,7340,7408,7372,60,24,25570,188528.34,76124
1496,y1105,20100712,7408,7372,7458,7458,7392,7402,7430,30,58,29590,219868.96,80708
1497,y1105,20100713,7402,7430,7418,7428,7376,7390,7404,-40,-26,28992,214695.59,83312
1498,y1105,20100714,7390,7404,7428,7442,7416,7426,7424,22,20,26400,196043.86,91588
1499,y1105,20100715,7426,7424,7416,7450,7416,7422,7432,-2,8,27396,203651.18,93730
1500,y1105,20100716,7422,7432,7480,7540,7470,7536,7510,104,78,43844,329350.37,97352
1501,y1105,20100719,7536,7510,7506,7536,7498,7532,7514,22,4,43536,327155.29,103668
1502,y1105,20100720,7532,7514,7514,7530,7486,7522,7506,8,-8,51688,388058.92,112392
1503,y1105,20100721,7522,7506,7552,7560,7504,7518,7534,12,28,51466,387766.52,121724
1504,y1105,20100722,7518,7534,7518,7564,7496,7562,7532,28,-2,77008,580111.86,129686
1505,y1105,20100723,7562,7532,7600,7626,7576,7604,7600,72,68,71842,546045.6,139520
1506,y1105,20100726,7604,7600,7606,7672,7600,7660,7644,60,44,90146,689197.98,152904
1507,y1105,20100727,7660,7644,7628,7638,7554,7560,7594,-84,-50,96052,729482.86,162142
1508,y1105,20100728,7560,7594,7570,7614,7562,7614,7598,20,4,86456,656942.3,174522
1509,y1105,20100729,7614,7598,7636,7690,7624,7678,7662,80,64,148084,1134680.96,179656
1510,y1105,20100730,7678,7662,7720,7732,7682,7696,7708,34,46,115076,887145.26,178220
1511,y1105,20100802,7696,7708,7760,7892,7760,7858,7842,150,134,214926,1685455.55,193194
1512,y1105,20100803,7858,7842,7878,7928,7808,7880,7880,38,38,325356,2563887.02,217832
1513,y1105,20100804,7880,7880,7928,7988,7902,7942,7944,62,64,560414,4452197.19,247454
1514,y1105,20100805,7942,7944,8008,8032,7854,7884,7926,-60,-18,657556,5212647.17,241308
1515,y1105,20100806,7884,7926,7910,8118,7876,8112,7968,186,42,897476,7152036.65,318512
1516,y1105,20100809,8112,7968,8110,8286,8088,8286,8218,318,250,1411650,11603384.27,425580
1517,y1105,20100810,8286,8218,8244,8296,8176,8218,8226,0,8,1960104,16127321.93,482558
1518,y1105,20100811,8218,8226,8222,8286,8142,8166,8228,-60,2,2018152,16606518.07,504492
1519,y1105,20100812,8166,8228,8160,8198,8102,8146,8154,-82,-74,1486016,12118416.05,456856
1520,y1105,20100813,8146,8154,8150,8354,8150,8342,8280,188,126,2043830,16923835.28,639670
1521,y1105,20100816,8342,8280,8368,8416,8306,8318,8352,38,72,1286198,10743137.91,580582
1522,y1105,20100817,8318,8352,8248,8300,8214,8276,8256,-76,-96,1104418,9119042.97,569508
1523,y1105,20100818,8276,8256,8310,8358,8152,8172,8252,-84,-4,1457260,12027768.59,542326
1524,y1105,20100819,8172,8252,8180,8210,8112,8182,8164,-70,-88,1331264,10870868.96,557058
1525,y1105,20100820,8182,8164,8056,8080,7944,7958,8018,-206,-146,1171970,9398282.78,522832
1526,y1105,20100823,7958,8018,7984,8040,7948,7984,7996,-34,-22,1211220,9685226.34,526066
1527,y1105,20100824,7984,7996,7948,8036,7914,7934,7990,-62,-6,1281752,10241297.67,543396
1528,y1105,20100825,7934,7990,7960,8014,7896,7908,7958,-82,-32,1207532,9611277.18,555574
1529,y1105,20100826,7908,7958,7940,7994,7940,7988,7964,30,6,964484,7681679.22,565328
1530,y1105,20100827,7988,7964,8010,8074,7992,8068,8032,104,68,1145298,9199988.07,574572
1531,y1105,20100830,8068,8032,8136,8168,8104,8144,8140,112,108,877288,7141831.6,573464
1532,y1105,20100831,8144,8140,8068,8072,7980,7988,8012,-152,-128,961378,7704187.38,541148
1533,y1105,20100901,7988,8012,8002,8066,7966,7998,8018,-14,6,955988,7666702.13,557688
1534,y1105,20100902,7998,8018,8022,8060,8000,8052,8030,34,12,1015398,8154279.57,570510
1535,y1105,20100903,8052,8030,8072,8156,8046,8142,8102,112,72,1363246,11047230.21,619040
1536,y1105,20100906,8142,8102,8200,8232,8162,8184,8198,82,96,747332,6127922.26,612082
1537,y1105,20100907,8184,8198,8188,8256,8164,8254,8208,56,10,1086894,8922519.4,646374
1538,y1105,20100908,8254,8208,8326,8328,8224,8234,8268,26,60,711622,5884304.3,619866
1539,y1105,20100909,8234,8268,8260,8280,7938,8102,8116,-166,-152,1388934,11275240.18,530222
1540,y1105,20100910,8102,8116,8140,8182,8094,8150,8138,34,22,805454,6555233.33,533148
1541,y1105,20100913,8150,8138,8158,8176,8102,8172,8132,34,-6,625896,5090798.87,529270
1542,y1105,20100914,8172,8132,8150,8210,8118,8132,8166,0,34,853998,6974442.34,516234
1543,y1105,20100915,8132,8166,8158,8190,8122,8144,8156,-22,-10,765156,6241601.63,519710
1544,y1105,20100916,8144,8156,8170,8208,8080,8142,8146,-14,-10,763476,6220247.25,509474
1545,y1105,20100917,8142,8146,8170,8188,8134,8168,8164,22,18,607496,4959881.14,511048
1546,y1105,20100920,8168,8164,8302,8488,8300,8440,8414,276,250,1116538,9395322.84,543600
1547,y1105,20100921,8440,8414,8420,8424,8306,8398,8370,-16,-44,645028,5400040.12,528948
1548,y1105,20100927,8398,8370,8770,8794,8570,8624,8674,254,304,794444,6891665.85,547824
1549,y1105,20100928,8624,8674,8570,8736,8556,8728,8664,54,-10,777586,6738216.26,610288
1550,y1105,20100929,8728,8664,8650,8674,8488,8572,8574,-92,-90,922938,7914753.5,600670
1551,y1105,20100930,8572,8574,8540,8606,8486,8598,8556,24,-18,640866,5483987.62,602824
1552,y1105,20101008,8598,8556,8498,8626,8492,8536,8576,-20,20,735518,6308958.76,621208
1553,y1105,20101011,8536,8576,8918,8918,8918,8918,8916,342,340,28276,252165.2,598720
1554,y1105,20101012,8918,8916,8918,8986,8808,8932,8928,16,12,1071160,9565007.31,651098
1555,y1105,20101013,8932,8928,8960,9004,8902,8950,8946,22,18,823882,7372086.86,673092
1556,y1105,20101014,8950,8946,9008,9072,8972,9032,9026,86,80,1008760,9105228.34,677036
1557,y1105,20101015,9032,9026,9046,9132,8982,9108,9060,82,34,1054188,9552039.91,700058
1558,y1105,20101018,9108,9060,8990,9008,8868,8900,8938,-160,-122,833138,7446701.71,680528
1559,y1105,20101019,8900,8938,8968,9102,8932,9008,9020,70,82,1253860,11310034.4,708210
1560,y1105,20101020,9008,9020,8814,9018,8812,8982,8942,-38,-78,1009060,9024708.56,693434
1561,y1105,20101021,8982,8942,9128,9298,9124,9192,9218,250,276,1408886,12987211.02,683790
1562,y1105,20101022,9192,9218,9170,9260,9150,9244,9222,26,4,950608,8767310.38,593906
1563,y1105,20101025,9244,9222,9300,9580,9282,9514,9464,292,242,765350,7244384.3,536812
1564,y1105,20101026,9514,9464,9480,9542,9428,9458,9484,-6,20,444330,4214863.56,465348
1565,y1105,20101027,9458,9484,9580,9580,9240,9252,9374,-232,-110,519164,4867678.3,449502
1566,y1105,20101028,9252,9374,9372,9398,9302,9374,9358,0,-16,401378,3756447.85,387396
1567,y1105,20101029,9374,9358,9330,9342,9150,9154,9226,-204,-132,303676,2802004.31,358600
1568,y1105,20101101,9154,9226,9206,9358,9206,9334,9294,108,68,200722,1865845.89,330218
1569,y1105,20101102,9334,9294,9308,9394,9290,9354,9346,60,52,204798,1914427.26,302300
1570,y1105,20101103,9354,9346,9372,9420,9296,9336,9376,-10,30,164872,1546003.82,288978
1571,y1105,20101104,9336,9376,9412,9640,9390,9606,9518,230,142,245128,2333309.47,271614
1572,y1105,20101105,9606,9518,9750,9898,9720,9898,9852,380,334,154582,1523083.82,264282
1573,y1105,20101108,9898,9852,9888,10170,9784,9940,9970,88,118,283302,2824671.38,253176
1574,y1105,20101109,9940,9970,9870,10132,9852,10074,10010,104,40,207452,2076959.85,251560
1575,y1105,20101110,10074,10010,10250,10258,10004,10052,10142,42,132,178104,1806642.38,237154
1576,y1105,20101111,10052,10142,10088,10212,10000,10092,10122,-50,-20,167224,1692827.6,217528
1577,y1105,20101112,10092,10122,10100,10200,9718,9718,9824,-404,-298,224886,2209544,181292
1578,y1105,20101115,9718,9824,9600,9798,9452,9618,9636,-206,-188,194268,1872113.37,155748
1579,y1105,20101116,9618,9636,9716,9722,9500,9508,9606,-128,-30,139818,1343124.12,146934
1580,y1105,20101117,9508,9606,9222,9232,9222,9222,9222,-384,-384,22474,207272.44,133306
1581,y1105,20101118,9222,9222,9250,9342,8940,9200,9150,-22,-72,128830,1178811.29,122098
1582,y1105,20101119,9200,9150,9308,9380,9106,9298,9242,148,92,85634,791521.39,120184
1583,y1105,20101122,9298,9242,9148,9178,9038,9090,9138,-152,-104,49394,451410.56,120478
1584,y1105,20101123,9090,9138,9120,9170,8966,8978,9058,-160,-80,58524,530217.29,117210
1585,y1105,20101124,8978,9058,9002,9220,9002,9214,9118,156,60,42202,384845.98,111702
1586,y1105,20101125,9214,9118,9296,9352,9238,9258,9294,140,176,30622,284652.6,109668
1587,y1105,20101126,9258,9294,9268,9302,9036,9166,9156,-128,-138,36080,330392.17,103400
1588,y1105,20101129,9166,9156,9152,9264,9084,9264,9176,108,20,25772,236513.82,101298
1589,y1105,20101130,9264,9176,9212,9304,9134,9292,9230,116,54,28542,263483.17,99322
1590,y1105,20101201,9292,9230,9270,9420,9248,9400,9340,170,110,27980,261371.39,93584
1591,y1105,20101202,9400,9340,9488,9580,9486,9492,9514,152,174,17248,164127.85,91868
1592,y1105,20101203,9492,9514,9300,9562,9300,9510,9502,-4,-12,15898,151078.51,92274
1593,y1105,20101206,9510,9502,9650,9650,9524,9610,9572,108,70,17058,163292.8,92090
1594,y1105,20101207,9610,9572,9572,9678,9556,9678,9610,106,38,16918,162605.16,91724
1595,y1105,20101208,9678,9610,9560,9602,9462,9466,9544,-144,-66,13954,133188.66,90290
1596,y1105,20101209,9466,9544,9580,9624,9544,9570,9582,26,38,10454,100178.69,90276
1597,y1105,20101210,9570,9582,9522,9590,9512,9564,9552,-18,-30,6122,58485.64,89886
1598,y1105,20101213,9564,9552,9540,9774,9526,9734,9672,182,120,10372,100327.17,89382
1599,y1105,20101214,9734,9672,9794,9822,9738,9822,9776,150,104,11648,113888.05,89138
1600,y1105,20101215,9822,9776,9800,9912,9722,9732,9830,-44,54,14754,145058.74,86678
1601,y1105,20101216,9732,9830,9756,9790,9722,9750,9760,-80,-70,5344,52159.67,86348
1602,y1105,20101217,9750,9760,9760,9820,9752,9786,9790,26,30,4780,46805.56,86194
1603,y1105,20101220,9786,9790,9830,9900,9726,9774,9818,-16,28,14110,138541.26,88858
1604,y1105,20101221,9774,9818,9818,9918,9818,9908,9858,90,40,9242,91119.42,87632
1605,y1105,20101222,9908,9858,9958,9982,9878,9906,9926,48,68,15034,149228.1,90506
1606,y1105,20101223,9906,9926,9930,10184,9930,10164,10084,238,158,17036,171815.13,87880
1607,y1105,20101224,10164,10084,10224,10234,10032,10132,10124,48,40,7228,73185.95,87482
1608,y1105,20101227,10132,10124,10050,10228,10050,10200,10158,76,34,4956,50347,87022
1609,y1105,20101228,10200,10158,10286,10416,10266,10314,10316,156,158,11584,119523.48,83666
1610,y1105,20101229,10314,10316,10302,10302,10098,10116,10202,-200,-114,6642,67774.88,81150
1611,y1105,20101230,10116,10202,10058,10220,10030,10210,10146,8,-56,3394,34440.02,80950
1612,y1105,20101231,10210,10146,10160,10250,10120,10246,10190,100,44,2988,30453.36,80504
1613,y1107,20100715,,7438,0,0,0,7438,7438,0,0,0,0,0
1614,y1107,20100716,7438,7438,0,0,0,7438,7438,0,0,0,0,0
1615,y1107,20100719,7438,7438,7618,7618,7618,7618,7618,180,180,2,15.24,2
1616,y1107,20100720,7618,7618,7618,7618,7618,7618,7618,0,0,2,15.24,4
1617,y1107,20100721,7618,7618,0,0,0,7618,7618,0,0,0,0,4
1618,y1107,20100722,7618,7618,0,0,0,7618,7618,0,0,0,0,4
1619,y1107,20100723,7618,7618,7786,7796,7600,7644,7680,26,62,600,4608.21,0
1620,y1107,20100726,7644,7680,0,0,0,7680,7680,0,0,0,0,0
1621,y1107,20100727,7680,7680,0,0,0,7680,7680,0,0,0,0,0
1622,y1107,20100728,7680,7680,0,0,0,7680,7680,0,0,0,0,0
1623,y1107,20100729,7680,7680,0,0,0,7680,7680,0,0,0,0,0
1624,y1107,20100730,7680,7680,0,0,0,7680,7680,0,0,0,0,0
1625,y1107,20100802,7680,7680,7946,7980,7850,7850,7924,170,244,6,47.55,2
1626,y1107,20100803,7850,7924,0,0,0,7924,7924,0,0,0,0,2
1627,y1107,20100804,7924,7924,7996,7996,7996,7996,7996,72,72,2,15.99,0
1628,y1107,20100805,7996,7996,8002,8002,7884,7976,7954,-20,-42,14,111.36,2
1629,y1107,20100806,7976,7954,7996,8180,7996,8060,8058,106,104,8,64.47,4
1630,y1107,20100809,8060,8058,8232,8232,8232,8232,8232,174,174,2,16.46,6
1631,y1107,20100810,8232,8232,8270,8270,8218,8262,8228,30,-4,30,246.9,12
1632,y1107,20100811,8262,8228,8244,8370,8210,8210,8244,-18,16,22,181.39,8
1633,y1107,20100812,8210,8244,0,0,0,8244,8244,0,0,0,0,8
1634,y1107,20100813,8244,8244,8228,8388,8228,8286,8296,42,52,86,713.54,38
1635,y1107,20100816,8286,8296,8286,8352,8286,8332,8332,36,36,32,266.63,44
1636,y1107,20100817,8332,8332,8234,8286,8156,8286,8246,-46,-86,40,329.89,54
1637,y1107,20100818,8286,8246,8280,8298,8144,8210,8242,-36,-4,14,115.41,54
1638,y1107,20100819,8210,8242,8100,8184,8100,8184,8142,-58,-100,4,32.57,56
1639,y1107,20100820,8184,8142,8052,8088,7998,7998,8052,-144,-90,28,225.47,50
1640,y1107,20100823,7998,8052,8092,8092,7974,8018,7998,-34,-54,88,703.86,56
1641,y1107,20100824,8018,7998,8028,8084,7980,8052,8034,54,36,28,225,64
1642,y1107,20100825,8052,8034,8038,8060,7960,7962,8012,-72,-22,28,224.35,62
1643,y1107,20100826,7962,8012,8068,8068,7988,8056,8020,44,8,18,144.37,60
1644,y1107,20100827,8056,8020,8034,8100,8034,8100,8072,80,52,14,113.02,50
1645,y1107,20100830,8100,8072,8150,8200,8138,8156,8154,84,82,16,130.49,50
1646,y1107,20100831,8156,8154,8050,8098,8050,8064,8070,-90,-84,6,48.42,50
1647,y1107,20100901,8064,8070,7944,8110,7944,8076,8076,6,6,16,129.23,50
1648,y1107,20100902,8076,8076,8088,8116,8050,8116,8090,40,14,588,4757.75,530
1649,y1107,20100903,8116,8090,8128,8236,8108,8174,8156,84,66,18,146.83,530
1650,y1107,20100906,8174,8156,8290,8296,8256,8272,8266,116,110,156,1289.72,652
1651,y1107,20100907,8272,8266,8314,8368,8232,8336,8284,70,18,100,828.55,706
1652,y1107,20100908,8336,8284,8338,8342,8328,8328,8334,44,50,12,100.03,710
1653,y1107,20100909,8328,8334,8306,8306,8032,8194,8148,-140,-186,60,488.94,698
1654,y1107,20100910,8194,8148,8166,8234,8166,8232,8208,84,60,10,82.1,700
1655,y1107,20100913,8232,8208,8166,8240,8166,8214,8206,6,-2,32,262.6,708
1656,y1107,20100914,8214,8206,8274,8286,8206,8224,8256,18,50,20,165.14,704
1657,y1107,20100915,8224,8256,8200,8284,8200,8254,8232,-2,-24,44,362.21,698
1658,y1107,20100916,8254,8232,8240,8240,8110,8214,8194,-18,-38,64,524.48,694
1659,y1107,20100917,8214,8194,8210,8258,8210,8258,8218,64,24,174,1430.06,830
1660,y1107,20100920,8258,8218,8424,8536,8424,8536,8476,318,258,10,84.76,824
1661,y1107,20100921,8536,8476,8494,8494,8398,8428,8466,-48,-10,228,1930.4,866
1662,y1107,20100927,8428,8466,8866,8866,8682,8710,8762,244,296,78,683.46,858
1663,y1107,20100928,8710,8762,8662,8772,8662,8764,8732,2,-30,22,192.14,858
1664,y1107,20100929,8764,8732,8710,8710,8588,8598,8640,-134,-92,10,86.41,856
1665,y1107,20100930,8598,8640,8630,8654,8610,8610,8636,-30,-4,32,276.39,850
1666,y1107,20101008,8610,8636,8614,8656,8614,8622,8624,-14,-12,26,224.22,858
1667,y1107,20101011,8622,8624,8854,8960,8854,8960,8946,336,322,16,143.15,866
1668,y1107,20101012,8960,8946,9090,9090,8958,8972,9012,26,66,56,504.73,864
1669,y1107,20101013,8972,9012,0,0,0,9012,9012,0,0,0,0,864
1670,y1107,20101014,9012,9012,9100,9128,9080,9110,9106,98,94,50,455.31,840
1671,y1107,20101015,9110,9106,9118,9166,9098,9166,9140,60,34,436,3985.04,1252
1672,y1107,20101018,9166,9140,9042,9042,9006,9006,9024,-134,-116,22,198.56,1256
1673,y1107,20101019,9006,9024,9150,9152,9030,9072,9100,48,76,18,163.82,1260
1674,y1107,20101020,9072,9100,8998,9076,8998,9076,9056,-24,-44,8,72.45,1258
1675,y1107,20101021,9076,9056,9368,9406,9302,9352,9360,296,304,20,187.22,1258
1676,y1107,20101022,9352,9360,9334,9398,9268,9376,9362,16,2,36,337.08,1258
1677,y1107,20101025,9376,9362,9560,9734,9560,9674,9664,312,302,8,77.32,1254
1678,y1107,20101026,9674,9664,9700,9700,9612,9612,9672,-52,8,24,232.15,1256
1679,y1107,20101027,9612,9672,9680,9680,9390,9390,9538,-282,-134,54,515.08,1250
1680,y1107,20101028,9390,9538,9548,9588,9402,9526,9482,-12,-56,26,246.55,1250
1681,y1107,20101029,9526,9482,9446,9446,9206,9330,9384,-152,-98,44,412.91,1244
1682,y1107,20101101,9330,9384,0,0,0,9384,9384,0,0,0,0,1244
1683,y1107,20101102,9384,9384,9636,9636,9460,9500,9532,116,148,6,57.19,1244
1684,y1107,20101103,9500,9532,9576,9576,9488,9488,9532,-44,0,4,38.13,1242
1685,y1107,20101104,9488,9532,9582,9868,9582,9814,9744,282,212,76,740.6,1244
1686,y1107,20101105,9814,9744,10122,10132,9808,10132,9984,388,240,68,679,1262
1687,y1107,20101108,10132,9984,10308,10330,10006,10082,10240,98,256,36,368.7,1260
1688,y1107,20101109,10082,10240,10218,10260,10058,10250,10188,10,-52,130,1324.52,1284
1689,y1107,20101110,10250,10188,10354,10438,10200,10200,10346,12,158,32,331.09,1270
1690,y1107,20101111,10200,10346,0,0,0,10346,10346,0,0,0,0,1270
1691,y1107,20101112,10346,10346,9934,10076,9934,9934,9994,-412,-352,14,139.93,1264
1692,y1107,20101115,9934,9994,9800,9800,9596,9600,9778,-394,-216,202,1975.19,1064
1693,y1107,20101116,9600,9778,9414,9750,9392,9562,9540,-216,-238,60,572.51,1046
1694,y1107,20101117,9562,9540,9160,9160,9160,9160,9160,-380,-380,2,18.32,1046
1695,y1107,20101118,9160,9160,9090,9396,9090,9100,9102,-60,-58,308,2803.94,1346
1696,y1107,20101119,9100,9102,9408,9408,9244,9244,9246,142,144,204,1886.26,1544
1697,y1107,20101122,9244,9246,0,0,0,9246,9246,0,0,0,0,1544
1698,y1107,20101123,9246,9246,9180,9182,9180,9182,9180,-64,-66,20,183.6,1546
1699,y1107,20101124,9182,9180,9558,9558,9172,9180,9284,0,104,14,129.98,1546
1700,y1107,20101125,9180,9284,9450,9450,9336,9336,9392,52,108,4,37.57,1546
1701,y1107,20101126,9336,9392,9264,9420,9092,9092,9274,-300,-118,604,5602.6,944
1702,y1107,20101129,9092,9274,0,0,0,9274,9274,0,0,0,0,944
1703,y1107,20101130,9274,9274,0,0,0,9274,9274,0,0,0,0,944
1704,y1107,20101201,9274,9274,9410,9412,9410,9412,9410,138,136,306,2879.47,644
1705,y1107,20101202,9412,9410,9856,9856,9564,9564,9636,154,226,8,77.1,648
1706,y1107,20101203,9564,9636,9476,9724,9476,9640,9694,4,58,70,678.64,714
1707,y1107,20101206,9640,9694,9758,9758,9672,9758,9716,64,22,8,77.73,710
1708,y1107,20101207,9758,9716,9688,9782,9688,9782,9734,66,18,4,38.94,708
1709,y1107,20101208,9782,9734,0,0,0,9734,9734,0,0,0,0,708
1710,y1107,20101209,9734,9734,0,0,0,9734,9734,0,0,0,0,708
1711,y1107,20101210,9734,9734,9828,9828,9828,9828,9828,94,94,4,39.31,712
1712,y1107,20101213,9828,9828,9900,9920,9850,9910,9890,82,62,20,197.83,712
1713,y1107,20101214,9910,9890,9978,9978,9978,9978,9978,88,88,4,39.91,708
1714,y1107,20101215,9978,9978,9938,9938,9938,9938,9938,-40,-40,2,19.88,706
1715,y1107,20101216,9938,9938,0,0,0,9938,9938,0,0,0,0,706
1716,y1107,20101217,9938,9938,0,0,0,9938,9938,0,0,0,0,706
1717,y1107,20101220,9938,9938,10052,10052,10046,10046,10046,108,108,800,8036.81,1506
1718,y1107,20101221,10046,10046,10088,10130,9948,10062,10074,16,28,18,181.36,1510
1719,y1107,20101222,10062,10074,0,0,0,10074,10074,0,0,0,0,1510
1720,y1107,20101223,10074,10074,10090,10300,10090,10300,10238,226,164,14,143.33,1520
1721,y1107,20101224,10300,10238,10350,10350,10262,10262,10290,24,52,6,61.75,1522
1722,y1107,20101227,10262,10290,10330,10330,10330,10330,10330,40,40,2,20.66,1524
1723,y1107,20101228,10330,10330,10358,10474,10358,10452,10450,122,120,68,710.7,1538
1724,y1107,20101229,10452,10450,10362,10362,10282,10318,10302,-132,-148,16,164.83,1524
1725,y1107,20101230,10318,10302,10284,10362,10264,10294,10264,-8,-38,812,8335.18,728
1726,y1107,20101231,10294,10264,10360,10360,10360,10360,10360,96,96,4,41.44,724
1727,y1108,20100816,,8154,0,0,0,8154,8154,0,0,0,0,0
1728,y1108,20100817,8154,8154,0,0,0,8154,8154,0,0,0,0,0
1729,y1108,20100818,8154,8154,8484,8484,8174,8174,8284,20,130,12,99.41,8
1730,y1108,20100819,8174,8284,8110,8336,8110,8158,8190,-126,-94,8,65.52,12
1731,y1108,20100820,8158,8190,8050,8094,8006,8006,8052,-184,-138,14,112.74,14
1732,y1108,20100823,8006,8052,8010,8010,8010,8010,8010,-42,-42,10,80.1,14
1733,y1108,20100824,8010,8010,7902,8060,7902,8010,7994,0,-16,8,63.96,14
1734,y1108,20100825,8010,7994,8066,8068,8008,8062,8038,68,44,26,209.03,12
1735,y1108,20100826,8062,8038,7990,8030,7990,8030,8010,-8,-28,4,32.04,10
1736,y1108,20100827,8030,8010,8008,8116,8008,8116,8080,106,70,66,533.29,54
1737,y1108,20100830,8116,8080,8198,8232,8198,8232,8214,152,134,4,32.86,56
1738,y1108,20100831,8232,8214,8086,8086,8066,8066,8076,-148,-138,18,145.39,62
1739,y1108,20100901,8066,8076,8196,8196,8088,8088,8138,12,62,70,569.68,72
1740,y1108,20100902,8088,8138,8076,8076,8076,8076,8076,-62,-62,2,16.15,72
1741,y1108,20100903,8076,8076,8158,8202,8142,8202,8168,126,92,14,114.35,64
1742,y1108,20100906,8202,8168,8246,8298,8230,8298,8258,130,90,6,49.55,66
1743,y1108,20100907,8298,8258,8298,8328,8234,8300,8292,42,34,28,232.21,68
1744,y1108,20100908,8300,8292,8330,8362,8316,8316,8344,24,52,14,116.84,72
1745,y1108,20100909,8316,8344,8250,8376,8082,8208,8206,-136,-138,24,196.97,78
1746,y1108,20100910,8208,8206,8260,8260,8210,8210,8234,4,28,4,32.94,74
1747,y1108,20100913,8210,8234,0,0,0,8234,8234,0,0,0,0,74
1748,y1108,20100914,8234,8234,8232,8232,8180,8180,8218,-54,-16,8,65.75,78
1749,y1108,20100915,8180,8218,8230,8238,8230,8234,8232,16,14,8,65.86,72
1750,y1108,20100916,8234,8232,8252,8252,8218,8218,8232,-14,0,8,65.87,70
1751,y1108,20100917,8218,8232,8250,8250,8250,8250,8250,18,18,2,16.5,70
1752,y1108,20100920,8250,8250,8388,8564,8388,8532,8462,282,212,38,321.58,68
1753,y1108,20100921,8532,8462,8434,8496,8408,8450,8418,-12,-44,70,589.26,44
1754,y1108,20100927,8450,8418,8720,8900,8692,8692,8754,274,336,26,227.61,44
1755,y1108,20100928,8692,8754,8632,8742,8632,8680,8696,-74,-58,14,121.74,42
1756,y1108,20100929,8680,8696,8572,8600,8572,8600,8586,-96,-110,4,34.34,40
1757,y1108,20100930,8600,8586,8632,8632,8632,8632,8632,46,46,4,34.53,36
1758,y1108,20101008,8632,8632,8632,8632,8632,8632,8632,0,0,2,17.26,38
1759,y1108,20101011,8632,8632,0,0,0,8632,8632,0,0,0,0,38
1760,y1108,20101012,8632,8632,8976,8976,8900,8976,8920,344,288,226,2016.31,244
1761,y1108,20101013,8976,8920,8982,9234,8982,9234,9084,314,164,6,54.51,240
1762,y1108,20101014,9234,9084,9118,9134,9118,9122,9124,38,40,18,164.24,246
1763,y1108,20101015,9122,9124,9088,9188,9080,9188,9132,64,8,166,1516.15,406
1764,y1108,20101018,9188,9132,8956,9150,8956,9010,9038,-122,-94,6,54.23,406
1765,y1108,20101019,9010,9038,9176,9256,8902,9168,9100,130,62,14,127.4,404
1766,y1108,20101020,9168,9100,9100,9100,8920,9002,9034,-98,-66,38,343.36,404
1767,y1108,20101021,9002,9034,9392,9394,9230,9230,9306,196,272,24,223.38,400
1768,y1108,20101022,9230,9306,9230,9378,9230,9378,9322,72,16,16,149.16,404
1769,y1108,20101025,9378,9322,9690,9692,9622,9690,9638,368,316,32,308.45,430
1770,y1108,20101026,9690,9638,10022,10022,9600,9610,9784,-28,146,76,743.66,412
1771,y1108,20101027,9610,9784,9722,9730,9398,9412,9542,-372,-242,126,1202.42,484
1772,y1108,20101028,9412,9542,9530,9608,9456,9536,9554,-6,12,68,649.67,458
1773,y1108,20101029,9536,9554,9626,9626,9270,9474,9442,-80,-112,26,245.53,458
1774,y1108,20101101,9474,9442,9550,9550,9510,9510,9530,68,88,4,38.12,458
1775,y1108,20101102,9510,9530,9570,9578,9488,9490,9504,-40,-26,20,190.12,440
1776,y1108,20101103,9490,9504,9582,9588,9530,9544,9558,40,54,98,936.78,424
1777,y1108,20101104,9544,9558,9626,9880,9602,9776,9684,218,126,28,271.15,410
1778,y1108,20101105,9776,9684,9980,10070,9980,10070,10046,386,362,8,80.38,408
1779,y1108,20101108,10070,10046,10398,10416,10040,10256,10254,210,208,648,6644.72,1006
1780,y1108,20101109,10256,10254,10240,10384,10160,10334,10324,80,70,120,1238.9,1110
1781,y1108,20101110,10334,10324,10230,10556,10230,10308,10418,-16,94,78,812.71,1104
1782,y1108,20101111,10308,10418,10222,10588,10222,10442,10448,24,30,80,835.91,1104
1783,y1108,20101112,10442,10448,10270,10270,10060,10060,10126,-388,-322,12,121.52,1106
1784,y1108,20101115,10060,10126,9988,9988,9722,9722,9818,-404,-308,70,687.26,1056
1785,y1108,20101116,9722,9818,9780,9986,9668,9770,9802,-48,-16,22,215.68,1058
1786,y1108,20101117,9770,9802,9410,9410,9410,9410,9410,-392,-392,8,75.28,1050
1787,y1108,20101118,9410,9410,9568,9568,9182,9460,9392,50,-18,96,901.76,1064
1788,y1108,20101119,9460,9392,9420,9520,9280,9410,9478,18,86,40,379.12,1052
1789,y1108,20101122,9410,9478,9342,9418,9342,9350,9374,-128,-104,10,93.74,1050
1790,y1108,20101123,9350,9374,9356,9356,9178,9300,9270,-74,-104,62,574.76,1054
1791,y1108,20101124,9300,9270,9300,9592,9300,9460,9312,190,42,144,1341.11,1174
1792,y1108,20101125,9460,9312,9520,9602,9518,9538,9538,226,226,20,190.8,1174
1793,y1108,20101126,9538,9538,9500,9520,9178,9326,9378,-212,-160,352,3301.66,1320
1794,y1108,20101129,9326,9378,9306,9466,9300,9466,9330,88,-48,134,1250.22,1374
1795,y1108,20101130,9466,9330,9394,9514,9378,9432,9436,102,106,310,2925.66,1240
1796,y1108,20101201,9432,9436,9528,9600,9436,9600,9554,164,118,248,2369.43,1014
1797,y1108,20101202,9600,9554,9790,9790,9720,9732,9738,178,184,134,1305.11,1112
1798,y1108,20101203,9732,9738,9706,9822,9706,9822,9744,84,6,12,116.94,1112
1799,y1108,20101206,9822,9744,9978,9978,9828,9828,9902,84,158,4,39.61,1112
1800,y1108,20101207,9828,9902,9836,9902,9836,9902,9882,0,-20,8,79.07,1112
1801,y1108,20101208,9902,9882,9800,9864,9614,9790,9792,-92,-90,16,156.69,1112
1802,y1108,20101209,9790,9792,9898,9928,9780,9780,9874,-12,82,184,1816.89,1090
1803,y1108,20101210,9780,9874,9812,9858,9812,9858,9834,-16,-40,12,118.02,1096
1804,y1108,20101213,9858,9834,10066,10066,10018,10018,10062,184,228,28,281.75,1122
1805,y1108,20101214,10018,10062,10018,10048,10018,10036,10042,-26,-20,56,562.37,1124
1806,y1108,20101215,10036,10042,10098,10178,10034,10034,10150,-8,108,170,1725.76,1208
1807,y1108,20101216,10034,10150,9998,9998,9998,9998,9998,-152,-152,2,20,1208
1808,y1108,20101217,9998,9998,10028,10028,10028,10028,10028,30,30,36,361.01,1194
1809,y1108,20101220,10028,10028,10118,10118,10062,10062,10090,34,62,4,40.36,1192
1810,y1108,20101221,10062,10090,10100,10100,10100,10100,10100,10,10,14,141.4,1196
1811,y1108,20101222,10100,10100,0,0,0,10100,10100,0,0,0,0,1196
1812,y1108,20101223,10100,10100,9814,10388,9814,10388,10160,288,60,6,60.97,1196
1813,y1108,20101224,10388,10160,10556,10556,10114,10398,10350,238,190,28,289.8,1200
1814,y1108,20101227,10398,10350,10496,10522,10024,10484,10436,134,86,48,501.01,1198
1815,y1108,20101228,10484,10436,10644,10886,10332,10614,10642,178,206,34,361.84,1196
1816,y1108,20101229,10614,10642,10424,10424,10400,10400,10412,-242,-230,4,41.65,1198
1817,y1108,20101230,10400,10412,10356,10442,10356,10442,10398,30,-14,4,41.6,1196
1818,y1108,20101231,10442,10398,10400,10464,10400,10464,10438,66,40,1004,10480.21,192
1819,y1109,20100915,,8132,8206,8270,8194,8222,8216,90,84,618,5077.92,444
1820,y1109,20100916,8222,8216,8246,8292,8180,8236,8236,20,20,564,4645.49,744
1821,y1109,20100917,8236,8236,8236,8272,8216,8258,8246,22,10,3508,28928.66,2348
1822,y1109,20100920,8258,8246,8450,8574,8400,8548,8518,302,272,5664,48253.43,4642
1823,y1109,20100921,8548,8518,8540,8540,8358,8462,8464,-56,-54,4416,37385.48,5718
1824,y1109,20100927,8462,8464,8810,8830,8650,8686,8736,222,272,3320,29006.84,7038
1825,y1109,20100928,8686,8736,8640,8768,8640,8768,8720,32,-16,7160,62441.52,12128
1826,y1109,20100929,8768,8720,8712,8712,8552,8616,8624,-104,-96,4150,35795.61,11258
1827,y1109,20100930,8616,8624,8600,8660,8536,8654,8600,30,-24,1994,17150.93,12016
1828,y1109,20101008,8654,8600,8600,8680,8590,8620,8640,20,40,4886,42224.04,13790
1829,y1109,20101011,8620,8640,8984,8984,8984,8984,8984,344,344,292,2623.33,13680
1830,y1109,20101012,8984,8984,9028,9044,8934,8990,8988,6,4,16490,148219.23,18714
1831,y1109,20101013,8990,8988,9000,9068,8976,9044,9018,56,30,15096,136151.69,20576
1832,y1109,20101014,9044,9018,9088,9164,9070,9116,9114,98,96,28618,260835.35,30352
1833,y1109,20101015,9116,9114,9134,9180,9070,9166,9126,52,12,36246,330820.46,41222
1834,y1109,20101018,9166,9126,9060,9076,8952,8986,9006,-140,-120,41552,374268.3,49242
1835,y1109,20101019,8986,9006,9060,9174,9032,9114,9112,108,106,81160,739558.33,61276
1836,y1109,20101020,9114,9112,8962,9156,8946,9100,9076,-12,-36,123894,1124630.44,91440
1837,y1109,20101021,9100,9076,9280,9438,9268,9354,9360,278,284,275336,2577635.84,134946
1838,y1109,20101022,9354,9360,9280,9474,9280,9456,9422,96,62,424178,3996682.65,275992
1839,y1109,20101025,9456,9422,9476,9796,9476,9774,9698,352,276,948414,9199032.66,451654
1840,y1109,20101026,9774,9698,9750,9818,9646,9686,9712,-12,14,1274870,12383727.87,520654
1841,y1109,20101027,9686,9712,9800,9800,9332,9440,9576,-272,-136,1476078,14135714.09,458372
1842,y1109,20101028,9440,9576,9572,9660,9542,9628,9606,52,30,1400334,13452454.27,568024
1843,y1109,20101029,9628,9606,9572,9578,9370,9380,9454,-226,-152,1321046,12489346.22,521048
1844,y1109,20101101,9380,9454,9460,9600,9432,9564,9532,110,78,973836,9283990.03,566890
1845,y1109,20101102,9564,9532,9580,9632,9510,9552,9572,20,40,1183472,11328814.84,597270
1846,y1109,20101103,9552,9572,9572,9660,9520,9568,9604,-4,32,1124644,10801756.39,592522
1847,y1109,20101104,9568,9604,9662,9900,9630,9874,9768,270,164,1724756,16849779.1,740008
1848,y1109,20101105,9874,9768,9986,10158,9972,10158,10120,390,352,782640,7921750.29,736694
1849,y1109,20101108,10158,10120,10080,10476,10042,10192,10242,72,122,2005750,20543005.66,751768
1850,y1109,20101109,10192,10242,10110,10416,10106,10358,10282,116,40,1774544,18247142.68,791852
1851,y1109,20101110,10358,10282,10488,10554,10270,10330,10426,48,144,1618760,16880400.51,784160
1852,y1109,20101111,10330,10426,10412,10498,10290,10366,10408,-60,-18,1511230,15730122.52,762222
1853,y1109,20101112,10366,10408,10400,10400,9992,9992,10098,-416,-310,1470988,14856818.46,632988
1854,y1109,20101115,9992,10098,9838,10038,9696,9812,9868,-286,-230,1646448,16248365.66,589772
1855,y1109,20101116,9812,9868,9850,9922,9660,9670,9786,-198,-82,1744110,17070101.12,565846
1856,y1109,20101117,9670,9786,9396,9402,9396,9396,9396,-390,-390,130752,1228563.91,538914
1857,y1109,20101118,9396,9396,9458,9504,9100,9384,9310,-12,-86,1743568,16234579.28,525930
1858,y1109,20101119,9384,9310,9548,9576,9304,9512,9454,202,144,1488636,14075651.39,504744
1859,y1109,20101122,9512,9454,9280,9394,9230,9254,9334,-200,-120,961244,8972283.37,481596
1860,y1109,20101123,9254,9334,9300,9362,9150,9164,9234,-170,-100,1633350,15084879.83,495910
1861,y1109,20101124,9164,9234,9260,9436,9232,9428,9316,194,82,1159868,10807361.23,505006
1862,y1109,20101125,9428,9316,9476,9564,9450,9460,9502,144,186,1099980,10452235.9,510154
1863,y1109,20101126,9460,9502,9502,9508,9222,9350,9346,-152,-156,1456186,13609860.4,495118
1864,y1109,20101129,9350,9346,9334,9480,9264,9474,9366,128,20,888136,8318750.03,501650
1865,y1109,20101130,9474,9366,9460,9540,9338,9528,9438,162,72,864506,8159526.63,483482
1866,y1109,20101201,9528,9438,9500,9648,9470,9628,9576,190,138,873232,8362336.1,473976
1867,y1109,20101202,9628,9576,9800,9800,9702,9718,9740,142,164,689428,6716127.52,463616
1868,y1109,20101203,9718,9740,9712,9798,9666,9744,9736,4,-4,739698,7202774.2,465844
1869,y1109,20101206,9744,9736,9800,9872,9750,9858,9824,122,88,698194,6859674.06,473740
1870,y1109,20101207,9858,9824,9822,9936,9784,9934,9862,110,38,746056,7358929.58,457744
1871,y1109,20101208,9934,9862,9808,9850,9700,9710,9790,-152,-72,649942,6363298.43,446436
1872,y1109,20101209,9710,9790,9850,9872,9788,9816,9832,26,42,654848,6439298.22,428568
1873,y1109,20101210,9816,9832,9800,9830,9754,9810,9790,-22,-42,445300,4359752.96,423798
1874,y1109,20101213,9810,9790,9762,10032,9754,9986,9932,196,142,646460,6420943.28,445602
1875,y1109,20101214,9986,9932,10060,10084,9980,10082,10030,150,98,553584,5553384.37,455020
1876,y1109,20101215,10082,10030,10038,10176,9960,9974,10066,-56,36,999104,10058389.96,474468
1877,y1109,20101216,9974,10066,9960,10032,9952,9990,9994,-76,-72,534232,5339821.12,458408
1878,y1109,20101217,9990,9994,9990,10066,9980,10040,10036,46,42,474222,4759864.36,461474
1879,y1109,20101220,10040,10036,10120,10164,9982,10046,10082,10,46,645952,6513428.87,470508
1880,y1109,20101221,10046,10082,10102,10194,10080,10176,10124,94,42,551304,5582391.06,475754
1881,y1109,20101222,10176,10124,10210,10258,10132,10164,10198,40,74,602712,6146488.92,459984
1882,y1109,20101223,10164,10198,10218,10474,10200,10448,10358,250,160,892720,9247735.59,519112
1883,y1109,20101224,10448,10358,10500,10526,10306,10416,10414,58,56,762402,7939799.56,486702
1884,y1109,20101227,10416,10414,10352,10524,10350,10488,10452,74,38,743244,7768823.7,507508
1885,y1109,20101228,10488,10452,10560,10662,10556,10606,10616,154,164,735730,7811646.73,500390
1886,y1109,20101229,10606,10616,10578,10590,10368,10386,10472,-230,-144,706440,7398519.01,466604
1887,y1109,20101230,10386,10472,10350,10512,10300,10498,10404,26,-68,633924,6596067.01,435202
1888,y1109,20101231,10498,10404,10398,10538,10396,10526,10476,122,72,524626,5496503.15,426546
1889,y1111,20101115,,9992,9830,9830,9828,9828,9828,-164,-164,18,176.94,18
1890,y1111,20101116,9828,9828,10094,10094,9898,9964,10010,136,182,8,80.09,24
1891,y1111,20101117,9964,10010,9610,9610,9610,9610,9610,-400,-400,10,96.1,34
1892,y1111,20101118,9610,9610,9230,9592,9228,9342,9266,-268,-344,108,1000.78,138
1893,y1111,20101119,9342,9266,9616,9616,9450,9590,9502,324,236,114,1083.34,194
1894,y1111,20101122,9590,9502,9460,9460,9338,9352,9352,-150,-150,20,187.04,210
1895,y1111,20101123,9352,9352,9324,9424,9002,9190,9218,-162,-134,472,4351.3,646
1896,y1111,20101124,9190,9218,9014,9414,9014,9414,9308,196,90,50,465.43,616
1897,y1111,20101125,9414,9308,0,0,0,9308,9308,0,0,0,0,616
1898,y1111,20101126,9308,9308,9392,9396,9360,9360,9390,52,82,18,169.03,616
1899,y1111,20101129,9360,9390,0,0,0,9390,9390,0,0,0,0,616
1900,y1111,20101130,9390,9390,9400,9444,9400,9400,9414,10,24,6,56.49,616
1901,y1111,20101201,9400,9414,9420,9600,9420,9600,9420,186,6,504,4748.04,116
1902,y1111,20101202,9600,9420,9600,9600,9600,9600,9600,180,180,2,19.2,118
1903,y1111,20101203,9600,9600,9818,9818,9716,9720,9746,120,146,10,97.46,118
1904,y1111,20101206,9720,9746,9702,9702,9702,9702,9702,-44,-44,2,19.4,120
1905,y1111,20101207,9702,9702,9848,9944,9756,9914,9834,212,132,28,275.39,120
1906,y1111,20101208,9914,9834,9798,9798,9760,9760,9776,-74,-58,10,97.76,118
1907,y1111,20101209,9760,9776,0,0,0,9776,9776,0,0,0,0,118
1908,y1111,20101210,9776,9776,9780,9820,9780,9800,9818,24,42,1404,13787.16,1518
1909,y1111,20101213,9800,9818,9890,9950,9800,9950,9880,132,62,6,59.28,1522
1910,y1111,20101214,9950,9880,10122,10122,9960,10048,9980,168,100,246,2455.38,1728
1911,y1111,20101215,10048,9980,10002,10002,10000,10000,10000,20,20,26,260,1734
1912,y1111,20101216,10000,10000,9952,9952,9952,9952,9952,-48,-48,22,218.94,1734
1913,y1111,20101217,9952,9952,0,0,0,9952,9952,0,0,0,0,1734
1914,y1111,20101220,9952,9952,10178,10178,9996,9996,10086,44,134,4,40.35,1734
1915,y1111,20101221,9996,10086,10094,10094,10094,10094,10094,8,8,402,4057.79,1336
1916,y1111,20101222,10094,10094,10200,10200,10200,10200,10200,106,106,80,816,1416
1917,y1111,20101223,10200,10200,0,0,0,10200,10200,0,0,0,0,1416
1918,y1111,20101224,10200,10200,10496,10496,10232,10290,10352,90,152,12,124.23,1416
1919,y1111,20101227,10290,10352,10342,10562,10342,10358,10470,6,118,208,2177.84,1448
1920,y1111,20101228,10358,10470,10598,10606,10518,10600,10592,130,122,60,635.6,1448
1921,y1111,20101229,10600,10592,10648,10648,10302,10448,10518,-144,-74,1008,10603.41,448
1922,y1111,20101230,10448,10518,10300,10498,10300,10498,10310,-20,-208,328,3381.95,158
1923,y1111,20101231,10498,10310,10500,10926,10446,10496,10618,186,308,42,445.98,154
1924,y1112,20101215,,9932,0,0,0,9932,9932,0,0,0,0,0
1925,y1112,20101216,9932,9932,9964,9964,9964,9964,9964,32,32,2,19.93,2
1926,y1112,20101217,9964,9964,10098,10098,10098,10098,10098,134,134,2,20.2,0
1927,y1112,20101220,10098,10098,0,0,0,10098,10098,0,0,0,0,0
1928,y1112,20101221,10098,10098,10660,10660,9904,9904,10282,-194,184,4,41.13,0
1929,y1112,20101222,9904,10282,0,0,0,10282,10282,0,0,0,0,0
1930,y1112,20101223,10282,10282,10534,10678,10302,10360,10480,78,198,26,272.49,4
1931,y1112,20101224,10360,10480,0,0,0,10480,10480,0,0,0,0,4
1932,y1112,20101227,10480,10480,10300,10300,10300,10300,10300,-180,-180,2,20.6,4
1933,y1112,20101228,10300,10300,10550,10600,10550,10600,10574,300,274,4,42.3,2
1934,y1112,20101229,10600,10574,10450,10450,10450,10450,10450,-124,-124,2,20.9,2
1935,y1112,20101230,10450,10450,10072,10652,10072,10480,10408,30,-42,8,83.27,4
1936,y1112,20101231,10480,10408,10482,10582,10444,10582,10502,174,94,6,63.02,2