   ,合约,日期,前收盘价,前结算价,开盘价,最高价,最低价,收盘价,结算价,涨跌1,涨跌2,成交量,成交金额,持仓量
1,y1101,20110104,10120,10074,9902,10250,9850,10250,10144,176,70,316,32058560,4014
2,y1101,20110105,10250,10144,10190,10190,10190,10190,10190,46,46,20,2038000,4034
3,y1101,20110106,10190,10190,10348,10400,10348,10400,10354,210,164,22,2277960,4054
4,y1101,20110107,10400,10354,10184,10260,10184,10260,10200,-94,-154,10,1020120,4052
5,y1101,20110110,10260,10200,0,0,0,10200,10200,0,0,0,0,4052
6,y1101,20110111,10200,10200,0,0,0,10200,10200,0,0,0,0,4052
7,y1101,20110112,10200,10200,0,0,0,10200,10200,0,0,0,0,2140
8,y1101,20110113,10200,10200,10400,10400,10400,10400,10400,200,200,2,208000,2142
9,y1101,20110114,10400,10400,10296,10296,10296,10296,10296,-104,-104,20,2059200,1062
10,y1101,20110117,10296,10296,0,0,0,10296,10168,0,-128,0,0,0
11,y1103,20110104,10080,10112,10204,10220,10190,10200,10202,88,90,14,1428280,126
12,y1103,20110105,10200,10202,10100,10100,10100,10100,10100,-102,-102,2,202000,126
13,y1103,20110106,10100,10100,10224,10300,10222,10300,10258,200,158,14,1436320,126
14,y1103,20110107,10300,10258,10308,10308,10020,10020,10156,-238,-102,10,1015760,126
15,y1103,20110110,10020,10156,10050,10060,10050,10050,10052,-106,-104,6,603200,120
16,y1103,20110111,10050,10052,10050,10100,10050,10100,10068,48,16,34,3423600,86
17,y1103,20110112,10100,10068,10100,10100,9862,10068,10086,0,18,66,6657680,28
18,y1103,20110113,10068,10086,0,0,0,10086,10086,0,0,0,0,28
19,y1103,20110114,10086,10086,0,0,0,10086,10086,0,0,0,0,28
20,y1103,20110117,10086,10086,0,0,0,10086,10086,0,0,0,0,28
21,y1103,20110118,10086,10086,10002,10160,10002,10050,10074,-36,-12,12,1208960,24
22,y1103,20110119,10050,10074,0,0,0,10074,10074,0,0,0,0,24
23,y1103,20110120,10074,10074,10248,10248,10248,10248,10248,174,174,2,204960,22
24,y1103,20110121,10248,10248,0,0,0,10248,10248,0,0,0,0,22
25,y1103,20110124,10248,10248,0,0,0,10248,10248,0,0,0,0,22
26,y1103,20110125,10248,10248,0,0,0,10248,10248,0,0,0,0,22
27,y1103,20110126,10248,10248,10050,10050,10000,10000,10032,-248,-216,6,602000,16
28,y1103,20110127,10000,10032,0,0,0,10032,10032,0,0,0,0,16
29,y1103,20110128,10032,10032,0,0,0,10032,10032,0,0,0,0,16
30,y1103,20110131,10032,10032,0,0,0,10032,10032,0,0,0,0,16
31,y1103,20110201,10032,10032,0,0,0,10032,10032,0,0,0,0,16
32,y1103,20110209,10032,10032,0,0,0,10032,10032,0,0,0,0,16
33,y1103,20110210,10032,10032,0,0,0,10032,10032,0,0,0,0,16
34,y1103,20110211,10032,10032,0,0,0,10032,10032,0,0,0,0,16
35,y1103,20110214,10032,10032,0,0,0,10032,10032,0,0,0,0,16
36,y1103,20110215,10032,10032,10192,10400,10192,10400,10260,368,228,16,1641600,12
37,y1103,20110216,10400,10260,0,0,0,10260,10260,0,0,0,0,12
38,y1103,20110217,10260,10260,10260,10260,10260,10260,10260,0,0,2,205200,10
39,y1103,20110218,10260,10260,0,0,0,10260,10260,0,0,0,0,10
40,y1103,20110221,10260,10260,0,0,0,10260,10260,0,0,0,0,10
41,y1103,20110222,10260,10260,0,0,0,10260,10260,0,0,0,0,10
42,y1103,20110223,10260,10260,9650,9706,9646,9696,9676,-564,-584,18,1741680,2
43,y1103,20110224,9696,9676,0,0,0,9676,9676,0,0,0,0,2
44,y1103,20110225,9676,9676,0,0,0,9676,9676,0,0,0,0,2
45,y1103,20110228,9676,9676,9820,9820,9820,9820,9820,144,144,2,196400,0
46,y1103,20110301,9820,9820,0,0,0,9820,9820,0,0,0,0,0
47,y1103,20110302,9820,9820,0,0,0,9820,9820,0,0,0,0,0
48,y1103,20110303,9820,9820,0,0,0,9820,9820,0,0,0,0,0
49,y1103,20110304,9820,9820,0,0,0,9820,9820,0,0,0,0,0
50,y1103,20110307,9820,9820,0,0,0,9820,9820,0,0,0,0,0
51,y1103,20110308,9820,9820,0,0,0,9820,9820,0,0,0,0,0
52,y1103,20110309,9820,9820,0,0,0,9820,9820,0,0,0,0,0
53,y1103,20110310,9820,9820,0,0,0,9820,9820,0,0,0,0,0
54,y1103,20110311,9820,9820,0,0,0,9820,9820,0,0,0,0,0
55,y1103,20110314,9820,9820,0,0,0,9820,9820,0,0,0,0,0
56,y1105,20110104,10246,10190,10252,10362,10232,10342,10318,152,128,8438,870719600,76918
57,y1105,20110105,10342,10318,10250,10298,10198,10238,10256,-80,-62,3612,370490840,75870
58,y1105,20110106,10238,10256,10342,10546,10342,10522,10466,266,210,3036,317808280,74914
59,y1105,20110107,10522,10466,10384,10496,10276,10360,10398,-106,-68,9788,1017845520,70214
60,y1105,20110110,10360,10398,10362,10438,10292,10342,10362,-56,-36,5478,567663640,67538
61,y1105,20110111,10342,10362,10412,10440,10340,10404,10372,42,10,5392,559287720,64934
62,y1105,20110112,10404,10372,10390,10432,10206,10248,10324,-124,-48,5270,544156680,62482
63,y1105,20110113,10248,10324,10660,10660,10338,10350,10392,26,68,3314,344453840,61138
64,y1105,20110114,10350,10392,10390,10390,10298,10352,10346,-40,-46,3598,372307840,59544
65,y1105,20110117,10352,10346,10370,10386,10276,10312,10322,-34,-24,5004,516610240,58268
66,y1105,20110118,10312,10322,10312,10318,10166,10254,10258,-68,-64,4034,413829840,55860
67,y1105,20110119,10254,10258,10278,10398,10272,10380,10340,122,82,3388,350385960,54138
68,y1105,20110120,10380,10340,10336,10426,10314,10366,10382,26,42,4582,475731560,51042
69,y1105,20110121,10366,10382,10302,10368,10300,10356,10332,-26,-50,5256,543122360,46852
70,y1105,20110124,10356,10332,10420,10608,10410,10516,10520,184,188,4258,448014320,44040
71,y1105,20110125,10516,10520,10500,10500,10338,10338,10438,-182,-82,2668,278506560,42690
72,y1105,20110126,10338,10438,10192,10222,9988,10100,10148,-338,-290,8720,885058440,36730
73,y1105,20110127,10100,10148,10232,10264,10142,10200,10166,52,18,3272,332631880,35418
74,y1105,20110128,10200,10166,10184,10230,10168,10186,10194,20,28,2768,282170640,34710
75,y1105,20110131,10186,10194,10252,10408,10232,10382,10366,188,172,1752,181615160,34410
76,y1105,20110201,10382,10366,10450,10460,10378,10428,10420,62,54,454,47308800,34256
77,y1105,20110209,10428,10420,10570,10614,10412,10610,10570,190,150,752,79499320,33798
78,y1105,20110210,10610,10570,10694,10772,10668,10682,10658,112,88,1492,159046240,32534
79,y1105,20110211,10682,10658,10682,10706,10650,10670,10682,12,24,1090,116435240,31910
80,y1105,20110214,10670,10682,10648,10776,10602,10720,10676,38,-6,2342,250057240,30812
81,y1105,20110215,10720,10676,10650,10658,10600,10610,10624,-66,-52,3138,333436280,27968
82,y1105,20110216,10610,10624,10412,10476,10366,10442,10436,-182,-188,1494,155943200,27368
83,y1105,20110217,10442,10436,10442,10736,10290,10290,10470,-146,34,1616,169211560,26432
84,y1105,20110218,10290,10470,10470,10470,10284,10284,10366,-186,-104,690,71536960,26052
85,y1105,20110221,10284,10366,10300,10314,10210,10266,10282,-100,-84,918,94394360,25498
86,y1105,20110222,10266,10282,10392,10426,10268,10406,10368,124,86,1112,115307400,25184
87,y1105,20110223,10406,10368,10000,10076,9800,9996,9998,-372,-370,1484,148393320,24702
88,y1105,20110224,9996,9998,10060,10068,9758,9840,9860,-158,-138,1556,153448520,23590
89,y1105,20110225,9840,9860,9886,9968,9840,9954,9912,94,52,1202,119158200,22802
90,y1105,20110228,9954,9912,10000,10108,10000,10100,10060,188,148,828,83301400,22176
91,y1105,20110301,10100,10060,10120,10126,10030,10100,10102,40,42,686,69302680,21790
92,y1105,20110302,10100,10102,10128,10260,10106,10244,10176,142,74,1104,112353640,21538
93,y1105,20110303,10244,10176,10270,10280,10172,10246,10218,70,42,574,58658040,21346
94,y1105,20110304,10246,10218,10274,10830,10250,10300,10328,82,110,938,96892120,21180
95,y1105,20110307,10300,10328,10300,10372,10300,10334,10330,6,2,1066,110136040,21444
96,y1105,20110308,10334,10330,10246,10286,10104,10146,10188,-184,-142,420,42794440,21284
97,y1105,20110309,10146,10188,10150,10150,10080,10100,10108,-88,-80,794,80269200,21080
98,y1105,20110310,10100,10108,9954,10020,9934,9980,9984,-128,-124,738,73693400,21136
99,y1105,20110311,9980,9984,9990,10036,9956,9966,9988,-18,4,694,69317800,20872
100,y1105,20110314,9966,9988,9906,9946,9820,9828,9856,-160,-132,420,41396040,20816
101,y1105,20110315,9828,9856,9848,9910,9820,9888,9872,32,16,126,12441040,20804
102,y1105,20110316,9888,9872,9724,9780,9622,9780,9688,-92,-184,410,39724760,20894
103,y1105,20110317,9780,9688,9762,9860,9726,9830,9734,142,46,1708,166260440,20548
104,y1105,20110318,9830,9734,9960,9966,9900,9958,9934,224,200,368,36562280,20560
105,y1105,20110321,9958,9934,10046,10080,10010,10052,10042,118,108,168,16873280,20464
106,y1105,20110322,10052,10042,10052,10052,9990,9998,10010,-44,-32,708,70873680,20440
107,y1105,20110323,9998,10010,9996,10124,9996,10094,10090,84,80,392,39555120,20158
108,y1105,20110324,10094,10090,10040,10086,9914,9938,9952,-152,-138,922,91771800,19848
109,y1105,20110325,9938,9952,10032,10074,10020,10038,10038,86,86,160,16063600,19802
110,y1105,20110328,10038,10038,10090,10136,9956,10020,10080,-18,42,436,43951680,19718
111,y1105,20110329,10020,10080,9960,10010,9924,10010,9974,-70,-106,446,44486800,19716
112,y1105,20110330,10010,9974,10078,10108,10036,10060,10064,86,90,620,62396880,19300
113,y1105,20110331,10060,10064,10124,10138,10050,10120,10078,56,14,640,64508920,18912
114,y1105,20110401,10120,10078,10220,10220,10140,10150,10170,72,92,1422,144635960,17582
115,y1105,20110406,10150,10170,10128,10204,10128,10204,10198,34,28,384,39166880,17208
116,y1105,20110407,10204,10198,10200,10200,10150,10160,10170,-38,-28,296,30105840,17198
117,y1105,20110408,10160,10170,10150,10250,10150,10202,10188,32,18,1468,149566560,16482
118,y1105,20110411,10202,10188,10212,10300,9712,10254,10250,66,62,430,44080000,16256
119,y1105,20110412,10254,10250,10198,10198,10030,10030,10062,-220,-188,2286,230028480,14032
120,y1105,20110413,10030,10062,9874,9950,9874,9948,10038,-114,-24,2764,277504960,11278
121,y1105,20110414,9948,10038,9900,9980,9890,9890,9936,-148,-102,650,64595680,10664
122,y1105,20110415,9890,9936,9866,9964,9840,9840,9858,-96,-78,234,23071800,10532
123,y1105,20110418,9840,9858,9888,9888,9614,9810,9750,-48,-108,2650,258398680,8556
124,y1105,20110419,9810,9750,9888,9962,9738,9750,9848,0,98,1250,123101040,8414
125,y1105,20110420,9750,9848,9800,9850,9776,9850,9814,2,-34,612,60064720,7958
126,y1105,20110421,9850,9814,9820,9880,9820,9866,9848,52,34,246,24229880,7776
127,y1105,20110422,9866,9848,9950,10038,9940,10004,9950,156,102,3720,370158840,4150
128,y1105,20110425,10004,9950,9994,10092,9990,10064,10012,114,62,32,3204040,4130
129,y1105,20110426,10064,10012,9962,10000,9954,9960,9976,-52,-36,144,14366200,3996
130,y1105,20110427,9960,9976,10056,10056,9984,10000,9996,24,20,80,7998040,3938
131,y1105,20110428,10000,9996,10018,10040,9952,10006,10000,10,4,180,18000000,3860
132,y1105,20110429,10006,10000,9884,9884,9674,9712,9736,-288,-264,320,31159240,3550
133,y1105,20110503,9712,9736,0,0,0,9736,9736,0,0,0,0,2898
134,y1105,20110504,9736,9736,10198,10200,9800,9888,9884,152,148,138,13642520,2898
135,y1105,20110505,9888,9884,9800,9800,9800,9800,9800,-84,-84,10,980000,2894
136,y1105,20110506,9800,9800,0,0,0,9800,9800,0,0,0,0,2894
137,y1105,20110509,9800,9800,0,0,0,9800,9800,0,0,0,0,2894
138,y1105,20110510,9800,9800,0,0,0,9800,9800,0,0,0,0,2894
139,y1105,20110511,9800,9800,0,0,0,9800,9800,0,0,0,0,2712
140,y1105,20110512,9800,9800,0,0,0,9800,9800,0,0,0,0,2712
141,y1105,20110513,9800,9800,0,0,0,9800,9800,0,0,0,0,2712
142,y1105,20110516,9800,9800,0,0,0,9800,9880,0,80,0,0,0
143,y1107,20110104,10360,10360,10410,10480,10400,10480,10410,120,50,552,57470000,186
144,y1107,20110105,10480,10410,10380,10380,10344,10344,10368,-66,-42,6,622080,192
145,y1107,20110106,10344,10368,10370,10620,10370,10610,10546,242,178,32,3375160,218
146,y1107,20110107,10610,10546,10442,10448,10400,10410,10414,-136,-132,54,5623800,190
147,y1107,20110110,10410,10414,10520,10520,10334,10360,10448,-54,34,30,3134720,186
148,y1107,20110111,10360,10448,10430,10468,10430,10430,10442,-18,-6,6,626560,182
149,y1107,20110112,10430,10442,10422,10422,10416,10416,10418,-26,-24,44,4584760,174
150,y1107,20110113,10416,10418,0,0,0,10418,10418,0,0,0,0,174
151,y1107,20110114,10418,10418,0,0,0,10418,10418,0,0,0,0,174
152,y1107,20110117,10418,10418,0,0,0,10418,10418,0,0,0,0,174
153,y1107,20110118,10418,10418,10380,10380,10376,10376,10396,-42,-22,6,623800,172
154,y1107,20110119,10376,10396,10426,10426,10410,10410,10418,14,22,4,416720,172
155,y1107,20110120,10410,10418,0,0,0,10418,10418,0,0,0,0,172
156,y1107,20110121,10418,10418,0,0,0,10418,10418,0,0,0,0,172
157,y1107,20110124,10418,10418,0,0,0,10418,10418,0,0,0,0,172
158,y1107,20110125,10418,10418,0,0,0,10418,10418,0,0,0,0,172
159,y1107,20110126,10418,10418,10150,10260,10150,10200,10204,-218,-214,36,3673600,140
160,y1107,20110127,10200,10204,10250,10250,10250,10250,10250,46,46,6,615000,134
161,y1107,20110128,10250,10250,10222,10654,10222,10302,10336,52,86,16,1653760,134
162,y1107,20110131,10302,10336,10350,10350,10350,10350,10350,14,14,2,207000,132
163,y1107,20110201,10350,10350,10068,10520,10068,10520,10294,170,-56,4,411760,130
164,y1107,20110209,10520,10294,0,0,0,10294,10294,0,0,0,0,130
165,y1107,20110210,10294,10294,0,0,0,10294,10294,0,0,0,0,130
166,y1107,20110211,10294,10294,0,0,0,10294,10294,0,0,0,0,130
167,y1107,20110214,10294,10294,0,0,0,10294,10294,0,0,0,0,130
168,y1107,20110215,10294,10294,10620,10634,10620,10634,10624,340,330,14,1487520,136
169,y1107,20110216,10634,10624,10514,10524,10512,10512,10514,-112,-110,14,1472080,130
170,y1107,20110217,10512,10514,10508,10508,10508,10508,10508,-6,-6,4,420320,130
171,y1107,20110218,10508,10508,10480,10480,10450,10450,10470,-58,-38,12,1256400,130
172,y1107,20110221,10450,10470,10400,10422,10398,10422,10406,-48,-64,18,1873160,130
173,y1107,20110222,10422,10406,0,0,0,10406,10406,0,0,0,0,130
174,y1107,20110223,10406,10406,10246,10246,10230,10230,10236,-176,-170,10,1023640,130
175,y1107,20110224,10230,10236,10080,10080,10080,10080,10080,-156,-156,2,201600,130
176,y1107,20110225,10080,10080,0,0,0,10080,10080,0,0,0,0,130
177,y1107,20110228,10080,10080,0,0,0,10080,10080,0,0,0,0,130
178,y1107,20110301,10080,10080,0,0,0,10080,10080,0,0,0,0,130
179,y1107,20110302,10080,10080,0,0,0,10080,10080,0,0,0,0,130
180,y1107,20110303,10080,10080,10280,10280,10280,10280,10280,200,200,4,411200,130
181,y1107,20110304,10280,10280,10480,10480,10432,10432,10464,152,184,12,1255760,130
182,y1107,20110307,10432,10464,10432,10432,10384,10384,10416,-80,-48,6,624960,130
183,y1107,20110308,10384,10416,10410,10410,10410,10410,10410,-6,-6,6,624600,130
184,y1107,20110309,10410,10410,0,0,0,10410,10410,0,0,0,0,130
185,y1107,20110310,10410,10410,10102,10102,10070,10070,10080,-340,-330,12,1209640,138
186,y1107,20110311,10070,10080,0,0,0,10080,10080,0,0,0,0,138
187,y1107,20110314,10080,10080,10078,10078,10048,10048,10058,-32,-22,12,1206960,138
188,y1107,20110315,10048,10058,0,0,0,10058,10058,0,0,0,0,138
189,y1107,20110316,10058,10058,0,0,0,10058,10058,0,0,0,0,138
190,y1107,20110317,10058,10058,0,0,0,10058,10058,0,0,0,0,138
191,y1107,20110318,10058,10058,0,0,0,10058,10058,0,0,0,0,138
192,y1107,20110321,10058,10058,0,0,0,10058,10058,0,0,0,0,138
193,y1107,20110322,10058,10058,0,0,0,10058,10058,0,0,0,0,138
194,y1107,20110323,10058,10058,0,0,0,10058,10058,0,0,0,0,138
195,y1107,20110324,10058,10058,0,0,0,10058,10058,0,0,0,0,138
196,y1107,20110325,10058,10058,0,0,0,10058,10058,0,0,0,0,138
197,y1107,20110328,10058,10058,0,0,0,10058,10058,0,0,0,0,138
198,y1107,20110329,10058,10058,0,0,0,10058,10058,0,0,0,0,138
199,y1107,20110330,10058,10058,10148,10206,10134,10206,10158,148,100,8,812720,138
200,y1107,20110331,10206,10158,0,0,0,10158,10158,0,0,0,0,138
201,y1107,20110401,10158,10158,10332,10350,10332,10346,10342,188,184,6,620560,138
202,y1107,20110406,10346,10342,10480,10480,10360,10472,10418,130,76,24,2500320,132
203,y1107,20110407,10472,10418,10362,10362,10362,10362,10362,-56,-56,2,207240,132
204,y1107,20110408,10362,10362,0,0,0,10362,10362,0,0,0,0,132
205,y1107,20110411,10362,10362,10500,10500,10500,10500,10500,138,138,2,210000,134
206,y1107,20110412,10500,10500,10324,10338,10180,10180,10298,-320,-202,120,12359120,180
207,y1107,20110413,10180,10298,10184,10184,10130,10130,10136,-168,-162,18,1824480,178
208,y1107,20110414,10130,10136,10010,10076,10010,10076,10066,-60,-70,30,3019800,178
209,y1107,20110415,10076,10066,0,0,0,10066,10066,0,0,0,0,178
210,y1107,20110418,10066,10066,0,0,0,10066,10066,0,0,0,0,178
211,y1107,20110419,10066,10066,0,0,0,10066,10066,0,0,0,0,178
212,y1107,20110420,10066,10066,0,0,0,10066,10066,0,0,0,0,178
213,y1107,20110421,10066,10066,10000,10000,10000,10000,10000,-66,-66,4,400000,176
214,y1107,20110422,10000,10000,10002,10138,10002,10050,10036,50,36,68,6825200,170
215,y1107,20110425,10050,10036,0,0,0,10036,10036,0,0,0,0,170
216,y1107,20110426,10036,10036,9950,9950,9950,9950,9950,-86,-86,4,398000,170
217,y1107,20110427,9950,9950,10030,10030,10030,10030,10030,80,80,2,200600,168
218,y1107,20110428,10030,10030,9912,10048,9912,10048,9980,18,-50,4,399200,166
219,y1107,20110429,10048,9980,0,0,0,9980,9980,0,0,0,0,166
220,y1107,20110503,9980,9980,0,0,0,9980,9980,0,0,0,0,166
221,y1107,20110504,9980,9980,0,0,0,9980,9980,0,0,0,0,166
222,y1107,20110505,9980,9980,9968,9968,9840,9840,9904,-140,-76,8,792320,162
223,y1107,20110506,9840,9904,9640,9640,9640,9640,9640,-264,-264,2,192800,160
224,y1107,20110509,9640,9640,9756,9756,9650,9650,9686,10,46,34,3293680,152
225,y1107,20110510,9650,9686,0,0,0,9686,9686,0,0,0,0,152
226,y1107,20110511,9686,9686,0,0,0,9686,9686,0,0,0,0,152
227,y1107,20110512,9686,9686,9686,9754,9686,9754,9720,68,34,4,388800,152
228,y1107,20110513,9754,9720,9800,9800,9800,9800,9800,80,80,20,1960000,152
229,y1107,20110516,9800,9800,0,0,0,9800,9800,0,0,0,0,152
230,y1107,20110517,9800,9800,0,0,0,9800,9800,0,0,0,0,152
231,y1107,20110518,9800,9800,0,0,0,9800,9800,0,0,0,0,152
232,y1107,20110519,9800,9800,9790,9790,9786,9786,9786,-14,-14,36,3523280,132
233,y1107,20110520,9786,9786,9770,9830,9770,9830,9810,44,24,6,588600,132
234,y1107,20110523,9830,9810,9892,10124,9828,9828,9912,18,102,20,1982640,132
235,y1107,20110524,9828,9912,9870,9870,9768,9824,9802,-88,-110,130,12745080,128
236,y1107,20110525,9824,9802,9930,9930,9830,9858,9864,56,62,18,1775600,124
237,y1107,20110526,9858,9864,9916,9916,9916,9916,9916,52,52,2,198320,124
238,y1107,20110527,9916,9916,0,0,0,9916,9916,0,0,0,0,124
239,y1107,20110530,9916,9916,0,0,0,9916,9916,0,0,0,0,124
240,y1107,20110531,9916,9916,9952,9952,9880,9880,9928,-36,12,6,595680,122
241,y1107,20110601,9880,9928,10366,10366,9752,9932,10034,4,106,26,2609160,116
242,y1107,20110602,9932,10034,9892,9892,9884,9884,9888,-150,-146,4,395520,116
243,y1107,20110603,9884,9888,10054,10150,10012,10030,10052,142,164,16,1608320,108
244,y1107,20110607,10030,10052,9908,9908,9908,9908,9908,-144,-144,4,396320,108
245,y1107,20110608,9908,9908,0,0,0,9908,9908,0,0,0,0,108
246,y1107,20110609,9908,9908,9920,9920,9920,9920,9920,12,12,4,396800,104
247,y1107,20110610,9920,9920,9930,10004,9752,9940,9884,20,-36,46,4547280,96
248,y1107,20110613,9940,9884,0,0,0,9884,9884,0,0,0,0,96
249,y1107,20110614,9884,9884,0,0,0,9884,9884,0,0,0,0,96
250,y1107,20110615,9884,9884,10000,10000,10000,10000,10000,116,116,2,200000,94
251,y1107,20110616,10000,10000,0,0,0,10000,10000,0,0,0,0,94
252,y1107,20110617,10000,10000,0,0,0,10000,10000,0,0,0,0,94
253,y1107,20110620,10000,10000,0,0,0,10000,10000,0,0,0,0,94
254,y1107,20110621,10000,10000,0,0,0,10000,10000,0,0,0,0,94
255,y1107,20110622,10000,10000,0,0,0,10000,10000,0,0,0,0,94
256,y1107,20110623,10000,10000,9650,9750,9650,9750,9730,-250,-270,12,1167600,84
257,y1107,20110624,9750,9730,0,0,0,9730,9730,0,0,0,0,84
258,y1107,20110627,9730,9730,9500,9500,9450,9500,9464,-230,-266,14,1325000,76
259,y1107,20110628,9500,9464,9500,9552,9500,9552,9538,88,74,40,3815360,46
260,y1107,20110629,9552,9538,9538,9538,9538,9538,9538,0,0,2,190760,44
261,y1107,20110630,9538,9538,9800,9800,9500,9500,9650,-38,112,4,386000,44
262,y1107,20110701,9500,9650,9460,9460,9460,9460,9460,-190,-190,44,4162400,44
263,y1107,20110704,9460,9460,0,0,0,9460,9460,0,0,0,0,44
264,y1107,20110705,9460,9460,0,0,0,9460,9460,0,0,0,0,44
265,y1107,20110706,9460,9460,0,0,0,9460,9460,0,0,0,0,0
266,y1107,20110707,9460,9460,0,0,0,9460,9460,0,0,0,0,0
267,y1107,20110708,9460,9460,0,0,0,9460,9460,0,0,0,0,0
268,y1107,20110711,9460,9460,0,0,0,9460,9460,0,0,0,0,0
269,y1107,20110712,9460,9460,0,0,0,9460,9460,0,0,0,0,0
270,y1107,20110713,9460,9460,0,0,0,9460,9460,0,0,0,0,0
271,y1107,20110714,9460,9460,0,0,0,9460,9460,0,0,0,0,0
272,y1108,20110104,10464,10438,10222,10612,10222,10552,10486,114,48,8,838920,192
273,y1108,20110105,10552,10486,10484,10594,10484,10512,10530,26,44,6,631800,194
274,y1108,20110106,10512,10530,10596,10770,10596,10702,10720,172,190,24,2573160,192
275,y1108,20110107,10702,10720,10568,10712,10486,10692,10630,-28,-90,46,4890560,192
276,y1108,20110110,10692,10630,10542,10602,10542,10578,10588,-52,-42,18,1906000,192
277,y1108,20110111,10578,10588,10610,10766,10530,10596,10612,8,24,12,1273440,192
278,y1108,20110112,10596,10612,10654,10654,10494,10496,10612,-116,0,62,6580200,196
279,y1108,20110113,10496,10612,10700,10700,10566,10566,10628,-46,16,58,6165080,204
280,y1108,20110114,10566,10628,10512,10584,10512,10532,10546,-96,-82,18,1898320,204
281,y1108,20110117,10532,10546,0,0,0,10546,10546,0,0,0,0,204
282,y1108,20110118,10546,10546,10502,10502,10420,10420,10460,-126,-86,4,418440,204
283,y1108,20110119,10420,10460,10604,10604,10530,10530,10580,70,120,42,4444360,204
284,y1108,20110120,10530,10580,10586,10588,10586,10588,10586,8,6,4,423480,204
285,y1108,20110121,10588,10586,0,0,0,10586,10586,0,0,0,0,204
286,y1108,20110124,10586,10586,10820,11000,10776,10820,10840,234,254,28,3035640,208
287,y1108,20110125,10820,10840,10580,10714,10580,10652,10646,-188,-194,16,1703520,206
288,y1108,20110126,10652,10646,10476,10476,10260,10320,10318,-326,-328,22,2270320,206
289,y1108,20110127,10320,10318,10402,10472,10402,10472,10426,154,108,6,625560,202
290,y1108,20110128,10472,10426,0,0,0,10426,10426,0,0,0,0,202
291,y1108,20110131,10426,10426,0,0,0,10426,10426,0,0,0,0,202
292,y1108,20110201,10426,10426,10648,10648,10600,10600,10612,174,186,16,1698120,208
293,y1108,20110209,10600,10612,10800,10800,10730,10730,10752,118,140,16,1720560,208
294,y1108,20110210,10730,10752,10992,11028,10910,10910,10976,158,224,30,3293160,216
295,y1108,20110211,10910,10976,10912,10922,10896,10922,10908,-54,-68,10,1090960,216
296,y1108,20110214,10922,10908,10872,10872,10870,10870,10870,-38,-38,6,652280,220
297,y1108,20110215,10870,10870,10822,10822,10800,10800,10802,-70,-68,60,6482200,272
298,y1108,20110216,10800,10802,10656,10660,10550,10658,10630,-144,-172,20,2126040,272
299,y1108,20110217,10658,10630,10622,10680,10530,10552,10568,-78,-62,22,2325360,272
300,y1108,20110218,10552,10568,10578,10582,10502,10502,10552,-66,-16,76,8020240,272
301,y1108,20110221,10502,10552,10448,10500,10432,10458,10462,-94,-90,16,1674080,276
302,y1108,20110222,10458,10462,10500,10626,10500,10528,10562,66,100,10,1056200,276
303,y1108,20110223,10528,10562,10154,10238,10140,10150,10160,-412,-402,16,1625800,270
304,y1108,20110224,10150,10160,10056,10088,9992,10088,10056,-72,-104,10,1005600,270
305,y1108,20110225,10088,10056,10274,10274,10120,10162,10176,106,120,18,1831920,274
306,y1108,20110228,10162,10176,10248,10396,10248,10270,10290,94,114,8,823240,272
307,y1108,20110301,10270,10290,10516,10516,10160,10324,10380,34,90,788,81795480,358
308,y1108,20110302,10324,10380,10394,10518,10376,10476,10460,96,80,66,6903760,340
309,y1108,20110303,10476,10460,10530,10530,10484,10518,10508,58,48,18,1891600,338
310,y1108,20110304,10518,10508,10610,10610,10508,10508,10572,0,64,100,10572760,362
311,y1108,20110307,10508,10572,10506,10558,10506,10558,10532,-14,-40,8,842560,364
312,y1108,20110308,10558,10532,10458,10458,10406,10406,10432,-126,-100,4,417280,364
313,y1108,20110309,10406,10432,10328,10328,10328,10328,10328,-104,-104,12,1239360,364
314,y1108,20110310,10328,10328,10156,10156,10156,10156,10156,-172,-172,6,609360,358
315,y1108,20110311,10156,10156,10266,10266,10132,10146,10234,-10,78,16,1637480,352
316,y1108,20110314,10146,10234,9986,10108,9984,9984,10038,-250,-196,8,803160,354
317,y1108,20110315,9984,10038,10098,10098,10002,10002,10050,-36,12,4,402000,352
318,y1108,20110316,10002,10050,9850,9898,9850,9898,9866,-152,-184,12,1183920,348
319,y1108,20110317,9898,9866,10068,10068,9976,9988,10036,122,170,20,2007480,366
320,y1108,20110318,9988,10036,10186,10186,10058,10128,10104,92,68,20,2020880,356
321,y1108,20110321,10128,10104,10174,10174,10174,10174,10174,70,70,2,203480,356
322,y1108,20110322,10174,10174,10166,10240,10076,10240,10160,66,-14,6,609640,356
323,y1108,20110323,10240,10160,10240,10276,10178,10178,10236,18,76,18,1842680,358
324,y1108,20110324,10178,10236,10090,10090,10060,10060,10062,-176,-174,22,2214000,368
325,y1108,20110325,10060,10062,0,0,0,10062,10062,0,0,0,0,368
326,y1108,20110328,10062,10062,10062,10142,10062,10142,10102,80,40,8,808160,368
327,y1108,20110329,10142,10102,10074,10074,10074,10074,10074,-28,-28,2,201480,368
328,y1108,20110330,10074,10074,10074,10260,10074,10260,10190,186,116,14,1426840,368
329,y1108,20110331,10260,10190,0,0,0,10190,10190,0,0,0,0,368
330,y1108,20110401,10190,10190,0,0,0,10190,10190,0,0,0,0,368
331,y1108,20110406,10190,10190,0,0,0,10190,10190,0,0,0,0,368
332,y1108,20110407,10190,10190,10470,10470,10270,10270,10370,80,180,4,414800,368
333,y1108,20110408,10270,10370,10322,10444,10322,10392,10410,22,40,44,4580440,380
334,y1108,20110411,10392,10410,10442,10578,10442,10530,10520,120,110,20,2104320,368
335,y1108,20110412,10530,10520,0,0,0,10520,10520,0,0,0,0,368
336,y1108,20110413,10520,10520,0,0,0,10520,10520,0,0,0,0,368
337,y1108,20110414,10520,10520,10150,10198,10120,10120,10166,-400,-354,10,1016640,366
338,y1108,20110415,10120,10166,0,0,0,10166,10166,0,0,0,0,366
339,y1108,20110418,10166,10166,9990,10198,9972,10094,10046,-72,-120,18,1808360,366
340,y1108,20110419,10094,10046,0,0,0,10046,10046,0,0,0,0,366
341,y1108,20110420,10046,10046,10108,10114,10108,10114,10110,68,64,4,404440,362
342,y1108,20110421,10114,10110,0,0,0,10110,10110,0,0,0,0,362
343,y1108,20110422,10110,10110,10202,10218,10192,10192,10196,82,86,22,2243400,364
344,y1108,20110425,10192,10196,10306,10306,10210,10240,10234,44,38,26,2660960,360
345,y1108,20110426,10240,10234,10150,10150,10102,10102,10136,-132,-98,14,1419040,358
346,y1108,20110427,10102,10136,0,0,0,10136,10136,0,0,0,0,358
347,y1108,20110428,10136,10136,0,0,0,10136,10136,0,0,0,0,358
348,y1108,20110429,10136,10136,9908,9908,9908,9908,9908,-228,-228,2,198160,358
349,y1108,20110503,9908,9908,0,0,0,9908,9908,0,0,0,0,358
350,y1108,20110504,9908,9908,9912,9912,9912,9912,9912,4,4,2,198240,358
351,y1108,20110505,9912,9912,9940,9968,9940,9968,9958,56,46,8,796680,354
352,y1108,20110506,9968,9958,9708,9722,9708,9722,9712,-236,-246,10,971360,348
353,y1108,20110509,9722,9712,9796,9796,9796,9796,9796,84,84,2,195920,346
354,y1108,20110510,9796,9796,9800,9800,9800,9800,9800,4,4,80,7840000,346
355,y1108,20110511,9800,9800,0,0,0,9800,9800,0,0,0,0,346
356,y1108,20110512,9800,9800,9792,9792,9792,9792,9792,-8,-8,12,1175040,348
357,y1108,20110513,9792,9792,9800,9800,9800,9800,9800,8,8,2,196000,346
358,y1108,20110516,9800,9800,0,0,0,9800,9800,0,0,0,0,346
359,y1108,20110517,9800,9800,0,0,0,9800,9800,0,0,0,0,346
360,y1108,20110518,9800,9800,0,0,0,9800,9800,0,0,0,0,346
361,y1108,20110519,9800,9800,0,0,0,9800,9800,0,0,0,0,346
362,y1108,20110520,9800,9800,0,0,0,9800,9800,0,0,0,0,346
363,y1108,20110523,9800,9800,0,0,0,9800,9800,0,0,0,0,346
364,y1108,20110524,9800,9800,0,0,0,9800,9800,0,0,0,0,346
365,y1108,20110525,9800,9800,10096,10096,9970,9980,10004,180,204,18,1800920,332
366,y1108,20110526,9980,10004,10056,10056,10056,10056,10056,52,52,4,402240,328
367,y1108,20110527,10056,10056,0,0,0,10056,10056,0,0,0,0,328
368,y1108,20110530,10056,10056,0,0,0,10056,10056,0,0,0,0,328
369,y1108,20110531,10056,10056,10052,10052,10050,10050,10050,-6,-6,6,603080,326
370,y1108,20110601,10050,10050,0,0,0,10050,10050,0,0,0,0,326
371,y1108,20110602,10050,10050,10000,10000,10000,10000,10000,-50,-50,4,400000,322
372,y1108,20110603,10000,10000,0,0,0,10000,10000,0,0,0,0,322
373,y1108,20110607,10000,10000,10052,10052,10050,10050,10050,50,50,8,804080,320
374,y1108,20110608,10050,10050,10030,10100,10030,10030,10052,-20,2,12,1206360,312
375,y1108,20110609,10030,10052,10050,10050,10050,10050,10050,-2,-2,2,201000,310
376,y1108,20110610,10050,10050,0,0,0,10050,10050,0,0,0,0,310
377,y1108,20110613,10050,10050,9968,9970,9960,9970,9968,-80,-82,54,5383120,256
378,y1108,20110614,9970,9968,10048,10048,9940,9940,9994,-28,26,4,399760,256
379,y1108,20110615,9940,9994,0,0,0,9994,9994,0,0,0,0,256
380,y1108,20110616,9994,9994,9852,9852,9852,9852,9852,-142,-142,8,788160,256
381,y1108,20110617,9852,9852,0,0,0,9852,9852,0,0,0,0,256
382,y1108,20110620,9852,9852,9802,9802,9802,9802,9802,-50,-50,2,196040,256
383,y1108,20110621,9802,9802,9802,9872,9802,9872,9864,70,62,22,2170240,236
384,y1108,20110622,9872,9864,0,0,0,9864,9864,0,0,0,0,236
385,y1108,20110623,9864,9864,0,0,0,9864,9864,0,0,0,0,236
386,y1108,20110624,9864,9864,0,0,0,9864,9864,0,0,0,0,236
387,y1108,20110627,9864,9864,0,0,0,9864,9864,0,0,0,0,236
388,y1108,20110628,9864,9864,9620,9620,9620,9620,9620,-244,-244,30,2886000,208
389,y1108,20110629,9620,9620,9698,9698,9698,9698,9698,78,78,4,387920,208
390,y1108,20110630,9698,9698,9700,9700,9700,9700,9700,2,2,2,194000,206
391,y1108,20110701,9700,9700,9690,9690,9552,9552,9620,-148,-80,4,384840,206
392,y1108,20110704,9552,9620,0,0,0,9620,9620,0,0,0,0,206
393,y1108,20110705,9620,9620,9718,9720,9690,9700,9702,80,82,22,2134760,184
394,y1108,20110706,9700,9702,0,0,0,9702,9702,0,0,0,0,184
395,y1108,20110707,9702,9702,9740,9860,9740,9860,9768,158,66,26,2539960,164
396,y1108,20110708,9860,9768,10000,10000,9916,9916,9958,148,190,4,398320,166
397,y1108,20110711,9916,9958,0,0,0,9958,9958,0,0,0,0,166
398,y1108,20110712,9958,9958,9900,9900,9868,9868,9886,-90,-72,10,988760,156
399,y1108,20110713,9868,9886,0,0,0,9886,9886,0,0,0,0,156
400,y1108,20110714,9886,9886,9960,9960,9960,9960,9960,74,74,18,1792800,138
401,y1108,20110715,9960,9960,9900,9900,9900,9900,9900,-60,-60,4,396000,134
402,y1108,20110718,9900,9900,9930,9930,9880,9880,9884,-20,-16,20,1977000,114
403,y1108,20110719,9880,9884,9900,9900,9900,9900,9900,16,16,10,990000,104
404,y1108,20110720,9900,9900,9920,9920,9920,9920,9920,20,20,6,595200,98
405,y1108,20110721,9920,9920,0,0,0,9920,9920,0,0,0,0,98
406,y1108,20110722,9920,9920,9910,9910,9910,9910,9910,-10,-10,32,3171200,66
407,y1108,20110725,9910,9910,0,0,0,9910,9910,0,0,0,0,66
408,y1108,20110726,9910,9910,9830,9830,9820,9820,9820,-90,-90,14,1375000,52
409,y1108,20110727,9820,9820,9840,9850,9820,9820,9840,0,20,12,1180800,44
410,y1108,20110728,9820,9840,9760,9830,9760,9830,9824,-10,-16,40,3929600,42
411,y1108,20110729,9830,9824,9950,9950,9950,9950,9950,126,126,2,199000,40
412,y1108,20110801,9950,9950,0,0,0,9950,9950,0,0,0,0,0
413,y1108,20110802,9950,9950,0,0,0,9950,9950,0,0,0,0,0
414,y1108,20110803,9950,9950,0,0,0,9950,9950,0,0,0,0,0
415,y1108,20110804,9950,9950,0,0,0,9950,9950,0,0,0,0,0
416,y1108,20110805,9950,9950,0,0,0,9950,9950,0,0,0,0,0
417,y1108,20110808,9950,9950,0,0,0,9950,9950,0,0,0,0,0
418,y1108,20110809,9950,9950,0,0,0,9950,9950,0,0,0,0,0
419,y1108,20110810,9950,9950,0,0,0,9950,9950,0,0,0,0,0
420,y1108,20110811,9950,9950,0,0,0,9950,9950,0,0,0,0,0
421,y1108,20110812,9950,9950,0,0,0,9950,9950,0,0,0,0,0
422,y1109,20110104,10526,10476,10520,10646,10510,10610,10588,134,112,505368,53516591160,432550
423,y1109,20110105,10610,10588,10514,10580,10462,10512,10526,-76,-62,487374,51310382480,441018
424,y1109,20110106,10512,10526,10612,10828,10612,10800,10748,274,222,579428,62285595840,477484
425,y1109,20110107,10800,10748,10652,10780,10482,10586,10654,-162,-94,938576,1.00003E+11,461834
426,y1109,20110110,10586,10654,10660,10662,10502,10546,10580,-108,-74,692528,73281216880,471438
427,y1109,20110111,10546,10580,10624,10650,10540,10610,10586,30,6,484862,51333796600,474756
428,y1109,20110112,10610,10586,10590,10638,10412,10472,10528,-114,-58,942140,99204875680,482074
429,y1109,20110113,10472,10528,10770,10770,10546,10556,10624,28,96,653058,69388548480,448022
430,y1109,20110114,10556,10624,10530,10608,10492,10584,10560,-40,-64,437580,46215800640,439608
431,y1109,20110117,10584,10560,10586,10604,10474,10520,10538,-40,-22,557210,58721095240,449238
432,y1109,20110118,10520,10538,10478,10524,10362,10470,10440,-68,-98,649106,67776014560,428274
433,y1109,20110119,10470,10440,10520,10608,10482,10598,10552,158,112,495070,52246714000,424436
434,y1109,20110120,10598,10552,10530,10640,10522,10572,10584,20,32,598938,63396835560,426116
435,y1109,20110121,10572,10584,10488,10576,10488,10558,10540,-26,-44,498330,52532789160,411568
436,y1109,20110124,10558,10540,10600,10858,10600,10736,10762,196,222,730208,78588306200,457476
437,y1109,20110125,10736,10762,10658,10706,10556,10558,10626,-204,-136,464736,49389167400,447776
438,y1109,20110126,10558,10626,10400,10422,10180,10314,10276,-312,-350,615930,63304538160,427626
439,y1109,20110127,10314,10276,10450,10472,10350,10400,10410,124,134,420956,43824630480,430900
440,y1109,20110128,10400,10410,10398,10436,10360,10388,10404,-22,-6,305682,31808287280,415588
441,y1109,20110131,10388,10404,10420,10616,10414,10592,10556,188,152,310196,32746685040,422620
442,y1109,20110201,10592,10556,10628,10660,10562,10628,10614,72,58,205946,21860664680,413864
443,y1109,20110209,10628,10614,10796,10846,10646,10802,10766,188,152,362076,38983329360,405262
444,y1109,20110210,10802,10766,10890,10976,10834,10874,10912,108,146,407264,44447314360,417826
445,y1109,20110211,10874,10912,10846,10906,10792,10862,10866,-50,-46,362450,39384030760,404712
446,y1109,20110214,10862,10866,10880,10900,10754,10886,10840,20,-26,315182,34172003000,414500
447,y1109,20110215,10886,10840,10792,10828,10730,10736,10786,-104,-54,344568,37168029080,430378
448,y1109,20110216,10736,10786,10496,10590,10442,10530,10528,-256,-258,446442,47010035640,415594
449,y1109,20110217,10530,10528,10560,10620,10380,10382,10514,-146,-14,564278,59330693240,438870
450,y1109,20110218,10382,10514,10560,10564,10358,10360,10472,-154,-42,475214,49764983680,412096
451,y1109,20110221,10360,10472,10286,10394,10256,10356,10348,-116,-124,357824,37032780960,408482
452,y1109,20110222,10356,10348,10450,10504,10300,10464,10420,116,72,581714,60624314640,400374
453,y1109,20110223,10464,10420,10010,10106,9868,10040,10046,-380,-374,503396,50576015800,366744
454,y1109,20110224,10040,10046,10140,10140,9782,9880,9964,-166,-82,480312,47866263400,348932
455,y1109,20110225,9880,9964,9930,10056,9918,10042,10000,78,36,365324,36538174960,327782
456,y1109,20110228,10042,10000,10196,10222,10130,10198,10178,198,178,362064,36852911480,322568
457,y1109,20110301,10198,10178,10200,10240,10100,10200,10174,22,-4,455146,46310159280,327788
458,y1109,20110302,10200,10174,10188,10396,10180,10380,10290,206,116,533412,54892494160,347772
459,y1109,20110303,10380,10290,10366,10450,10304,10308,10374,18,84,426842,44289112720,328010
460,y1109,20110304,10308,10374,10398,10462,10350,10438,10410,64,36,424172,44160708720,320622
461,y1109,20110307,10438,10410,10424,10478,10382,10426,10426,16,16,371180,38706169000,324138
462,y1109,20110308,10426,10426,10338,10376,10204,10252,10290,-174,-136,398360,40992277560,323598
463,y1109,20110309,10252,10290,10262,10296,10166,10180,10224,-110,-66,459796,47010340960,306420
464,y1109,20110310,10180,10224,10050,10124,9996,10048,10070,-176,-154,387870,39059506080,315624
465,y1109,20110311,10048,10070,10068,10114,9990,10006,10046,-64,-24,411066,41300023680,324420
466,y1109,20110314,10006,10046,9988,9996,9836,9880,9910,-166,-136,459172,45504200880,337816
467,y1109,20110315,9880,9910,9898,9960,9850,9940,9912,30,2,408572,40498656240,342318
468,y1109,20110316,9940,9912,9700,9812,9620,9806,9730,-106,-182,473304,46053373600,339642
469,y1109,20110317,9806,9730,9750,9890,9736,9872,9818,142,88,414130,40662271200,343934
470,y1109,20110318,9872,9818,9970,10016,9936,9982,9978,164,160,350542,34983653840,343058
471,y1109,20110321,9982,9978,10032,10128,10030,10074,10076,96,98,417536,42077876360,336128
472,y1109,20110322,10074,10076,10000,10074,10000,10028,10048,-48,-28,285952,28734416720,340512
473,y1109,20110323,10028,10048,10048,10168,10046,10152,10116,104,68,305998,30956901160,342692
474,y1109,20110324,10152,10116,10122,10140,9952,9966,10038,-150,-78,461472,46325785400,356390
475,y1109,20110325,9966,10038,10040,10120,10038,10094,10080,56,42,332342,33501633360,338234
476,y1109,20110328,10094,10080,10120,10168,9982,10066,10092,-14,12,475998,48045033120,322900
477,y1109,20110329,10066,10092,10010,10054,9952,10042,10008,-50,-84,410208,41061233840,319778
478,y1109,20110330,10042,10008,10086,10148,10064,10100,10106,92,98,329044,33254161080,299766
479,y1109,20110331,10100,10106,10140,10146,10052,10124,10104,18,-2,254212,25687006480,296212
480,y1109,20110401,10124,10104,10228,10270,10194,10210,10232,106,128,287354,29404209680,294280
481,y1109,20110406,10210,10232,10188,10338,10188,10330,10286,98,54,302102,31076646880,320846
482,y1109,20110407,10330,10286,10284,10336,10274,10290,10298,4,12,201236,20725081080,319116
483,y1109,20110408,10290,10298,10256,10356,10238,10352,10298,54,0,268000,27599795200,319098
484,y1109,20110411,10352,10298,10432,10468,10390,10396,10436,98,138,202754,21160478480,286608
485,y1109,20110412,10396,10436,10282,10296,10200,10210,10246,-226,-190,150972,15468907920,260688
486,y1109,20110413,10210,10246,10120,10130,10038,10118,10080,-128,-166,152858,15408593640,244268
487,y1109,20110414,10118,10080,10080,10098,9976,9978,10050,-102,-30,95314,9580933000,236988
488,y1109,20110415,9978,10050,10010,10046,9926,9930,9990,-120,-60,102792,10269840480,228562
489,y1109,20110418,9930,9990,9900,9976,9862,9964,9930,-26,-60,58034,5763921000,224924
490,y1109,20110419,9964,9930,9990,10028,9906,9918,9962,-12,32,79894,7959447360,218912
491,y1109,20110420,9918,9962,9960,10086,9960,10082,10034,120,72,78688,7895594440,205054
492,y1109,20110421,10082,10034,10092,10108,10040,10056,10068,22,34,51468,5182568360,199176
493,y1109,20110422,10056,10068,10090,10160,10088,10154,10130,86,62,74742,7572557560,180994
494,y1109,20110425,10154,10130,10184,10196,10140,10166,10168,36,38,57576,5855183440,168816
495,y1109,20110426,10166,10168,10042,10100,10022,10026,10054,-142,-114,46778,4703569120,165610
496,y1109,20110427,10026,10054,10060,10082,9992,10010,10050,-44,-4,45344,4557728400,159702
497,y1109,20110428,10010,10050,10058,10120,10044,10118,10078,68,28,30896,3114225800,156764
498,y1109,20110429,10118,10078,10020,10020,9880,9890,9926,-188,-152,65910,6543392000,152776
499,y1109,20110503,9890,9926,9996,10016,9960,10004,9990,78,64,35232,3519940280,147310
500,y1109,20110504,10004,9990,9952,9964,9884,9910,9922,-80,-68,26188,2598575400,147552
501,y1109,20110505,9910,9922,9868,9922,9794,9900,9868,-22,-54,40700,4017047000,144942
502,y1109,20110506,9900,9868,9700,9756,9652,9668,9708,-200,-160,52314,5079249880,137308
503,y1109,20110509,9668,9708,9700,9740,9690,9726,9718,18,10,18970,1843509040,133532
504,y1109,20110510,9726,9718,9730,9810,9710,9798,9758,80,40,16064,1567712160,131198
505,y1109,20110511,9798,9758,9816,9846,9788,9792,9818,34,60,17146,1683640920,129422
506,y1109,20110512,9792,9818,9850,9850,9706,9714,9770,-104,-48,23132,2260419160,127092
507,y1109,20110513,9714,9770,9798,9862,9762,9848,9810,78,40,25182,2470382920,127838
508,y1109,20110516,9848,9810,9794,9848,9754,9770,9782,-40,-28,17334,1695655800,128782
509,y1109,20110517,9770,9782,9758,9768,9646,9750,9706,-32,-76,31438,3051408560,126678
510,y1109,20110518,9750,9706,9780,9866,9780,9830,9836,124,130,22320,2195657680,126348
511,y1109,20110519,9830,9836,9930,9958,9908,9922,9934,86,98,14220,1412812120,125702
512,y1109,20110520,9922,9934,9950,10006,9930,10004,9968,70,34,21204,2114022840,125732
513,y1109,20110523,10004,9968,9970,10034,9966,9972,10002,4,34,13342,1334722680,124380
514,y1109,20110524,9972,10002,9986,10056,9978,10044,10006,42,4,15256,1526585600,118616
515,y1109,20110525,10044,10006,10042,10042,9974,9990,10002,-16,-4,10928,1093061640,116460
516,y1109,20110526,9990,10002,10046,10098,10046,10098,10072,96,70,13542,1364036240,114370
517,y1109,20110527,10098,10072,10120,10120,10068,10100,10090,28,18,10588,1068338680,111562
518,y1109,20110530,10100,10090,10096,10156,10070,10110,10124,20,34,9544,966249960,107780
519,y1109,20110531,10110,10124,10110,10136,10070,10096,10098,-28,-26,6306,636817640,106436
520,y1109,20110601,10096,10098,10100,10128,10060,10070,10086,-28,-12,5142,518641760,105394
521,y1109,20110602,10070,10086,10082,10120,10028,10114,10078,28,-8,5270,531176640,104096
522,y1109,20110603,10114,10078,10118,10280,10118,10272,10208,194,130,13088,1336102440,100406
523,y1109,20110607,10272,10208,10192,10192,10116,10180,10148,-28,-60,16388,1663281400,92280
524,y1109,20110608,10180,10148,10208,10208,10098,10142,10160,-6,12,6686,679343080,90894
525,y1109,20110609,10142,10160,10366,10366,10146,10150,10182,-10,22,7804,794728440,89434
526,y1109,20110610,10150,10182,10140,10168,10062,10076,10112,-106,-70,6388,646061480,89542
527,y1109,20110613,10076,10112,10116,10116,10052,10064,10070,-48,-42,5174,521121400,89106
528,y1109,20110614,10064,10070,10076,10104,10050,10100,10074,30,4,3888,391736440,87976
529,y1109,20110615,10100,10074,10086,10140,10060,10124,10102,50,28,4250,429412800,86382
530,y1109,20110616,10124,10102,10096,10102,9958,9986,10004,-116,-98,13682,1368789120,79146
531,y1109,20110617,9986,10004,10000,10000,9926,9966,9952,-38,-52,4482,446123080,77906
532,y1109,20110620,9966,9952,9932,9978,9928,9942,9954,-10,2,3482,346651760,76874
533,y1109,20110621,9942,9954,9918,9998,9918,9986,9974,32,20,3228,322004720,76178
534,y1109,20110622,9986,9974,9998,10000,9944,9948,9974,-26,0,2470,246399000,75384
535,y1109,20110623,9948,9974,9938,9938,9850,9912,9894,-62,-80,3688,364937000,73756
536,y1109,20110624,9912,9894,9850,9900,9850,9866,9880,-28,-14,2952,291687760,72658
537,y1109,20110627,9866,9880,9838,9838,9670,9710,9730,-170,-150,7320,712365080,68650
538,y1109,20110628,9710,9730,9730,9770,9712,9734,9738,4,8,3800,370089680,67334
539,y1109,20110629,9734,9738,9716,9796,9716,9754,9776,16,38,2778,271620160,66392
540,y1109,20110630,9754,9776,9774,9830,9768,9830,9784,54,8,10572,1034461280,56968
541,y1109,20110701,9830,9784,9780,9780,9682,9736,9726,-48,-58,2978,289686920,55792
542,y1109,20110704,9736,9726,9758,9856,9758,9850,9816,124,90,1900,186541960,54886
543,y1109,20110705,9850,9816,9850,9868,9798,9830,9830,14,14,2320,228095800,53322
544,y1109,20110706,9830,9830,9810,9854,9804,9852,9836,22,6,3864,380075920,51200
545,y1109,20110707,9852,9836,9838,9926,9838,9926,9878,90,42,2216,218898320,49836
546,y1109,20110708,9926,9878,9970,10030,9970,10030,10000,152,122,7376,737742160,48992
547,y1109,20110711,10030,10000,10018,10100,10018,10052,10048,52,48,5182,520777000,45886
548,y1109,20110712,10052,10048,10036,10062,9950,10004,9996,-44,-52,2364,236310320,45268
549,y1109,20110713,10004,9996,10022,10106,10022,10084,10072,88,76,3778,380586320,45472
550,y1109,20110714,10084,10072,10150,10150,10084,10086,10106,14,34,1928,194844320,45264
551,y1109,20110715,10086,10106,10074,10094,10044,10070,10068,-36,-38,880,88611760,44924
552,y1109,20110718,10070,10068,10050,10118,10032,10060,10078,-8,10,1598,161068760,44310
553,y1109,20110719,10060,10078,10054,10100,10048,10100,10080,22,2,872,87899680,44070
554,y1109,20110720,10100,10080,10092,10100,10046,10100,10080,20,0,2050,206665440,43072
555,y1109,20110721,10100,10080,10078,10124,10078,10124,10100,44,20,1862,188084680,42114
556,y1109,20110722,10124,10100,10112,10120,10088,10094,10102,-6,2,538,54356520,41844
557,y1109,20110725,10094,10102,10080,10080,9978,9984,10032,-118,-70,1522,152715560,41230
558,y1109,20110726,9984,10032,10004,10062,9986,10044,10028,12,-4,930,93265880,40668
559,y1109,20110727,10044,10028,10078,10110,10070,10086,10092,58,64,1034,104371080,40106
560,y1109,20110728,10086,10092,10060,10066,10032,10060,10054,-32,-38,954,95920360,39584
561,y1109,20110729,10060,10054,10012,10070,9986,10008,10028,-46,-26,3378,338787120,37332
562,y1109,20110801,10008,10028,10026,10098,10026,10098,10050,70,22,2376,238805680,35404
563,y1109,20110802,10098,10050,10078,10120,10070,10092,10084,42,34,2812,283591240,33156
564,y1109,20110803,10092,10084,10156,10156,10100,10116,10116,32,32,2214,223983320,32020
565,y1109,20110804,10116,10116,10072,10108,10044,10050,10092,-66,-24,838,84582440,31792
566,y1109,20110805,10050,10092,9980,9980,9808,9900,9900,-192,-192,2904,287535960,30112
567,y1109,20110808,9900,9900,9750,9906,9750,9906,9848,6,-52,1084,106758040,29260
568,y1109,20110809,9906,9848,9730,9766,9356,9766,9608,-82,-240,1656,159116720,28384
569,y1109,20110810,9766,9608,9802,9820,9770,9798,9742,190,134,3748,365160760,27120
570,y1109,20110811,9798,9742,9756,9832,9756,9830,9762,88,20,2914,284468640,25110
571,y1109,20110812,9830,9762,9878,9938,9812,9812,9860,50,98,660,65086560,24730
572,y1109,20110815,9812,9860,9948,9948,9864,9870,9882,10,22,1772,175116960,23048
573,y1109,20110816,9870,9882,9882,9882,9820,9820,9840,-62,-42,936,92105000,22316
574,y1109,20110817,9820,9840,9834,9868,9834,9846,9848,6,8,114,11228960,22212
575,y1109,20110818,9846,9848,9872,9880,9860,9870,9878,22,30,1406,138897440,20814
576,y1109,20110819,9870,9878,9870,9870,9770,9782,9790,-96,-88,1802,176447640,19064
577,y1109,20110822,9782,9790,9804,9820,9770,9796,9786,6,-4,2424,237218320,16730
578,y1109,20110823,9796,9786,9810,9850,9776,9846,9812,60,26,970,95176440,16068
579,y1109,20110824,9846,9812,9812,9830,9784,9800,9794,-12,-18,66,6465320,16024
580,y1109,20110825,9800,9794,9780,9810,9770,9802,9790,8,-4,396,38768800,15646
581,y1109,20110826,9802,9790,9802,9820,9790,9802,9802,12,12,288,28230520,15392
582,y1109,20110829,9802,9802,9878,9888,9850,9886,9878,84,76,390,38525200,15108
583,y1109,20110830,9886,9878,9902,9992,9846,9992,9914,114,36,1798,178289280,14604
584,y1109,20110831,9992,9914,9920,10246,9920,10120,10022,206,108,3386,339382360,11942
585,y1109,20110901,10120,10022,10058,10090,10000,10000,10068,-22,46,3602,362703000,3744
586,y1109,20110902,10000,10068,10100,10100,10090,10100,10096,32,28,220,22212000,3792
587,y1109,20110905,10100,10096,10100,10100,10100,10100,10100,4,4,2,202000,3792
588,y1109,20110906,10100,10100,0,0,0,10100,10100,0,0,0,0,3792
589,y1109,20110907,10100,10100,10200,10200,10200,10200,10200,100,100,58,5916000,3792
590,y1109,20110908,10200,10200,0,0,0,10200,10200,0,0,0,0,3158
591,y1109,20110909,10200,10200,0,0,0,10200,10200,0,0,0,0,2580
592,y1109,20110913,10200,10200,0,0,0,10200,10200,0,0,0,0,2580
593,y1109,20110914,10200,10200,0,0,0,10200,10200,0,0,0,0,2460
594,y1109,20110915,10200,10200,0,0,0,10200,10072,0,-128,0,0,0
595,y1111,20110104,10496,10618,10232,11236,10232,10730,10742,112,124,38,4082600,172
596,y1111,20110105,10730,10742,10620,10620,10530,10540,10566,-202,-176,26,2747440,166
597,y1111,20110106,10540,10566,10760,10880,10688,10852,10776,286,210,168,18104440,196
598,y1111,20110107,10852,10776,10706,10820,10572,10602,10674,-174,-102,54,5764360,184
599,y1111,20110110,10602,10674,10600,10690,10576,10576,10622,-98,-52,22,2337200,186
600,y1111,20110111,10576,10622,10588,10668,10588,10668,10636,46,14,18,1914560,184
601,y1111,20110112,10668,10636,10668,10760,10456,10502,10514,-134,-122,114,11988120,226
602,y1111,20110113,10502,10514,10502,10806,10212,10670,10646,156,132,92,9795800,232
603,y1111,20110114,10670,10646,10484,10622,10484,10622,10594,-24,-52,22,2331040,226
604,y1111,20110117,10622,10594,10578,10612,10572,10574,10584,-20,-10,42,4446080,230
605,y1111,20110118,10574,10584,10494,10572,10440,10450,10486,-134,-98,118,12375080,276
606,y1111,20110119,10450,10486,10460,10576,10460,10576,10498,90,12,6,629920,270
607,y1111,20110120,10576,10498,10560,10672,10540,10626,10606,128,108,76,8060920,292
608,y1111,20110121,10626,10606,10560,10594,10490,10588,10562,-18,-44,54,5703640,280
609,y1111,20110124,10588,10562,10724,10800,10724,10800,10774,238,212,6,646480,282
610,y1111,20110125,10800,10774,10776,10776,10602,10602,10638,-172,-136,30,3191800,262
611,y1111,20110126,10602,10638,10272,10272,10272,10272,10272,-366,-366,2,205440,262
612,y1111,20110127,10272,10272,0,0,0,10272,10272,0,0,0,0,262
613,y1111,20110128,10272,10272,0,0,0,10272,10272,0,0,0,0,262
614,y1111,20110131,10272,10272,10668,10668,10518,10600,10596,328,324,26,2755200,258
615,y1111,20110201,10600,10596,10566,10650,10566,10650,10608,54,12,4,424320,258
616,y1111,20110209,10650,10608,10762,10762,10762,10762,10762,154,154,2,215240,256
617,y1111,20110210,10762,10762,10958,10958,10920,10920,10944,158,182,6,656720,256
618,y1111,20110211,10920,10944,10924,10924,10860,10860,10902,-84,-42,6,654120,254
619,y1111,20110214,10860,10902,10760,10760,10760,10760,10760,-142,-142,2,215200,256
620,y1111,20110215,10760,10760,10852,10852,10852,10852,10852,92,92,2,217040,254
621,y1111,20110216,10852,10852,10542,10542,10500,10502,10508,-350,-344,12,1261000,258
622,y1111,20110217,10502,10508,10506,10630,10440,10542,10538,34,30,24,2529480,256
623,y1111,20110218,10542,10538,10480,10480,10480,10480,10480,-58,-58,8,838400,256
624,y1111,20110221,10480,10480,10344,10344,10344,10344,10344,-136,-136,4,413760,260
625,y1111,20110222,10344,10344,10444,10444,10444,10444,10444,100,100,4,417760,256
626,y1111,20110223,10444,10444,10156,10156,10156,10156,10156,-288,-288,2,203120,256
627,y1111,20110224,10156,10156,10090,10170,9882,9914,9952,-242,-204,222,22096200,244
628,y1111,20110225,9914,9952,10028,10070,10028,10070,10054,118,102,16,1608720,234
629,y1111,20110228,10070,10054,10252,10252,10252,10252,10252,198,198,4,410080,234
630,y1111,20110301,10252,10252,0,0,0,10252,10252,0,0,0,0,234
631,y1111,20110302,10252,10252,0,0,0,10252,10252,0,0,0,0,234
632,y1111,20110303,10252,10252,10404,10450,10400,10400,10430,148,178,24,2503440,228
633,y1111,20110304,10400,10430,0,0,0,10430,10430,0,0,0,0,228
634,y1111,20110307,10430,10430,10500,10512,10480,10480,10496,50,66,8,839800,226
635,y1111,20110308,10480,10496,10362,10362,10200,10340,10300,-156,-196,10,1030040,230
636,y1111,20110309,10340,10300,10200,10298,10200,10298,10248,-2,-52,4,409960,230
637,y1111,20110310,10298,10248,10108,10108,10108,10108,10108,-140,-140,10,1010800,240
638,y1111,20110311,10108,10108,9910,10120,9910,10056,9970,-52,-138,16,1595400,230
639,y1111,20110314,10056,9970,10038,10090,10038,10090,10064,120,94,4,402560,230
640,y1111,20110315,10090,10064,10010,10010,10010,10010,10010,-54,-54,2,200200,230
641,y1111,20110316,10010,10010,0,0,0,10010,10010,0,0,0,0,230
642,y1111,20110317,10010,10010,9862,9862,9860,9860,9860,-150,-150,6,591680,230
643,y1111,20110318,9860,9860,10050,10050,10050,10050,10050,190,190,2,201000,228
644,y1111,20110321,10050,10050,10118,10232,10118,10144,10168,94,118,8,813560,228
645,y1111,20110322,10144,10168,10144,10144,10144,10144,10144,-24,-24,2,202880,228
646,y1111,20110323,10144,10144,10242,10242,10118,10118,10180,-26,36,4,407200,228
647,y1111,20110324,10118,10180,10226,10226,10158,10158,10180,-22,0,6,610880,228
648,y1111,20110325,10158,10180,0,0,0,10180,10180,0,0,0,0,228
649,y1111,20110328,10180,10180,10220,10220,10160,10160,10182,-20,2,8,814680,228
650,y1111,20110329,10160,10182,0,0,0,10182,10182,0,0,0,0,228
651,y1111,20110330,10182,10182,0,0,0,10182,10182,0,0,0,0,228
652,y1111,20110331,10182,10182,0,0,0,10182,10182,0,0,0,0,228
653,y1111,20110401,10182,10182,0,0,0,10182,10182,0,0,0,0,228
654,y1111,20110406,10182,10182,10326,10326,10326,10326,10326,144,144,2,206520,228
655,y1111,20110407,10326,10326,10380,10380,10380,10380,10380,54,54,2,207600,228
656,y1111,20110408,10380,10380,10350,10350,10350,10350,10350,-30,-30,2,207000,226
657,y1111,20110411,10350,10350,0,0,0,10350,10350,0,0,0,0,226
658,y1111,20110412,10350,10350,10388,10388,10266,10266,10266,-84,-84,202,20740720,424
659,y1111,20110413,10266,10266,10200,10242,10192,10192,10208,-74,-58,24,2450200,420
660,y1111,20110414,10192,10208,10140,10140,10140,10140,10140,-68,-68,2,202800,420
661,y1111,20110415,10140,10140,0,0,0,10140,10140,0,0,0,0,420
662,y1111,20110418,10140,10140,0,0,0,10140,10140,0,0,0,0,420
663,y1111,20110419,10140,10140,0,0,0,10140,10140,0,0,0,0,420
664,y1111,20110420,10140,10140,0,0,0,10140,10140,0,0,0,0,420
665,y1111,20110421,10140,10140,0,0,0,10140,10140,0,0,0,0,420
666,y1111,20110422,10140,10140,10224,10224,10224,10224,10224,84,84,2,204480,420
667,y1111,20110425,10224,10224,0,0,0,10224,10224,0,0,0,0,420
668,y1111,20110426,10224,10224,10224,10224,10108,10108,10124,-116,-100,138,13972800,420
669,y1111,20110427,10108,10124,10082,10082,10082,10082,10082,-42,-42,2,201640,420
670,y1111,20110428,10082,10082,10202,10202,10150,10150,10176,68,94,4,407040,418
671,y1111,20110429,10150,10176,0,0,0,10176,10176,0,0,0,0,418
672,y1111,20110503,10176,10176,10176,10216,10122,10130,10148,-46,-28,76,7713680,418
673,y1111,20110504,10130,10148,10130,10130,10046,10048,10064,-100,-84,66,6643480,404
674,y1111,20110505,10048,10064,9992,10042,9960,10024,10000,-40,-64,36,3600440,404
675,y1111,20110506,10024,10000,9906,9934,9818,9834,9902,-166,-98,80,7922800,408
676,y1111,20110509,9834,9902,9834,9896,9834,9896,9858,-6,-44,10,985960,406
677,y1111,20110510,9896,9858,9880,9916,9880,9916,9898,58,40,4,395920,406
678,y1111,20110511,9916,9898,9950,9950,9940,9940,9940,42,42,66,6560680,404
679,y1111,20110512,9940,9940,9928,9928,9720,9720,9806,-220,-134,28,2746120,422
680,y1111,20110513,9720,9806,9968,9990,9968,9990,9972,184,166,16,1595760,418
681,y1111,20110516,9990,9972,9910,9930,9910,9930,9916,-42,-56,6,595000,418
682,y1111,20110517,9930,9916,9860,9860,9860,9860,9860,-56,-56,2,197200,418
683,y1111,20110518,9860,9860,0,0,0,9860,9860,0,0,0,0,418
684,y1111,20110519,9860,9860,0,0,0,9860,9860,0,0,0,0,418
685,y1111,20110520,9860,9860,9998,10090,9998,10062,10074,202,214,16,1612000,408
686,y1111,20110523,10062,10074,0,0,0,10074,10074,0,0,0,0,408
687,y1111,20110524,10074,10074,10182,10182,10116,10126,10140,52,66,10,1014080,408
688,y1111,20110525,10126,10140,10166,10166,10112,10138,10146,-2,6,14,1420680,398
689,y1111,20110526,10138,10146,10248,10248,10190,10190,10200,44,54,10,1020160,404
690,y1111,20110527,10190,10200,10270,10270,10246,10246,10258,46,58,4,410320,400
691,y1111,20110530,10246,10258,10126,10280,10126,10278,10234,20,-24,16,1637440,408
692,y1111,20110531,10278,10234,10252,10256,10236,10236,10250,2,16,10,1025040,406
693,y1111,20110601,10236,10250,0,0,0,10250,10250,0,0,0,0,406
694,y1111,20110602,10250,10250,0,0,0,10250,10250,0,0,0,0,406
695,y1111,20110603,10250,10250,10410,10410,10342,10342,10376,92,126,4,415040,406
696,y1111,20110607,10342,10376,10276,10276,10276,10276,10276,-100,-100,2,205520,406
697,y1111,20110608,10276,10276,10302,10302,10302,10302,10302,26,26,4,412080,406
698,y1111,20110609,10302,10302,10396,10396,10284,10284,10340,-18,38,4,413600,408
699,y1111,20110610,10284,10340,10284,10296,10224,10224,10252,-116,-88,22,2255480,404
700,y1111,20110613,10224,10252,10210,10236,10210,10236,10222,-16,-30,4,408920,402
701,y1111,20110614,10236,10222,10220,10234,10220,10234,10230,12,8,8,818440,396
702,y1111,20110615,10234,10230,0,0,0,10230,10230,0,0,0,0,396
703,y1111,20110616,10230,10230,10190,10190,10122,10122,10156,-108,-74,4,406240,394
704,y1111,20110617,10122,10156,10090,10090,10090,10090,10090,-66,-66,2,201800,394
705,y1111,20110620,10090,10090,10072,10080,10072,10080,10076,-10,-14,4,403040,392
706,y1111,20110621,10080,10076,10168,10170,10168,10170,10168,94,92,8,813480,386
707,y1111,20110622,10170,10168,10180,10180,10124,10150,10150,-18,-18,6,609080,388
708,y1111,20110623,10150,10150,10020,10184,10020,10052,10068,-98,-82,22,2214960,392
709,y1111,20110624,10052,10068,10046,10066,10046,10066,10056,-2,-12,4,402240,388
710,y1111,20110627,10066,10056,9978,9978,9852,9862,9922,-194,-134,22,2183040,386
711,y1111,20110628,9862,9922,9910,9910,9870,9870,9876,-52,-46,12,1185320,390
712,y1111,20110629,9870,9876,9930,9930,9920,9920,9922,44,46,8,793800,382
713,y1111,20110630,9920,9922,9960,9960,9960,9960,9960,38,38,2,199200,380
714,y1111,20110701,9960,9960,0,0,0,9960,9960,0,0,0,0,380
715,y1111,20110704,9960,9960,9958,9958,9958,9958,9958,-2,-2,4,398320,380
716,y1111,20110705,9958,9958,9980,9980,9980,9980,9980,22,22,6,598800,376
717,y1111,20110706,9980,9980,9980,9998,9978,9998,9980,18,0,18,1796640,368
718,y1111,20110707,9998,9980,10002,10002,10002,10002,10002,22,22,2,200040,366
719,y1111,20110708,10002,10002,10142,10174,10142,10174,10162,172,160,6,609800,368
720,y1111,20110711,10174,10162,10184,10184,10154,10154,10172,-8,10,10,1017240,364
721,y1111,20110712,10154,10172,10086,10086,10060,10060,10072,-112,-100,4,402920,362
722,y1111,20110713,10060,10072,10286,10286,10176,10202,10206,130,134,18,1837240,348
723,y1111,20110714,10202,10206,10222,10222,10222,10222,10222,16,16,2,204440,350
724,y1111,20110715,10222,10222,10210,10228,10186,10228,10208,6,-14,52,5309080,358
725,y1111,20110718,10228,10208,10210,10210,10210,10210,10210,2,2,2,204200,358
726,y1111,20110719,10210,10210,10166,10190,10166,10190,10178,-20,-32,4,407120,356
727,y1111,20110720,10190,10178,10240,10240,10240,10240,10240,62,62,4,409600,356
728,y1111,20110721,10240,10240,10212,10244,10212,10244,10222,4,-18,6,613360,354
729,y1111,20110722,10244,10222,0,0,0,10222,10222,0,0,0,0,354
730,y1111,20110725,10222,10222,10330,10330,10132,10132,10162,-90,-60,18,1829480,354
731,y1111,20110726,10132,10162,10120,10120,10120,10120,10120,-42,-42,2,202400,354
732,y1111,20110727,10120,10120,0,0,0,10120,10120,0,0,0,0,354
733,y1111,20110728,10120,10120,0,0,0,10120,10120,0,0,0,0,354
734,y1111,20110729,10120,10120,10122,10122,10116,10122,10120,2,0,12,1214400,346
735,y1111,20110801,10122,10120,0,0,0,10120,10120,0,0,0,0,346
736,y1111,20110802,10120,10120,0,0,0,10120,10120,0,0,0,0,346
737,y1111,20110803,10120,10120,0,0,0,10120,10120,0,0,0,0,346
738,y1111,20110804,10120,10120,10150,10150,10150,10150,10150,30,30,2,203000,344
739,y1111,20110805,10150,10150,9928,9968,9712,9968,9886,-182,-264,12,1186520,342
740,y1111,20110808,9968,9886,9950,9978,9930,9930,9950,44,64,14,1393200,336
741,y1111,20110809,9930,9950,9688,9700,9662,9700,9678,-250,-272,44,4258840,318
742,y1111,20110810,9700,9678,0,0,0,9678,9678,0,0,0,0,318
743,y1111,20110811,9678,9678,9738,9894,9738,9790,9786,112,108,10,978600,318
744,y1111,20110812,9790,9786,9914,9914,9860,9860,9876,74,90,14,1382680,306
745,y1111,20110815,9860,9876,0,0,0,9876,9876,0,0,0,0,306
746,y1111,20110816,9876,9876,9880,9930,9862,9862,9902,-14,26,30,2970600,306
747,y1111,20110817,9862,9902,9948,9948,9946,9946,9946,44,44,12,1193560,304
748,y1111,20110818,9946,9946,9912,9958,9912,9952,9946,6,0,10,994760,304
749,y1111,20110819,9952,9946,9862,9878,9672,9872,9794,-74,-152,70,6856120,276
750,y1111,20110822,9872,9794,0,0,0,9794,9794,0,0,0,0,276
751,y1111,20110823,9794,9794,9902,9928,9902,9928,9914,134,120,4,396600,276
752,y1111,20110824,9928,9914,9952,9970,9952,9960,9958,46,44,8,796680,276
753,y1111,20110825,9960,9958,0,0,0,9958,9958,0,0,0,0,276
754,y1111,20110826,9958,9958,0,0,0,9958,9958,0,0,0,0,276
755,y1111,20110829,9958,9958,10080,10080,10080,10080,10080,122,122,6,604800,270
756,y1111,20110830,10080,10080,10170,10170,10102,10148,10142,68,62,20,2028560,268
757,y1111,20110831,10148,10142,0,0,0,10142,10142,0,0,0,0,268
758,y1111,20110901,10142,10142,0,0,0,10142,10142,0,0,0,0,268
759,y1111,20110902,10142,10142,0,0,0,10142,10142,0,0,0,0,268
760,y1111,20110905,10142,10142,10268,10268,10150,10150,10178,8,36,28,2850120,270
761,y1111,20110906,10150,10178,0,0,0,10178,10178,0,0,0,0,270
762,y1111,20110907,10178,10178,0,0,0,10178,10178,0,0,0,0,270
763,y1111,20110908,10178,10178,10230,10230,10230,10230,10230,52,52,2,204600,272
764,y1111,20110909,10230,10230,10130,10130,10116,10116,10124,-114,-106,14,1417440,258
765,y1111,20110913,10116,10124,0,0,0,10124,10124,0,0,0,0,258
766,y1111,20110914,10124,10124,10052,10052,9900,9930,9936,-194,-188,24,2385040,264
767,y1111,20110915,9930,9936,9960,9960,9900,9900,9930,-36,-6,4,397200,264
768,y1111,20110916,9900,9930,0,0,0,9930,9930,0,0,0,0,264
769,y1111,20110919,9930,9930,9930,9930,9732,9764,9784,-166,-146,32,3131360,268
770,y1111,20110920,9764,9784,9758,9760,9758,9760,9758,-24,-26,4,390360,264
771,y1111,20110921,9760,9758,9704,9704,9702,9702,9702,-56,-56,28,2716600,236
772,y1111,20110922,9702,9702,0,0,0,9702,9702,0,0,0,0,236
773,y1111,20110923,9702,9702,9218,9498,9218,9498,9242,-204,-460,22,2033560,238
774,y1111,20110926,9498,9242,9270,9270,8940,8940,9014,-302,-228,16,1442240,236
775,y1111,20110927,8940,9014,9180,9180,9180,9180,9180,166,166,4,367200,232
776,y1111,20110928,9180,9180,9030,9030,9004,9030,9020,-150,-160,6,541280,226
777,y1111,20110929,9030,9020,8820,8994,8820,8934,8910,-86,-110,24,2138400,228
778,y1111,20110930,8934,8910,8930,9000,8930,9000,8960,90,50,20,1792360,220
779,y1111,20111010,9000,8960,8898,8898,8898,8898,8898,-62,-62,6,533880,220
780,y1111,20111011,8898,8898,9060,9060,8890,8890,8974,-8,76,8,718000,218
781,y1111,20111012,8890,8974,0,0,0,8974,8974,0,0,0,0,218
782,y1111,20111013,8974,8974,8980,8980,8980,8980,8980,6,6,2,179600,216
783,y1111,20111014,8980,8980,9012,9032,9012,9032,9024,52,44,6,541520,216
784,y1111,20111017,9032,9024,9044,9044,9044,9044,9044,20,20,2,180880,214
785,y1111,20111018,9044,9044,8820,8840,8782,8794,8802,-250,-242,24,2112520,210
786,y1111,20111019,8794,8802,8800,8900,8800,8810,8818,8,16,16,1411040,206
787,y1111,20111020,8810,8818,8700,8700,8700,8700,8700,-118,-118,70,6090000,136
788,y1111,20111021,8700,8700,8850,8850,8850,8850,8850,150,150,72,6372000,64
789,y1111,20111024,8850,8850,8700,9290,8700,9002,8996,152,146,10,899640,66
790,y1111,20111025,9002,8996,8808,8898,8808,8898,8830,-98,-166,8,706440,60
791,y1111,20111026,8898,8830,9050,9050,8550,9000,8946,170,116,72,6442160,0
792,y1111,20111027,9000,8946,0,0,0,8946,8946,0,0,0,0,0
793,y1111,20111028,8946,8946,0,0,0,8946,8946,0,0,0,0,0
794,y1111,20111031,8946,8946,0,0,0,8946,8946,0,0,0,0,0
795,y1111,20111101,8946,8946,0,0,0,8946,8946,0,0,0,0,0
796,y1111,20111102,8946,8946,0,0,0,8946,8946,0,0,0,0,0
797,y1111,20111103,8946,8946,0,0,0,8946,8946,0,0,0,0,0
798,y1111,20111104,8946,8946,0,0,0,8946,8946,0,0,0,0,0
799,y1111,20111107,8946,8946,0,0,0,8946,8946,0,0,0,0,0
800,y1111,20111108,8946,8946,0,0,0,8946,8946,0,0,0,0,0
801,y1111,20111109,8946,8946,0,0,0,8946,8946,0,0,0,0,0
802,y1111,20111110,8946,8946,0,0,0,8946,8946,0,0,0,0,0
803,y1111,20111111,8946,8946,0,0,0,8946,8946,0,0,0,0,0
804,y1111,20111114,8946,8946,0,0,0,8946,8946,0,0,0,0,0
805,y1112,20110104,10582,10502,0,0,0,10502,10502,0,0,0,0,2
806,y1112,20110105,10502,10502,10500,10838,10500,10838,10646,336,144,6,638760,6
807,y1112,20110106,10838,10646,10650,10832,10504,10750,10722,104,76,24,2573480,6
808,y1112,20110107,10750,10722,10526,10690,10526,10648,10632,-74,-90,10,1063200,4
809,y1112,20110110,10648,10632,0,0,0,10632,10632,0,0,0,0,4
810,y1112,20110111,10632,10632,10530,10682,10530,10682,10606,50,-26,4,424240,4
811,y1112,20110112,10682,10606,10602,10602,10232,10232,10444,-374,-162,612,63918920,500
812,y1112,20110113,10232,10444,10406,10478,10322,10400,10394,-44,-50,52,5405880,500
813,y1112,20110114,10400,10394,10400,10440,10372,10438,10400,44,6,252,26211760,342
814,y1112,20110117,10438,10400,10458,10458,10340,10410,10408,10,8,206,21443400,206
815,y1112,20110118,10410,10408,10400,10400,10300,10388,10378,-20,-30,182,18889560,86
816,y1112,20110119,10388,10378,10450,10554,10450,10528,10498,150,120,32,3359880,84
817,y1112,20110120,10528,10498,10430,10552,10430,10552,10490,54,-8,6,629400,82
818,y1112,20110121,10552,10490,10454,10480,10408,10480,10458,-10,-32,14,1464320,78
819,y1112,20110124,10480,10458,10758,10850,10728,10728,10754,270,296,18,1935760,76
820,y1112,20110125,10728,10754,10606,10606,10606,10606,10606,-148,-148,2,212120,76
821,y1112,20110126,10606,10606,10216,10282,10200,10280,10226,-326,-380,32,3272720,74
822,y1112,20110127,10280,10226,10430,10430,10270,10306,10364,80,138,72,7463080,90
823,y1112,20110128,10306,10364,10324,10324,10324,10324,10324,-40,-40,2,206480,90
824,y1112,20110131,10324,10324,10408,10506,10408,10506,10450,182,126,14,1463120,92
825,y1112,20110201,10506,10450,10550,10560,10492,10492,10546,42,96,12,1265640,90
826,y1112,20110209,10492,10546,10598,10700,10598,10700,10634,154,88,8,850800,92
827,y1112,20110210,10700,10634,10814,10838,10750,10780,10782,146,148,18,1940840,90
828,y1112,20110211,10780,10782,10800,10800,10744,10778,10766,-4,-16,8,861320,88
829,y1112,20110214,10778,10766,10864,10932,10722,10744,10824,-22,58,90,9742680,128
830,y1112,20110215,10744,10824,10782,10790,10700,10700,10760,-124,-64,22,2367400,124
831,y1112,20110216,10700,10760,10456,10550,10422,10460,10502,-300,-258,14,1470400,130
832,y1112,20110217,10460,10502,10558,10558,10384,10384,10472,-118,-30,8,837760,126
833,y1112,20110218,10384,10472,0,0,0,10472,10472,0,0,0,0,126
834,y1112,20110221,10472,10472,0,0,0,10472,10472,0,0,0,0,126
835,y1112,20110222,10472,10472,10434,10434,10418,10420,10424,-52,-48,6,625440,128
836,y1112,20110223,10420,10424,10420,10420,9800,9990,10036,-434,-388,20,2007200,126
837,y1112,20110224,9990,10036,10036,10040,9762,9870,9962,-166,-74,54,5379680,144
838,y1112,20110225,9870,9962,9840,10192,9840,9980,9950,18,-12,22,2189320,144
839,y1112,20110228,9980,9950,10080,10080,10080,10080,10080,130,130,2,201600,144
840,y1112,20110301,10080,10080,10120,10190,10100,10190,10120,110,40,14,1417000,144
841,y1112,20110302,10190,10120,0,0,0,10120,10120,0,0,0,0,144
842,y1112,20110303,10120,10120,10418,10452,10226,10226,10350,106,230,22,2277240,142
843,y1112,20110304,10226,10350,10350,10350,10350,10350,10350,0,0,4,414000,142
844,y1112,20110307,10350,10350,0,0,0,10350,10350,0,0,0,0,142
845,y1112,20110308,10350,10350,10262,10272,10216,10216,10244,-134,-106,10,1024560,142
846,y1112,20110309,10216,10244,10106,10130,10106,10130,10118,-114,-126,4,404720,142
847,y1112,20110310,10130,10118,10094,10094,9990,9990,10042,-128,-76,8,803440,144
848,y1112,20110311,9990,10042,9990,9990,9960,9960,9974,-82,-68,4,399000,144
849,y1112,20110314,9960,9974,9900,9900,9782,9782,9850,-192,-124,64,6304320,164
850,y1112,20110315,9782,9850,9886,9926,9886,9926,9916,76,66,8,793280,164
851,y1112,20110316,9926,9916,9654,9780,9648,9780,9716,-136,-200,30,2915000,162
852,y1112,20110317,9780,9716,9826,9826,9762,9818,9816,102,100,48,4711680,188
853,y1112,20110318,9818,9816,9900,9946,9890,9910,9910,94,94,44,4361240,184
854,y1112,20110321,9910,9910,10000,10064,10000,10062,10044,152,134,28,2812840,184
855,y1112,20110322,10062,10044,9980,9990,9980,9990,9984,-54,-60,4,399400,182
856,y1112,20110323,9990,9984,10052,10120,10052,10056,10082,72,98,8,806560,184
857,y1112,20110324,10056,10082,10028,10028,9888,9946,9982,-136,-100,10,998360,180
858,y1112,20110325,9946,9982,0,0,0,9982,9982,0,0,0,0,180
859,y1112,20110328,9982,9982,10080,10088,9914,10006,10020,24,38,16,1603480,184
860,y1112,20110329,10006,10020,9998,9998,9940,9940,9978,-80,-42,12,1197440,186
861,y1112,20110330,9940,9978,10104,10116,10056,10056,10092,78,114,6,605520,188
862,y1112,20110331,10056,10092,10094,10094,10042,10042,10058,-50,-34,22,2212760,186
863,y1112,20110401,10042,10058,10156,10190,10156,10158,10160,100,102,28,2845160,184
864,y1112,20110406,10158,10160,10230,10304,10220,10244,10254,84,94,22,2256240,182
865,y1112,20110407,10244,10254,10318,10318,10250,10254,10264,0,10,50,5132200,180
866,y1112,20110408,10254,10264,10300,10348,10300,10348,10316,84,52,6,619000,182
867,y1112,20110411,10348,10316,10392,10440,10372,10400,10410,84,94,24,2498640,182
868,y1112,20110412,10400,10410,10358,10358,10088,10250,10238,-160,-172,98,10033320,176
869,y1112,20110413,10250,10238,10110,10188,10060,10128,10118,-110,-120,102,10321720,172
870,y1112,20110414,10128,10118,10112,10112,10050,10050,10090,-68,-28,12,1210920,172
871,y1112,20110415,10050,10090,10110,10122,10034,10034,10078,-56,-12,10,1007960,174
872,y1112,20110418,10034,10078,10018,10034,9986,9986,10004,-92,-74,24,2401280,168
873,y1112,20110419,9986,10004,0,0,0,10004,10004,0,0,0,0,168
874,y1112,20110420,10004,10004,10076,10160,10076,10104,10124,100,120,14,1417360,166
875,y1112,20110421,10104,10124,0,0,0,10124,10124,0,0,0,0,166
876,y1112,20110422,10124,10124,10134,10178,10108,10160,10148,36,24,118,11976240,198
877,y1112,20110425,10160,10148,0,0,0,10148,10148,0,0,0,0,198
878,y1112,20110426,10148,10148,0,0,0,10148,10148,0,0,0,0,198
879,y1112,20110427,10148,10148,10028,10080,9990,9990,10034,-158,-114,24,2408280,198
880,y1112,20110428,9990,10034,10072,10110,9986,10084,10068,50,34,50,5034560,212
881,y1112,20110429,10084,10068,9982,9982,9900,9900,9928,-168,-140,28,2779880,206
882,y1112,20110503,9900,9928,9990,10212,9990,10212,10168,284,240,94,9558360,282
883,y1112,20110504,10212,10168,10140,10140,9922,9964,9960,-204,-208,48,4781680,278
884,y1112,20110505,9964,9960,9820,9960,9812,9950,9902,-10,-58,198,19608400,260
885,y1112,20110506,9950,9902,9812,9816,9710,9710,9800,-192,-102,76,7448680,288
886,y1112,20110509,9710,9800,9780,9780,9734,9734,9772,-66,-28,14,1368280,280
887,y1112,20110510,9734,9772,9780,9810,9766,9802,9776,30,4,162,15839320,250
888,y1112,20110511,9802,9776,9840,9840,9790,9820,9812,44,36,50,4906400,248
889,y1112,20110512,9820,9812,9838,9838,9750,9750,9778,-62,-34,106,10365760,230
890,y1112,20110513,9750,9778,9800,9848,9800,9848,9818,70,40,12,1178360,226
891,y1112,20110516,9848,9818,0,0,0,9818,9818,0,0,0,0,226
892,y1112,20110517,9818,9818,9700,9750,9680,9718,9718,-100,-100,36,3498480,228
893,y1112,20110518,9718,9718,9780,9868,9780,9868,9820,150,102,16,1571360,228
894,y1112,20110519,9868,9820,9958,9958,9914,9920,9930,100,110,14,1390240,226
895,y1112,20110520,9920,9930,9934,10070,9934,10008,10002,78,72,88,8802120,228
896,y1112,20110523,10008,10002,10072,10072,9998,10026,10024,24,22,14,1403600,228
897,y1112,20110524,10026,10024,9970,10044,9970,10044,10006,20,-18,10,1000680,230
898,y1112,20110525,10044,10006,10010,10016,10010,10012,10012,6,6,8,801000,226
899,y1112,20110526,10012,10012,10058,10096,10058,10092,10084,80,72,24,2420400,214
900,y1112,20110527,10092,10084,10084,10112,10082,10112,10098,28,14,10,1009920,210
901,y1112,20110530,10112,10098,10084,10198,10084,10150,10154,52,56,36,3656000,204
902,y1112,20110531,10150,10154,10220,10220,10122,10144,10160,-10,6,20,2032120,200
903,y1112,20110601,10144,10160,10286,10286,10104,10128,10164,-32,4,28,2846320,200
904,y1112,20110602,10128,10164,10092,10120,10092,10118,10108,-46,-56,16,1617400,202
905,y1112,20110603,10118,10108,10198,10300,10198,10280,10248,172,140,40,4099800,200
906,y1112,20110607,10280,10248,10232,10232,10150,10212,10186,-36,-62,20,2037480,198
907,y1112,20110608,10212,10186,10228,10228,10228,10228,10228,42,42,6,613680,192
908,y1112,20110609,10228,10228,10240,10240,10200,10200,10212,-28,-16,6,612800,190
909,y1112,20110610,10200,10212,10150,10190,10082,10128,10132,-84,-80,28,2837360,182
910,y1112,20110613,10128,10132,0,0,0,10132,10132,0,0,0,0,182
911,y1112,20110614,10132,10132,10160,10160,10118,10118,10138,-14,6,4,405560,184
912,y1112,20110615,10118,10138,10144,10170,10122,10170,10156,32,18,16,1625120,180
913,y1112,20110616,10170,10156,10090,10090,10030,10030,10048,-126,-108,10,1004800,178
914,y1112,20110617,10030,10048,10048,10048,9962,9984,9994,-64,-54,12,1199480,174
915,y1112,20110620,9984,9994,10050,10050,9950,9970,9986,-24,-8,14,1398040,174
916,y1112,20110621,9970,9986,10044,10048,10010,10048,10026,62,40,22,2206120,162
917,y1112,20110622,10048,10026,10046,10046,10018,10018,10036,-8,10,8,802960,158
918,y1112,20110623,10018,10036,9980,9980,9980,9980,9980,-56,-56,2,199600,158
919,y1112,20110624,9980,9980,9954,9954,9954,9954,9954,-26,-26,8,796320,152
920,y1112,20110627,9954,9954,9828,9830,9828,9830,9828,-124,-126,4,393160,152
921,y1112,20110628,9830,9828,9770,9798,9770,9780,9782,-48,-46,6,586960,154
922,y1112,20110629,9780,9782,9784,9826,9784,9820,9794,38,12,60,5877280,154
923,y1112,20110630,9820,9794,9836,9850,9814,9850,9836,56,42,20,1967200,154
924,y1112,20110701,9850,9836,9850,9850,9740,9760,9764,-76,-72,20,1953160,150
925,y1112,20110704,9760,9764,9826,9894,9678,9678,9856,-86,92,26,2562680,152
926,y1112,20110705,9678,9856,9886,9886,9846,9846,9856,-10,0,8,788480,144
927,y1112,20110706,9846,9856,9896,9896,9842,9878,9866,22,10,30,2960360,148
928,y1112,20110707,9878,9866,9918,9920,9862,9920,9888,54,22,20,1977960,142
929,y1112,20110708,9920,9888,10036,10050,10016,10046,10038,158,150,22,2208560,136
930,y1112,20110711,10046,10038,10114,10114,10070,10070,10084,32,46,76,7663880,154
931,y1112,20110712,10070,10084,9986,10000,9978,10000,9986,-84,-98,12,1198520,156
932,y1112,20110713,10000,9986,10110,10118,10106,10118,10112,132,126,10,1011240,156
933,y1112,20110714,10118,10112,10340,10340,10150,10160,10222,48,110,32,3271640,160
934,y1112,20110715,10160,10222,10100,10128,10100,10110,10110,-112,-112,22,2224440,158
935,y1112,20110718,10110,10110,10114,10138,10072,10072,10110,-38,0,14,1415440,152
936,y1112,20110719,10072,10110,10070,10100,10070,10100,10094,-10,-16,16,1615200,150
937,y1112,20110720,10100,10094,10152,10152,10114,10114,10132,20,38,12,1215960,146
938,y1112,20110721,10114,10132,10140,10140,10140,10140,10140,8,8,2,202800,146
939,y1112,20110722,10140,10140,0,0,0,10140,10140,0,0,0,0,146
940,y1112,20110725,10140,10140,10044,10044,10028,10028,10040,-112,-100,10,1004080,148
941,y1112,20110726,10028,10040,0,0,0,10040,10040,0,0,0,0,148
942,y1112,20110727,10040,10040,10094,10110,10094,10110,10102,70,62,4,404080,148
943,y1112,20110728,10110,10102,10032,10060,10032,10050,10046,-52,-56,6,602840,146
944,y1112,20110729,10050,10046,0,0,0,10046,10046,0,0,0,0,146
945,y1112,20110801,10046,10046,0,0,0,10046,10046,0,0,0,0,146
946,y1112,20110802,10046,10046,10128,10128,10128,10128,10128,82,82,2,202560,146
947,y1112,20110803,10128,10128,0,0,0,10128,10128,0,0,0,0,146
948,y1112,20110804,10128,10128,0,0,0,10128,10128,0,0,0,0,146
949,y1112,20110805,10128,10128,9990,9990,9838,9906,9914,-222,-214,16,1586320,148
950,y1112,20110808,9906,9914,9754,9910,9754,9910,9844,-4,-70,6,590720,146
951,y1112,20110809,9910,9844,9650,9688,9642,9688,9662,-156,-182,14,1352920,144
952,y1112,20110810,9688,9662,9780,9780,9780,9780,9780,118,118,6,586800,144
953,y1112,20110811,9780,9780,0,0,0,9780,9780,0,0,0,0,144
954,y1112,20110812,9780,9780,9870,9870,9782,9812,9802,32,22,12,1176360,144
955,y1112,20110815,9812,9802,9824,9824,9824,9824,9824,22,22,2,196480,144
956,y1112,20110816,9824,9824,9866,9868,9866,9868,9866,44,42,16,1578760,138
957,y1112,20110817,9868,9866,9858,9858,9856,9856,9856,-10,-10,12,1182760,136
958,y1112,20110818,9856,9856,9864,9864,9864,9864,9864,8,8,4,394560,134
959,y1112,20110819,9864,9864,9798,9806,9792,9792,9798,-72,-66,6,587920,132
960,y1112,20110822,9792,9798,9870,9870,9834,9834,9860,36,62,8,788880,124
961,y1112,20110823,9834,9860,9922,9922,9920,9920,9920,60,60,4,396840,124
962,y1112,20110824,9920,9920,9902,9902,9896,9896,9900,-24,-20,8,792040,124
963,y1112,20110825,9896,9900,0,0,0,9900,9900,0,0,0,0,124
964,y1112,20110826,9900,9900,9920,9920,9920,9920,9920,20,20,2,198400,124
965,y1112,20110829,9920,9920,9920,10060,9920,10060,10008,140,88,12,1201080,122
966,y1112,20110830,10060,10008,10102,10102,10088,10088,10090,80,82,8,807320,116
967,y1112,20110831,10088,10090,10122,10124,10122,10122,10122,32,32,6,607360,114
968,y1112,20110901,10122,10122,10102,10102,10102,10102,10102,-20,-20,2,202040,112
969,y1112,20110902,10102,10102,10120,10120,10120,10120,10120,18,18,2,202400,112
970,y1112,20110905,10120,10120,10162,10162,10160,10160,10160,40,40,4,406440,112
971,y1112,20110906,10160,10160,10010,10048,10010,10048,10028,-112,-132,4,401160,112
972,y1112,20110907,10048,10028,10118,10118,10118,10118,10118,90,90,2,202360,112
973,y1112,20110908,10118,10118,0,0,0,10118,10118,0,0,0,0,112
974,y1112,20110909,10118,10118,10076,10078,10064,10064,10072,-54,-46,10,1007240,112
975,y1112,20110913,10064,10072,0,0,0,10072,10072,0,0,0,0,112
976,y1112,20110914,10072,10072,9968,9968,9968,9968,9968,-104,-104,2,199360,112
977,y1112,20110915,9968,9968,0,0,0,9968,9968,0,0,0,0,112
978,y1112,20110916,9968,9968,0,0,0,9968,9968,0,0,0,0,112
979,y1112,20110919,9968,9968,0,0,0,9968,9968,0,0,0,0,112
980,y1112,20110920,9968,9968,0,0,0,9968,9968,0,0,0,0,112
981,y1112,20110921,9968,9968,9878,9878,9706,9812,9792,-156,-176,156,15275640,144
982,y1112,20110922,9812,9792,0,0,0,9792,9792,0,0,0,0,144
983,y1112,20110923,9792,9792,9454,9454,9454,9454,9454,-338,-338,2,189080,146
984,y1112,20110926,9454,9454,9162,9352,8982,8982,9056,-472,-398,26,2355040,144
985,y1112,20110927,8982,9056,9448,9450,9132,9182,9396,126,340,22,2067160,154
986,y1112,20110928,9182,9396,0,0,0,9396,9396,0,0,0,0,154
987,y1112,20110929,9396,9396,0,0,0,9396,9396,0,0,0,0,154
988,y1112,20110930,9396,9396,0,0,0,9396,9396,0,0,0,0,154
989,y1112,20111010,9396,9396,8848,8870,8848,8870,8850,-526,-546,12,1062200,148
990,y1112,20111011,8870,8850,8906,8906,8902,8902,8904,52,54,4,356160,144
991,y1112,20111012,8902,8904,8930,8930,8930,8930,8930,26,26,14,1250200,146
992,y1112,20111013,8930,8930,9090,9090,9090,9090,9090,160,160,10,909000,138
993,y1112,20111014,9090,9090,0,0,0,9090,9090,0,0,0,0,138
994,y1112,20111017,9090,9090,9086,9086,9086,9086,9086,-4,-4,2,181720,138
995,y1112,20111018,9086,9086,0,0,0,9086,9086,0,0,0,0,138
996,y1112,20111019,9086,9086,8952,8966,8952,8966,8960,-120,-126,6,537680,136
997,y1112,20111020,8966,8960,8752,8752,8750,8750,8750,-210,-210,18,1575080,118
998,y1112,20111021,8750,8750,8900,8900,8900,8900,8900,150,150,22,1958000,96
999,y1112,20111024,8900,8900,8952,8952,8952,8952,8952,52,52,2,179040,96
1000,y1112,20111025,8952,8952,9000,9000,9000,9000,9000,48,48,8,720000,96
1001,y1112,20111026,9000,9000,8942,8942,8942,8942,8942,-58,-58,8,715360,94
1002,y1112,20111027,8942,8942,9006,9006,9000,9000,9000,58,58,16,1440120,94
1003,y1112,20111028,9000,9000,0,0,0,9000,9000,0,0,0,0,94
1004,y1112,20111031,9000,9000,0,0,0,9000,9000,0,0,0,0,94
1005,y1112,20111101,9000,9000,8830,8924,8800,8800,8860,-200,-140,20,1772240,86
1006,y1112,20111102,8800,8860,8860,8860,8860,8860,8860,0,0,2,177200,84
1007,y1112,20111103,8860,8860,0,0,0,8860,8860,0,0,0,0,84
1008,y1112,20111104,8860,8860,8918,8918,8918,8918,8918,58,58,8,713440,76
1009,y1112,20111107,8918,8918,0,0,0,8918,8918,0,0,0,0,76
1010,y1112,20111108,8918,8918,8656,8656,8656,8656,8656,-262,-262,2,173120,76
1011,y1112,20111109,8656,8656,0,0,0,8656,8656,0,0,0,0,76
1012,y1112,20111110,8656,8656,0,0,0,8656,8656,0,0,0,0,76
1013,y1112,20111111,8656,8656,8700,8700,8700,8700,8700,44,44,26,2262000,50
1014,y1112,20111114,8700,8700,8800,8930,8800,8930,8856,230,156,8,708600,42
1015,y1112,20111115,8930,8856,8930,8998,8930,8998,8984,142,128,10,898440,32
1016,y1112,20111116,8998,8984,0,0,0,8984,8984,0,0,0,0,32
1017,y1112,20111117,8984,8984,0,0,0,8984,8984,0,0,0,0,32
1018,y1112,20111118,8984,8984,0,0,0,8984,8984,0,0,0,0,32
1019,y1112,20111121,8984,8984,0,0,0,8984,8984,0,0,0,0,32
1020,y1112,20111122,8984,8984,8900,8900,8900,8900,8900,-84,-84,2,178000,30
1021,y1112,20111123,8900,8900,8880,8880,8602,8876,8786,-24,-114,6,527160,28
1022,y1112,20111124,8876,8786,8780,8780,8780,8780,8780,-6,-6,2,175600,26
1023,y1112,20111125,8780,8780,8346,8768,8346,8758,8660,-22,-120,18,1558800,16
1024,y1112,20111128,8758,8660,8750,8750,8750,8750,8750,90,90,6,525000,10
1025,y1112,20111129,8750,8750,8700,8800,8700,8800,8760,50,10,10,876000,6
1026,y1112,20111130,8800,8760,8702,8702,8322,8322,8462,-438,-298,6,507720,4
1027,y1112,20111201,8322,8462,8500,8500,8500,8500,8500,38,38,4,340000,4
1028,y1112,20111202,8500,8500,0,0,0,8500,8500,0,0,0,0,4
1029,y1112,20111205,8500,8500,0,0,0,8500,8500,0,0,0,0,4
1030,y1112,20111206,8500,8500,0,0,0,8500,8500,0,0,0,0,4
1031,y1112,20111207,8500,8500,0,0,0,8500,8500,0,0,0,0,4
1032,y1112,20111208,8500,8500,0,0,0,8500,8500,0,0,0,0,4
1033,y1112,20111209,8500,8500,0,0,0,8500,8500,0,0,0,0,4
1034,y1112,20111212,8500,8500,0,0,0,8500,8500,0,0,0,0,4
1035,y1112,20111213,8500,8500,0,0,0,8500,8500,0,0,0,0,4
1036,y1112,20111214,8500,8500,0,0,0,8500,8500,0,0,4,340000,0
1037,y1201,20110119,10458,10378,10540,10636,10496,10628,10552,250,174,17036,1797895120,15950
1038,y1201,20110120,10628,10552,10600,10640,10542,10596,10604,44,52,27764,2944332600,31466
1039,y1201,20110121,10596,10604,10570,10606,10530,10572,10566,-32,-38,9914,1047566440,35614
1040,y1201,20110124,10572,10566,10600,10860,10600,10736,10752,170,186,14936,1606057120,40814
1041,y1201,20110125,10736,10752,10644,10700,10576,10576,10646,-176,-106,7050,750615880,41308
1042,y1201,20110126,10576,10646,10406,10432,10218,10348,10320,-298,-326,8836,911941800,39738
1043,y1201,20110127,10348,10320,10500,10512,10410,10450,10444,130,124,8154,851686720,42836
1044,y1201,20110128,10450,10444,10452,10490,10418,10430,10450,-14,6,3720,388741840,43682
1045,y1201,20110131,10430,10450,10540,10628,10450,10604,10574,154,124,6176,653169880,44480
1046,y1201,20110201,10604,10574,10700,10700,10598,10664,10644,90,70,1260,134136360,44492
1047,y1201,20110209,10664,10644,10800,10856,10760,10850,10810,206,166,10246,1107709480,47658
1048,y1201,20110210,10850,10810,10938,11018,10892,10910,10938,100,128,20198,2209386680,52634
1049,y1201,20110211,10910,10938,10910,10966,10840,10950,10930,12,-8,28370,3101050960,62566
1050,y1201,20110214,10950,10930,10920,10980,10860,10970,10930,40,0,23298,2546566920,70268
1051,y1201,20110215,10970,10930,10850,10900,10740,10820,10862,-110,-68,36578,3973398320,84978
1052,y1201,20110216,10820,10862,10650,10678,10520,10608,10618,-254,-244,32298,3429957440,92070
1053,y1201,20110217,10608,10618,10640,10684,10456,10462,10574,-156,-44,44138,4667765640,104426
1054,y1201,20110218,10462,10574,10600,10638,10460,10460,10560,-114,-14,40086,4233346480,107586
1055,y1201,20110221,10460,10560,10466,10484,10342,10442,10434,-118,-126,18106,1889500160,106462
1056,y1201,20110222,10442,10434,10522,10590,10388,10538,10514,104,80,26416,2777799800,107776
1057,y1201,20110223,10538,10514,9890,10180,9890,10116,10112,-398,-402,34212,3459618320,112660
1058,y1201,20110224,10116,10112,10200,10210,9850,9990,10044,-122,-68,44734,4493863800,108486
1059,y1201,20110225,9990,10044,10050,10164,10028,10160,10102,116,58,30470,3078438000,113774
1060,y1201,20110228,10160,10102,10310,10330,10242,10296,10284,194,182,29458,3029625720,111390
1061,y1201,20110301,10296,10284,10284,10500,10220,10312,10294,28,10,32042,3298953920,110588
1062,y1201,20110302,10312,10294,10350,10488,10300,10474,10396,180,102,39300,4085773360,115818
1063,y1201,20110303,10474,10396,10486,10536,10404,10420,10466,24,70,46074,4822561360,124224
1064,y1201,20110304,10420,10466,10524,10560,10452,10528,10510,62,44,41566,4368595200,129388
1065,y1201,20110307,10528,10510,10498,10570,10486,10520,10520,10,10,40684,4280183760,134018
1066,y1201,20110308,10520,10520,10402,10468,10312,10352,10394,-168,-126,35808,3722219640,130912
1067,y1201,20110309,10352,10394,10370,10404,10294,10318,10348,-76,-46,35750,3699702600,134566
1068,y1201,20110310,10318,10348,10162,10258,10138,10182,10204,-166,-144,29394,2999378480,137132
1069,y1201,20110311,10182,10204,10220,10266,10112,10122,10172,-82,-32,55268,5622889200,141362
1070,y1201,20110314,10122,10172,10080,10102,9932,9976,10008,-196,-164,57850,5790133120,150020
1071,y1201,20110315,9976,10008,9980,10060,9952,10054,10018,46,10,68190,6831881360,152800
1072,y1201,20110316,10054,10018,9820,9914,9720,9900,9832,-118,-186,86818,8536414000,147502
1073,y1201,20110317,9900,9832,9880,10026,9836,9992,9944,160,112,81940,8149069480,143126
1074,y1201,20110318,9992,9944,10100,10142,10070,10118,10110,174,166,55420,5603574160,149422
1075,y1201,20110321,10118,10110,10146,10248,10146,10212,10202,102,92,86562,8832641160,152780
1076,y1201,20110322,10212,10202,10180,10208,10158,10158,10180,-44,-22,55554,5655501920,155530
1077,y1201,20110323,10158,10180,10180,10284,10176,10268,10236,88,56,91426,9359812240,161072
1078,y1201,20110324,10268,10236,10250,10252,10080,10082,10158,-154,-78,85662,8701949320,158566
1079,y1201,20110325,10082,10158,10152,10250,10152,10228,10208,70,50,77864,7949792200,161720
1080,y1201,20110328,10228,10208,10250,10316,10126,10234,10248,26,40,164038,16813331720,171062
1081,y1201,20110329,10234,10248,10198,10236,10134,10202,10188,-46,-60,110192,11228162200,180948
1082,y1201,20110330,10202,10188,10250,10350,10244,10304,10298,116,110,156624,16131745200,201220
1083,y1201,20110331,10304,10298,10320,10338,10222,10310,10288,12,-10,114372,11766785960,199846
1084,y1201,20110401,10310,10288,10420,10450,10370,10396,10408,108,120,122362,12735751080,207478
1085,y1201,20110406,10396,10408,10396,10546,10382,10532,10484,124,76,196404,20594384800,248946
1086,y1201,20110407,10532,10484,10500,10548,10488,10522,10516,38,32,187554,19725979600,275210
1087,y1201,20110408,10522,10516,10490,10608,10450,10606,10540,90,24,356834,37616757760,349474
1088,y1201,20110411,10606,10540,10682,10752,10650,10680,10706,140,166,393260,42106705360,388490
1089,y1201,20110412,10680,10706,10562,10574,10468,10476,10510,-230,-196,390400,41034990200,371852
1090,y1201,20110413,10476,10510,10378,10414,10324,10408,10362,-102,-148,348700,36138529960,368084
1091,y1201,20110414,10408,10362,10360,10386,10250,10252,10336,-110,-26,348842,36057602080,369118
1092,y1201,20110415,10252,10336,10300,10328,10204,10204,10270,-132,-66,346256,35561544160,375146
1093,y1201,20110418,10204,10270,10148,10262,10132,10244,10214,-26,-56,306234,31280205480,380136
1094,y1201,20110419,10244,10214,10280,10318,10172,10188,10234,-26,20,445458,45594441120,387514
1095,y1201,20110420,10188,10234,10260,10380,10246,10370,10322,136,88,386140,39862081880,401576
1096,y1201,20110421,10370,10322,10390,10390,10318,10340,10346,18,24,358768,37124547560,391096
1097,y1201,20110422,10340,10346,10402,10440,10352,10440,10406,94,60,459924,47868708440,397036
1098,y1201,20110425,10440,10406,10478,10478,10416,10438,10442,32,36,426516,44543134920,404860
1099,y1201,20110426,10438,10442,10350,10364,10256,10256,10298,-186,-144,397106,40899095960,391358
1100,y1201,20110427,10256,10298,10304,10324,10204,10222,10270,-76,-28,451956,46418287320,396560
1101,y1201,20110428,10222,10270,10260,10356,10256,10356,10308,86,38,453694,46774234000,385976
1102,y1201,20110429,10356,10308,10200,10218,10082,10092,10128,-216,-180,539980,54690290080,400798
1103,y1201,20110503,10092,10128,10198,10224,10170,10212,10204,84,76,325440,33210969400,403908
1104,y1201,20110504,10212,10204,10160,10168,10082,10126,10118,-78,-86,345136,34921813000,409046
1105,y1201,20110505,10126,10118,10060,10134,9998,10106,10084,-12,-34,513958,51836165840,413634
1106,y1201,20110506,10106,10084,9900,9958,9844,9856,9906,-228,-178,669092,66287093920,440690
1107,y1201,20110509,9856,9906,9914,9944,9888,9924,9918,18,12,320810,31820517120,429354
1108,y1201,20110510,9924,9918,9950,10020,9906,10006,9962,88,44,461442,45970545920,414558
1109,y1201,20110511,10006,9962,10036,10056,9982,9994,10014,32,52,359150,35967242200,426912
1110,y1201,20110512,9994,10014,9954,10044,9902,9912,9986,-102,-28,810478,80937477000,478806
1111,y1201,20110513,9912,9986,9980,10074,9960,10056,10008,70,22,529962,53045807240,454560
1112,y1201,20110516,10056,10008,10000,10018,9946,9964,9980,-44,-28,470710,46978130360,453160
1113,y1201,20110517,9964,9980,9936,9962,9832,9928,9892,-52,-88,683148,67582676000,459792
1114,y1201,20110518,9928,9892,9976,10026,9962,9988,10000,96,108,418378,41840238440,455316
1115,y1201,20110519,9988,10000,10100,10118,10060,10072,10086,72,86,332750,33565971800,454690
1116,y1201,20110520,10072,10086,10098,10158,10080,10154,10112,68,26,400320,40486417880,468990
1117,y1201,20110523,10154,10112,10190,10198,10118,10124,10158,12,46,419298,42595517320,468094
1118,y1201,20110524,10124,10158,10156,10230,10126,10220,10164,62,6,396512,40305778400,483508
1119,y1201,20110525,10220,10164,10200,10212,10150,10178,10178,14,14,323230,32904511720,467396
1120,y1201,20110526,10178,10178,10250,10296,10234,10296,10264,118,86,350822,36009614560,479396
1121,y1201,20110527,10296,10264,10316,10320,10270,10314,10292,50,28,337494,34738658720,468246
1122,y1201,20110530,10314,10292,10292,10398,10284,10348,10354,56,62,431058,44637910280,478896
1123,y1201,20110531,10348,10354,10352,10374,10302,10332,10330,-22,-24,389728,40265684400,474598
1124,y1201,20110601,10332,10330,10350,10366,10290,10302,10316,-28,-14,344924,35588662640,476078
1125,y1201,20110602,10302,10316,10296,10366,10274,10360,10310,44,-6,439382,45306269080,503278
1126,y1201,20110603,10360,10310,10398,10534,10390,10528,10452,218,142,565690,59133588800,562788
1127,y1201,20110607,10528,10452,10400,10440,10374,10436,10406,-16,-46,469460,48852129480,544660
1128,y1201,20110608,10436,10406,10438,10456,10346,10368,10402,-38,-4,499870,52006392680,528602
1129,y1201,20110609,10368,10402,10400,10430,10360,10362,10398,-40,-4,392380,40807326680,522034
1130,y1201,20110610,10362,10398,10350,10358,10264,10286,10316,-112,-82,408898,42187409960,516342
1131,y1201,20110613,10286,10316,10258,10298,10248,10282,10280,-34,-36,276142,28389983520,509414
1132,y1201,20110614,10282,10280,10288,10328,10266,10314,10300,34,20,297504,30645107920,513860
1133,y1201,20110615,10314,10300,10308,10366,10272,10342,10318,42,18,366186,37785641320,540878
1134,y1201,20110616,10342,10318,10306,10316,10202,10218,10262,-100,-56,383228,39331507760,526704
1135,y1201,20110617,10218,10262,10200,10226,10136,10168,10182,-94,-80,359304,36586367640,515332
1136,y1201,20110620,10168,10182,10152,10198,10124,10160,10168,-22,-14,335766,34142929360,524210
1137,y1201,20110621,10160,10168,10198,10248,10180,10232,10210,64,42,335816,34292877800,521946
1138,y1201,20110622,10232,10210,10246,10252,10186,10196,10222,-14,12,272672,27874727240,510380
1139,y1201,20110623,10196,10222,10142,10164,10082,10158,10128,-64,-94,335950,34026177080,490542
1140,y1201,20110624,10158,10128,10084,10150,10072,10112,10120,-16,-8,335206,33922927680,505892
1141,y1201,20110627,10112,10120,10070,10070,9880,9884,9962,-236,-158,499954,49810325880,469678
1142,y1201,20110628,9884,9962,9950,9974,9896,9906,9938,-56,-24,335716,33369147600,458126
1143,y1201,20110629,9906,9938,9980,9998,9956,9968,9976,30,38,246892,24634105160,451976
1144,y1201,20110630,9968,9976,9962,10046,9962,10046,10016,70,40,228846,22924009680,443838
1145,y1201,20110701,10046,10016,9934,9956,9882,9948,9930,-68,-86,336390,33405467160,462056
1146,y1201,20110704,9948,9930,9980,10078,9968,10060,10032,130,102,366142,36732289040,489634
1147,y1201,20110705,10060,10032,10060,10094,10024,10032,10050,0,18,315738,31734975560,490574
1148,y1201,20110706,10032,10050,10020,10068,10002,10038,10034,-12,-16,285744,28677178080,486030
1149,y1201,20110707,10038,10034,10030,10118,10030,10114,10068,80,34,298410,30049566000,480764
1150,y1201,20110708,10114,10068,10200,10234,10190,10220,10208,152,140,295048,30124050120,450404
1151,y1201,20110711,10220,10208,10208,10268,10200,10222,10244,14,36,226432,23198978480,408194
1152,y1201,20110712,10222,10244,10220,10252,10122,10174,10186,-70,-58,222168,22630865600,370852
1153,y1201,20110713,10174,10186,10232,10288,10226,10278,10266,92,80,182656,18753006320,339088
1154,y1201,20110714,10278,10266,10350,10358,10280,10292,10310,26,44,167962,17317681480,281292
1155,y1201,20110715,10292,10310,10270,10276,10208,10254,10252,-56,-58,111512,11433481280,257208
1156,y1201,20110718,10254,10252,10276,10286,10144,10196,10248,-56,-4,89776,9200734200,250492
1157,y1201,20110719,10196,10248,10220,10258,10202,10252,10226,4,-22,59998,6135576120,234870
1158,y1201,20110720,10252,10226,10240,10298,10218,10272,10262,46,36,99376,10198401240,193032
1159,y1201,20110721,10272,10262,10276,10300,10236,10266,10268,4,6,60058,6166848920,185960
1160,y1201,20110722,10266,10268,10260,10276,10240,10272,10262,4,-6,34566,3547700440,184344
1161,y1201,20110725,10272,10262,10222,10250,10122,10124,10172,-138,-90,62226,6329718160,170134
1162,y1201,20110726,10124,10172,10150,10182,10130,10178,10156,6,-16,27000,2742278320,166728
1163,y1201,20110727,10178,10156,10220,10236,10202,10226,10218,70,62,32008,3271076760,167178
1164,y1201,20110728,10226,10218,10210,10210,10162,10178,10186,-40,-32,29166,2971049880,163854
1165,y1201,20110729,10178,10186,10120,10222,10112,10140,10178,-46,-8,40262,4098551560,163988
1166,y1201,20110801,10140,10178,10200,10250,10172,10246,10202,68,24,29846,3045019800,162630
1167,y1201,20110802,10246,10202,10250,10286,10210,10224,10248,22,46,30032,3077801760,156860
1168,y1201,20110803,10224,10248,10320,10320,10254,10266,10270,18,22,27618,2836715080,153188
1169,y1201,20110804,10266,10270,10222,10240,10158,10190,10196,-80,-74,21374,2179424160,151782
1170,y1201,20110805,10190,10196,10064,10064,9906,9982,9992,-214,-204,64040,6399008960,146032
1171,y1201,20110808,9982,9992,9882,10000,9882,9936,9960,-56,-32,30176,3005707640,143456
1172,y1201,20110809,9936,9960,9750,9832,9594,9788,9708,-172,-252,35540,3450491360,138644
1173,y1201,20110810,9788,9708,9820,9890,9820,9852,9842,144,134,18094,1781157200,136388
1174,y1201,20110811,9852,9842,9800,9890,9796,9882,9842,40,0,24540,2415567960,128702
1175,y1201,20110812,9882,9842,9990,9990,9876,9888,9918,46,76,13708,1359819120,127388
1176,y1201,20110815,9888,9918,9996,9996,9946,9966,9966,48,48,10634,1059929280,126396
1177,y1201,20110816,9966,9966,9998,10000,9920,9920,9964,-46,-2,11104,1106571640,127054
1178,y1201,20110817,9920,9964,9942,9994,9942,9978,9976,14,12,9292,927046720,127590
1179,y1201,20110818,9978,9976,10000,10030,9966,9982,9988,6,12,6422,641453720,125968
1180,y1201,20110819,9982,9988,9960,9960,9890,9936,9916,-52,-72,14572,1445035240,119994
1181,y1201,20110822,9936,9916,9986,10000,9950,9952,9982,36,66,22054,2201587200,117714
1182,y1201,20110823,9952,9982,9998,10078,9988,10076,10028,94,46,19482,1953725600,114044
1183,y1201,20110824,10076,10028,10098,10098,10030,10062,10068,34,40,16002,1611206680,111048
1184,y1201,20110825,10062,10068,10086,10086,10026,10050,10046,-18,-22,7108,714103320,109814
1185,y1201,20110826,10050,10046,10056,10080,10006,10044,10042,-2,-4,8274,830888800,109714
1186,y1201,20110829,10044,10042,10168,10230,10166,10214,10192,172,150,17484,1782231840,106048
1187,y1201,20110830,10214,10192,10248,10294,10224,10250,10256,58,64,15988,1639743520,100404
1188,y1201,20110831,10250,10256,10266,10346,10258,10310,10300,54,44,15092,1554694880,95272
1189,y1201,20110901,10310,10300,10300,10326,10274,10288,10300,-12,0,7030,724224200,95416
1190,y1201,20110902,10288,10300,10280,10320,10252,10318,10302,18,2,9712,1000540440,92838
1191,y1201,20110905,10318,10302,10300,10376,10236,10268,10332,-34,30,18300,1890775120,89140
1192,y1201,20110906,10268,10332,10298,10298,10154,10238,10204,-94,-128,9132,931995920,88458
1193,y1201,20110907,10238,10204,10288,10314,10224,10312,10268,108,64,10972,1126795600,84058
1194,y1201,20110908,10312,10268,10350,10350,10246,10296,10282,28,14,5732,589454280,83994
1195,y1201,20110909,10296,10282,10270,10318,10266,10312,10294,30,12,4250,437516360,83504
1196,y1201,20110913,10312,10294,10248,10248,10164,10174,10188,-120,-106,8700,886420160,82480
1197,y1201,20110914,10174,10188,10178,10202,10060,10096,10118,-92,-70,7082,716560840,81830
1198,y1201,20110915,10096,10118,10128,10140,10070,10116,10120,-2,2,4188,423851920,80890
1199,y1201,20110916,10116,10120,10060,10092,10042,10086,10070,-34,-50,8088,814563200,78822
1200,y1201,20110919,10086,10070,10056,10056,9960,9966,9998,-104,-72,5160,515925720,78002
1201,y1201,20110920,9966,9998,9956,10050,9956,10042,10012,44,14,9964,997699160,73792
1202,y1201,20110921,10042,10012,10010,10028,9944,10018,10000,6,-12,5604,560486520,71094
1203,y1201,20110922,10018,10000,9912,9912,9792,9848,9868,-152,-132,5486,541427960,68686
1204,y1201,20110923,9848,9868,9550,9758,9376,9508,9592,-360,-276,12002,1151400360,63118
1205,y1201,20110926,9508,9592,9450,9560,9114,9138,9340,-454,-252,8576,801160520,60998
1206,y1201,20110927,9138,9340,9294,9432,9294,9370,9390,30,50,11800,1108095440,56326
1207,y1201,20110928,9370,9390,9292,9332,9208,9258,9262,-132,-128,10754,996150600,49892
1208,y1201,20110929,9258,9262,8956,9060,8908,9030,9006,-232,-256,6078,547402840,47250
1209,y1201,20110930,9030,9006,9030,9350,9030,9282,9210,276,204,4048,372898160,46098
1210,y1201,20111010,9282,9210,9100,9100,9014,9048,9066,-162,-144,1776,161033840,45722
1211,y1201,20111011,9048,9066,9100,9228,9014,9014,9092,-52,26,2088,189880680,46158
1212,y1201,20111012,9014,9092,9160,9232,9100,9212,9192,120,100,2364,217310120,45572
1213,y1201,20111013,9212,9192,9212,9238,9188,9214,9208,22,16,2228,205184000,45280
1214,y1201,20111014,9214,9208,9230,9304,9230,9292,9274,84,66,842,78094520,44824
1215,y1201,20111017,9292,9274,9304,9370,9304,9304,9330,30,56,2244,209374800,44700
1216,y1201,20111018,9304,9330,9218,9218,9122,9122,9182,-208,-148,1816,166751920,44296
1217,y1201,20111019,9122,9182,9196,9224,9140,9168,9202,-14,20,3688,339413600,41298
1218,y1201,20111020,9168,9202,9002,9010,8890,8980,8956,-222,-246,3514,314781880,39622
1219,y1201,20111021,8980,8956,9028,9120,9028,9096,9056,140,100,3384,306522520,36890
1220,y1201,20111024,9096,9056,9122,9288,9060,9220,9198,164,142,1110,102116120,36552
1221,y1201,20111025,9220,9198,9250,9300,9200,9266,9236,68,38,2848,263067240,34802
1222,y1201,20111026,9266,9236,9120,9266,9120,9238,9236,2,0,822,75932720,34690
1223,y1201,20111027,9238,9236,9238,9340,9190,9340,9308,104,72,2374,221007280,33148
1224,y1201,20111028,9340,9308,9412,9418,9278,9286,9348,-22,40,1224,114442200,32354
1225,y1201,20111031,9286,9348,9260,9266,9138,9146,9172,-202,-176,1376,126212760,31416
1226,y1201,20111101,9146,9172,9218,9232,9154,9172,9200,0,28,1838,169125320,30902
1227,y1201,20111102,9172,9200,9150,9272,9106,9272,9130,72,-70,7956,726472200,28200
1228,y1201,20111103,9272,9130,9256,9256,9164,9166,9186,36,56,806,74044920,27864
1229,y1201,20111104,9166,9186,9262,9300,9250,9260,9266,74,80,784,72656680,27568
1230,y1201,20111107,9260,9266,9212,9212,9160,9186,9186,-80,-80,268,24619600,27494
1231,y1201,20111108,9186,9186,9188,9216,9130,9184,9178,-2,-8,546,50116120,27398
1232,y1201,20111109,9184,9178,9200,9254,9180,9190,9218,12,40,398,36695520,27308
1233,y1201,20111110,9190,9218,9006,9072,8978,9056,9040,-162,-178,580,52441040,26912
1234,y1201,20111111,9056,9040,9142,9166,9064,9142,9102,102,62,676,61530560,26660
1235,y1201,20111114,9142,9102,9184,9264,9184,9264,9230,162,128,116,10707520,26648
1236,y1201,20111115,9264,9230,9246,9252,9192,9236,9226,6,-4,1218,112392800,26386
1237,y1201,20111116,9236,9226,9298,9340,9202,9220,9240,-6,14,356,32900920,26314
1238,y1201,20111117,9220,9240,9230,9278,9206,9266,9246,26,6,1286,118911680,25248
1239,y1201,20111118,9266,9246,9140,9168,9112,9152,9142,-94,-104,70,6399600,25248
1240,y1201,20111121,9152,9142,9100,9158,9100,9134,9136,-8,-6,328,29967960,25232
1241,y1201,20111122,9134,9136,9076,9098,9008,9010,9044,-126,-92,66,5970240,25224
1242,y1201,20111123,9010,9044,9066,9066,8938,8942,8996,-102,-48,278,25011080,25084
1243,y1201,20111124,8942,8996,8940,8962,8730,8780,8858,-216,-138,634,56164400,25052
1244,y1201,20111125,8780,8858,8766,8788,8678,8712,8704,-146,-154,370,32210640,24840
1245,y1201,20111128,8712,8704,8724,8768,8724,8736,8746,32,42,944,82576600,23928
1246,y1201,20111129,8736,8746,8770,8776,8708,8746,8750,0,4,2632,230349440,23218
1247,y1201,20111130,8746,8750,8746,8760,8590,8590,8732,-160,-18,4484,391631920,23060
1248,y1201,20111201,8590,8732,8762,8878,8762,8850,8846,118,114,388,34326000,22710
1249,y1201,20111202,8850,8846,8816,8838,8784,8796,8808,-50,-38,892,78573640,22204
1250,y1201,20111205,8796,8808,8820,8866,8820,8824,8842,16,34,582,51464240,21714
1251,y1201,20111206,8824,8842,8752,8788,8752,8776,8776,-66,-66,160,14042880,21554
1252,y1201,20111207,8776,8776,8806,8806,8738,8766,8780,-10,4,958,84114080,20998
1253,y1201,20111208,8766,8780,8732,8732,8640,8640,8674,-140,-106,218,18911560,20822
1254,y1201,20111209,8640,8674,8674,8716,8648,8658,8708,-16,34,2262,197017360,20776
1255,y1201,20111212,8658,8708,8702,8702,8538,8538,8600,-170,-108,190,16341920,20720
1256,y1201,20111213,8538,8600,8552,8564,8520,8520,8564,-80,-36,752,64408040,20558
1257,y1201,20111214,8520,8564,8488,8550,8488,8534,8532,-30,-32,1542,131584920,20126
1258,y1201,20111215,8534,8532,8436,8498,8396,8498,8440,-34,-92,1026,86606800,19126
1259,y1201,20111216,8498,8440,8542,8542,8484,8506,8504,66,64,998,84889600,18140
1260,y1201,20111219,8506,8504,8554,8578,8542,8572,8548,68,44,538,45998440,17620
1261,y1201,20111220,8572,8548,8570,8580,8524,8524,8544,-24,-4,654,55889920,17006
1262,y1201,20111221,8524,8544,8588,8590,8562,8564,8566,20,22,850,72819800,16704
1263,y1201,20111222,8564,8566,8600,8602,8536,8564,8584,-2,18,1130,97001000,15904
1264,y1201,20111223,8564,8584,8608,8646,8600,8600,8618,16,34,886,76366040,15444
1265,y1201,20111226,8600,8618,8650,8650,8594,8608,8644,-10,26,1100,95105960,15284
1266,y1201,20111227,8608,8644,8620,8620,8570,8610,8602,-34,-42,58,4989760,15234
1267,y1201,20111228,8610,8602,8674,8710,8666,8690,8688,88,86,3896,338526720,15156
1268,y1201,20111229,8690,8688,8672,8698,8672,8674,8694,-14,6,1102,95825720,15154
1269,y1201,20111230,8674,8694,8660,8750,8428,8448,8634,-246,-60,1698,146606000,15162
1270,y1203,20110316,10170,10170,0,0,0,10170,10170,0,0,0,0,0
1271,y1203,20110317,10170,10170,0,0,0,10170,10170,0,0,0,0,0
1272,y1203,20110318,10170,10170,0,0,0,10170,10170,0,0,0,0,0
1273,y1203,20110321,10170,10170,0,0,0,10170,10170,0,0,0,0,0
1274,y1203,20110322,10170,10170,0,0,0,10170,10170,0,0,0,0,0
1275,y1203,20110323,10170,10170,0,0,0,10170,10170,0,0,0,0,0
1276,y1203,20110324,10170,10170,0,0,0,10170,10170,0,0,0,0,0
1277,y1203,20110325,10170,10170,0,0,0,10170,10170,0,0,0,0,0
1278,y1203,20110328,10170,10170,0,0,0,10170,10170,0,0,0,0,0
1279,y1203,20110329,10170,10170,0,0,0,10170,10170,0,0,0,0,0
1280,y1203,20110330,10170,10170,0,0,0,10170,10170,0,0,0,0,0
1281,y1203,20110331,10170,10170,0,0,0,10170,10170,0,0,0,0,0
1282,y1203,20110401,10170,10170,0,0,0,10170,10170,0,0,0,0,0
1283,y1203,20110406,10170,10170,0,0,0,10170,10170,0,0,0,0,0
1284,y1203,20110407,10170,10170,0,0,0,10170,10170,0,0,0,0,0
1285,y1203,20110408,10170,10170,10750,10750,10352,10500,10534,330,364,6,632040,2
1286,y1203,20110411,10500,10534,0,0,0,10534,10534,0,0,0,0,2
1287,y1203,20110412,10534,10534,0,0,0,10534,10534,0,0,0,0,2
1288,y1203,20110413,10534,10534,10548,10548,10400,10508,10480,-26,-54,14,1467240,10
1289,y1203,20110414,10508,10480,10380,10380,10380,10380,10380,-100,-100,2,207600,10
1290,y1203,20110415,10380,10380,10350,10350,10350,10350,10350,-30,-30,2,207000,10
1291,y1203,20110418,10350,10350,0,0,0,10350,10350,0,0,0,0,10
1292,y1203,20110419,10350,10350,10210,10444,10210,10276,10310,-74,-40,6,618600,12
1293,y1203,20110420,10276,10310,10342,10342,10342,10342,10342,32,32,2,206840,10
1294,y1203,20110421,10342,10342,10616,10616,10388,10388,10444,46,102,18,1880120,2
1295,y1203,20110422,10388,10444,0,0,0,10444,10444,0,0,0,0,2
1296,y1203,20110425,10444,10444,0,0,0,10444,10444,0,0,0,0,2
1297,y1203,20110426,10444,10444,10440,10440,10440,10440,10440,-4,-4,2,208800,2
1298,y1203,20110427,10440,10440,10300,10376,10250,10340,10320,-100,-120,32,3302720,6
1299,y1203,20110428,10340,10320,10336,10398,10336,10390,10378,70,58,8,830360,8
1300,y1203,20110429,10390,10378,0,0,0,10378,10378,0,0,0,0,8
1301,y1203,20110503,10378,10378,0,0,0,10378,10378,0,0,0,0,8
1302,y1203,20110504,10378,10378,0,0,0,10378,10378,0,0,0,0,8
1303,y1203,20110505,10378,10378,0,0,0,10378,10378,0,0,0,0,8
1304,y1203,20110506,10378,10378,9950,9950,9950,9950,9950,-428,-428,2,199000,10
1305,y1203,20110509,9950,9950,9950,10022,9950,10022,9986,72,36,8,798880,8
1306,y1203,20110510,10022,9986,9940,10060,9940,10060,9994,74,8,10,999480,12
1307,y1203,20110511,10060,9994,0,0,0,9994,9994,0,0,0,0,12
1308,y1203,20110512,9994,9994,10060,10060,9980,9980,10024,-14,30,8,801920,14
1309,y1203,20110513,9980,10024,9990,10118,9990,10118,10028,94,4,18,1805120,20
1310,y1203,20110516,10118,10028,9914,10054,9914,10054,10002,26,-26,20,2000480,16
1311,y1203,20110517,10054,10002,10020,10020,9928,9928,9974,-74,-28,30,2992480,14
1312,y1203,20110518,9928,9974,10050,10050,10036,10036,10040,62,66,6,602440,14
1313,y1203,20110519,10036,10040,10108,10108,10060,10060,10090,20,50,14,1412720,8
1314,y1203,20110520,10060,10090,10118,10120,10118,10120,10118,30,28,4,404760,6
1315,y1203,20110523,10120,10118,10100,10314,10100,10160,10160,42,42,76,7722920,24
1316,y1203,20110524,10160,10160,0,0,0,10160,10160,0,0,0,0,24
1317,y1203,20110525,10160,10160,0,0,0,10160,10160,0,0,0,0,24
1318,y1203,20110526,10160,10160,0,0,0,10160,10160,0,0,0,0,24
1319,y1203,20110527,10160,10160,10292,10364,10292,10306,10320,146,160,6,619240,24
1320,y1203,20110530,10306,10320,0,0,0,10320,10320,0,0,0,0,24
1321,y1203,20110531,10320,10320,10320,10388,10302,10358,10348,38,28,16,1655800,26
1322,y1203,20110601,10358,10348,10358,10368,10306,10310,10330,-38,-18,22,2272760,26
1323,y1203,20110602,10310,10330,10336,10336,10336,10336,10336,6,6,4,413440,24
1324,y1203,20110603,10336,10336,0,0,0,10336,10336,0,0,0,0,24
1325,y1203,20110607,10336,10336,0,0,0,10336,10336,0,0,0,0,24
1326,y1203,20110608,10336,10336,10398,10440,10398,10440,10418,104,82,4,416760,24
1327,y1203,20110609,10440,10418,0,0,0,10418,10418,0,0,0,0,24
1328,y1203,20110610,10418,10418,10310,10310,10308,10308,10308,-110,-110,6,618560,24
1329,y1203,20110613,10308,10308,10280,10340,10280,10326,10302,18,-6,172,17721560,36
1330,y1203,20110614,10326,10302,10324,10366,10322,10322,10336,20,34,6,620240,36
1331,y1203,20110615,10322,10336,0,0,0,10336,10336,0,0,0,0,36
1332,y1203,20110616,10336,10336,10250,10250,10244,10244,10248,-92,-88,6,614880,36
1333,y1203,20110617,10244,10248,10230,10230,10182,10182,10192,-66,-56,40,4077520,50
1334,y1203,20110620,10182,10192,10190,10240,10190,10194,10198,2,6,40,4079400,36
1335,y1203,20110621,10194,10198,10258,10258,10240,10240,10254,42,56,22,2256040,30
1336,y1203,20110622,10240,10254,10226,10244,10226,10244,10234,-10,-20,4,409400,30
1337,y1203,20110623,10244,10234,10166,10166,10100,10150,10150,-84,-84,12,1218200,28
1338,y1203,20110624,10150,10150,10130,10176,10130,10150,10150,0,0,10,1015160,26
1339,y1203,20110627,10150,10150,9930,9930,9930,9930,9930,-220,-220,2,198600,26
1340,y1203,20110628,9930,9930,10038,10038,9934,9934,9988,4,58,12,1198560,30
1341,y1203,20110629,9934,9988,9934,9984,9932,9984,9938,-4,-50,20,1987680,38
1342,y1203,20110630,9984,9938,10032,10040,10002,10040,10026,102,88,20,2005320,32
1343,y1203,20110701,10040,10026,9938,9968,9920,9968,9940,-58,-86,26,2584480,26
1344,y1203,20110704,9968,9940,10040,10100,10040,10052,10072,112,132,22,2216000,32
1345,y1203,20110705,10052,10072,0,0,0,10072,10072,0,0,0,0,32
1346,y1203,20110706,10072,10072,10080,10080,10080,10080,10080,8,8,4,403200,34
1347,y1203,20110707,10080,10080,10042,10042,10042,10042,10042,-38,-38,4,401680,34
1348,y1203,20110708,10042,10042,10240,10240,10240,10240,10240,198,198,2,204800,36
1349,y1203,20110711,10240,10240,10268,10268,10220,10220,10244,-20,4,4,409760,36
1350,y1203,20110712,10220,10244,10228,10228,10188,10188,10202,-56,-42,6,612120,34
1351,y1203,20110713,10188,10202,10188,10294,10188,10274,10246,72,44,10,1024760,34
1352,y1203,20110714,10274,10246,10346,10346,10310,10322,10326,76,80,6,619560,34
1353,y1203,20110715,10322,10326,10266,10302,10244,10288,10278,-38,-48,36,3700120,30
1354,y1203,20110718,10288,10278,10328,10328,10250,10250,10286,-28,8,24,2468880,34
1355,y1203,20110719,10250,10286,10266,10288,10266,10288,10286,2,0,100,10286760,128
1356,y1203,20110720,10288,10286,10250,10312,10250,10300,10292,14,6,30,3087960,128
1357,y1203,20110721,10300,10292,10298,10300,10270,10280,10292,-12,0,40,4117000,122
1358,y1203,20110722,10280,10292,0,0,0,10292,10292,0,0,0,0,122
1359,y1203,20110725,10292,10292,10238,10238,10114,10158,10152,-134,-140,14,1421360,130
1360,y1203,20110726,10158,10152,10184,10210,10152,10208,10188,56,36,18,1833920,122
1361,y1203,20110727,10208,10188,10288,10288,10206,10250,10254,62,66,18,1846000,116
1362,y1203,20110728,10250,10254,10180,10216,10180,10210,10198,-44,-56,10,1019800,112
1363,y1203,20110729,10210,10198,10186,10202,10170,10190,10188,-8,-10,16,1630120,108
1364,y1203,20110801,10190,10188,10196,10248,10196,10248,10228,60,40,16,1636600,112
1365,y1203,20110802,10248,10228,10278,10300,10246,10288,10270,60,42,34,3492400,110
1366,y1203,20110803,10288,10270,10312,10320,10274,10274,10306,4,36,22,2267520,114
1367,y1203,20110804,10274,10306,10198,10198,10198,10198,10198,-108,-108,2,203960,114
1368,y1203,20110805,10198,10198,10042,10042,9880,9970,9972,-228,-226,54,5385040,108
1369,y1203,20110808,9970,9972,0,0,0,9972,9972,0,0,0,0,108
1370,y1203,20110809,9972,9972,9640,9806,9640,9806,9698,-166,-274,42,4073840,106
1371,y1203,20110810,9806,9698,9870,9870,9870,9870,9870,172,172,2,197400,106
1372,y1203,20110811,9870,9870,9866,9924,9800,9884,9868,14,-2,16,1579120,106
1373,y1203,20110812,9884,9868,9884,9934,9884,9928,9902,60,34,10,990280,106
1374,y1203,20110815,9928,9902,9996,10008,9996,10006,10006,104,104,28,2801840,110
1375,y1203,20110816,10006,10006,9998,9998,9990,9990,9994,-16,-12,8,799600,116
1376,y1203,20110817,9990,9994,10000,10016,10000,10016,10002,22,8,10,1000320,106
1377,y1203,20110818,10016,10002,0,0,0,10002,10002,0,0,0,0,106
1378,y1203,20110819,10002,10002,0,0,0,10002,10002,0,0,0,0,106
1379,y1203,20110822,10002,10002,10002,10066,9980,9982,9998,-20,-4,28,2799840,102
1380,y1203,20110823,9982,9998,10060,10060,10060,10060,10060,62,62,2,201200,102
1381,y1203,20110824,10060,10060,10120,10120,10120,10120,10120,60,60,2,202400,102
1382,y1203,20110825,10120,10120,0,0,0,10120,10120,0,0,0,0,102
1383,y1203,20110826,10120,10120,10090,10090,10006,10052,10048,-68,-72,10,1004880,102
1384,y1203,20110829,10052,10048,10166,10250,10166,10250,10216,202,168,14,1430280,100
1385,y1203,20110830,10250,10216,10296,10306,10296,10306,10302,90,86,28,2884560,92
1386,y1203,20110831,10306,10302,10300,10358,10300,10352,10314,50,12,46,4744800,90
1387,y1203,20110901,10352,10314,10296,10342,10296,10330,10320,16,6,22,2270400,84
1388,y1203,20110902,10330,10320,10242,10334,10242,10316,10290,-4,-30,16,1646520,84
1389,y1203,20110905,10316,10290,10350,10390,10278,10288,10348,-2,58,44,4553160,88
1390,y1203,20110906,10288,10348,10206,10232,10198,10204,10206,-144,-142,18,1837320,90
1391,y1203,20110907,10204,10206,10246,10348,10246,10348,10312,142,106,22,2269040,88
1392,y1203,20110908,10348,10312,10256,10300,10244,10300,10268,-12,-44,16,1642880,82
1393,y1203,20110909,10300,10268,10292,10292,10292,10292,10292,24,24,2,205840,82
1394,y1203,20110913,10292,10292,10182,10188,10180,10180,10182,-112,-110,6,611000,82
1395,y1203,20110914,10180,10182,10102,10102,10088,10088,10094,-94,-88,4,403800,82
1396,y1203,20110915,10088,10094,10128,10128,10044,10110,10092,16,-2,26,2624200,82
1397,y1203,20110916,10110,10092,10094,10094,9986,10008,10038,-84,-54,12,1204560,82
1398,y1203,20110919,10008,10038,0,0,0,10038,10038,0,0,0,0,82
1399,y1203,20110920,10038,10038,9966,10006,9966,10006,9970,-32,-68,30,2991400,78
1400,y1203,20110921,10006,9970,9984,9986,9928,9986,9962,16,-8,10,996200,78
1401,y1203,20110922,9986,9962,0,0,0,9962,9962,0,0,0,0,78
1402,y1203,20110923,9962,9962,9762,9762,9566,9566,9674,-396,-288,12,1161000,86
1403,y1203,20110926,9566,9674,9434,9468,9252,9252,9392,-422,-282,26,2442000,84
1404,y1203,20110927,9252,9392,9288,9330,9288,9330,9308,-62,-84,12,1117000,82
1405,y1203,20110928,9330,9308,9270,9270,9146,9178,9184,-130,-124,8,734800,88
1406,y1203,20110929,9178,9184,9100,9100,8938,8990,8994,-194,-190,16,1439240,84
1407,y1203,20110930,8990,8994,9152,9152,9152,9152,9152,158,158,4,366080,84
1408,y1203,20111010,9152,9152,9028,9028,8962,8962,8994,-190,-158,8,719600,84
1409,y1203,20111011,8962,8994,0,0,0,8994,8994,0,0,0,0,84
1410,y1203,20111012,8994,8994,9150,9162,9108,9108,9140,114,146,6,548400,86
1411,y1203,20111013,9108,9140,9194,9194,9138,9138,9166,-2,26,4,366640,88
1412,y1203,20111014,9138,9166,0,0,0,9166,9166,0,0,0,0,88
1413,y1203,20111017,9166,9166,9266,9266,9266,9266,9266,100,100,2,185320,88
1414,y1203,20111018,9266,9266,9248,9248,9028,9028,9116,-238,-150,8,729360,90
1415,y1203,20111019,9028,9116,9108,9110,9108,9110,9108,-6,-8,4,364360,90
1416,y1203,20111020,9110,9108,9010,9010,8768,8866,8870,-242,-238,10,887040,92
1417,y1203,20111021,8866,8870,8980,8994,8980,8994,8986,124,116,4,359480,92
1418,y1203,20111024,8994,8986,9130,9142,9130,9142,9138,156,152,8,731080,94
1419,y1203,20111025,9142,9138,9192,9192,9190,9190,9190,52,52,12,1102920,98
1420,y1203,20111026,9190,9190,9142,9142,9142,9142,9142,-48,-48,6,548520,94
1421,y1203,20111027,9142,9142,9236,9266,9206,9266,9242,124,100,46,4251600,84
1422,y1203,20111028,9266,9242,9262,9374,9230,9230,9300,-12,58,42,3906400,90
1423,y1203,20111031,9230,9300,9268,9268,9034,9110,9120,-190,-180,18,1641840,84
1424,y1203,20111101,9110,9120,9150,9186,9150,9186,9168,66,48,4,366720,84
1425,y1203,20111102,9186,9168,0,0,0,9168,9168,0,0,0,0,84
1426,y1203,20111103,9168,9168,0,0,0,9168,9168,0,0,0,0,84
1427,y1203,20111104,9168,9168,9194,9268,9166,9166,9204,-2,36,10,920400,86
1428,y1203,20111107,9166,9204,9198,9198,9092,9160,9148,-44,-56,16,1463880,86
1429,y1203,20111108,9160,9148,9118,9118,9044,9044,9078,-104,-70,8,726320,84
1430,y1203,20111109,9044,9078,9178,9180,9102,9158,9154,80,76,8,732360,88
1431,y1203,20111110,9158,9154,8912,8998,8912,8984,8956,-170,-198,32,2866520,94
1432,y1203,20111111,8984,8956,9144,9144,8952,9040,9034,84,78,40,3614200,90
1433,y1203,20111114,9040,9034,9130,9190,9130,9162,9158,128,124,20,1831760,88
1434,y1203,20111115,9162,9158,9158,9158,9158,9158,9158,0,0,6,549480,86
1435,y1203,20111116,9158,9158,9262,9262,9124,9124,9220,-34,62,12,1106400,92
1436,y1203,20111117,9124,9220,0,0,0,9220,9220,0,0,0,0,92
1437,y1203,20111118,9220,9220,0,0,0,9220,9220,0,0,0,0,92
1438,y1203,20111121,9220,9220,9022,9076,9022,9076,9034,-144,-186,8,722840,86
1439,y1203,20111122,9076,9034,8958,8978,8930,8968,8948,-66,-86,36,3221480,72
1440,y1203,20111123,8968,8948,8876,8900,8768,8768,8866,-180,-82,44,3901080,74
1441,y1203,20111124,8768,8866,8716,8736,8570,8632,8642,-234,-224,14,1210120,70
1442,y1203,20111125,8632,8642,8554,8554,8526,8528,8542,-114,-100,10,854240,66
1443,y1203,20111128,8528,8542,8528,8630,8528,8604,8588,62,46,10,858800,62
1444,y1203,20111129,8604,8588,8620,8620,8620,8620,8620,32,32,2,172400,62
1445,y1203,20111130,8620,8620,8680,8680,8584,8584,8626,-36,6,20,1725400,64
1446,y1203,20111201,8584,8626,8584,8778,8584,8778,8726,152,100,24,2094520,66
1447,y1203,20111202,8778,8726,0,0,0,8726,8726,0,0,0,0,66
1448,y1203,20111205,8726,8726,8778,8818,8750,8798,8778,72,52,24,2106760,56
1449,y1203,20111206,8798,8778,8798,8890,8682,8690,8796,-88,18,110,9677520,94
1450,y1203,20111207,8690,8796,8720,8752,8720,8752,8724,-44,-72,24,2094160,80
1451,y1203,20111208,8752,8724,8676,8676,8660,8660,8668,-64,-56,6,520080,78
1452,y1203,20111209,8660,8668,8668,8686,8662,8674,8674,6,6,16,1387880,72
1453,y1203,20111212,8674,8674,8638,8652,8536,8566,8590,-108,-84,26,2233480,76
1454,y1203,20111213,8566,8590,8548,8584,8548,8550,8558,-40,-32,8,684680,78
1455,y1203,20111214,8550,8558,0,0,0,8558,8558,0,0,0,0,78
1456,y1203,20111215,8558,8558,8458,8464,8458,8464,8460,-94,-98,4,338440,78
1457,y1203,20111216,8464,8460,8512,8512,8512,8512,8512,52,52,4,340480,74
1458,y1203,20111219,8512,8512,8568,8568,8568,8568,8568,56,56,2,171360,74
1459,y1203,20111220,8568,8568,0,0,0,8568,8568,0,0,0,0,74
1460,y1203,20111221,8568,8568,8616,8616,8568,8568,8592,0,24,4,343680,72
1461,y1203,20111222,8568,8592,0,0,0,8592,8592,0,0,0,0,72
1462,y1203,20111223,8592,8592,8650,8652,8650,8650,8650,58,58,12,1038040,66
1463,y1203,20111226,8650,8650,8650,8650,8650,8650,8650,0,0,4,346000,66
1464,y1203,20111227,8650,8650,0,0,0,8650,8650,0,0,0,0,66
1465,y1203,20111228,8650,8650,8658,8710,8658,8708,8692,58,42,20,1738720,64
1466,y1203,20111229,8708,8692,8694,8694,8692,8692,8692,0,0,10,869280,66
1467,y1203,20111230,8692,8692,8716,8720,8716,8720,8718,28,26,14,1220520,66
1468,y1205,20110518,9918,9888,9950,10000,9950,9960,9982,72,94,7816,780237200,10566
1469,y1205,20110519,9960,9982,10056,10088,10010,10026,10028,44,46,9460,948764200,16132
1470,y1205,20110520,10026,10028,10062,10104,10028,10102,10062,74,34,8646,869964800,19630
1471,y1205,20110523,10102,10062,10152,10152,10054,10064,10102,2,40,10322,1042804600,24294
1472,y1205,20110524,10064,10102,10080,10160,10062,10148,10086,46,-16,9010,908914000,27016
1473,y1205,20110525,10148,10086,10122,10138,10086,10106,10108,20,22,8390,848211240,30352
1474,y1205,20110526,10106,10108,10198,10234,10170,10234,10196,126,88,10128,1032707920,36128
1475,y1205,20110527,10234,10196,10280,10280,10232,10272,10254,76,58,26630,2730837600,48732
1476,y1205,20110530,10272,10254,10260,10382,10252,10322,10328,68,74,31484,3251999280,60602
1477,y1205,20110531,10322,10328,10338,10344,10268,10292,10298,-36,-30,35376,3643030480,71968
1478,y1205,20110601,10292,10298,10310,10326,10256,10268,10288,-30,-10,25948,2669973960,81348
1479,y1205,20110602,10268,10288,10268,10320,10244,10320,10270,32,-18,28870,2965267760,87736
1480,y1205,20110603,10320,10270,10396,10494,10358,10488,10406,218,136,48632,5061245240,100898
1481,y1205,20110607,10488,10406,10410,10410,10330,10400,10370,-6,-36,62542,6485840080,129322
1482,y1205,20110608,10400,10370,10400,10426,10318,10330,10366,-40,-4,103148,10693220960,162620
1483,y1205,20110609,10330,10366,10370,10396,10324,10324,10364,-42,-2,47608,4934807880,166756
1484,y1205,20110610,10324,10364,10298,10324,10224,10246,10286,-118,-78,63222,6503584760,176136
1485,y1205,20110613,10246,10286,10200,10264,10200,10246,10242,-40,-44,40862,4185858720,178084
1486,y1205,20110614,10246,10242,10252,10288,10226,10268,10258,26,16,44126,4526581840,189274
1487,y1205,20110615,10268,10258,10278,10308,10238,10284,10268,26,10,42754,4390536120,193410
1488,y1205,20110616,10284,10268,10260,10260,10150,10164,10206,-104,-62,41510,4237300840,194504
1489,y1205,20110617,10164,10206,10168,10176,10060,10118,10134,-88,-72,36454,3694530440,193836
1490,y1205,20110620,10118,10134,10098,10148,10068,10104,10114,-30,-20,33258,3363901320,196772
1491,y1205,20110621,10104,10114,10150,10208,10132,10202,10170,88,56,55088,5602462120,210194
1492,y1205,20110622,10202,10170,10200,10214,10134,10144,10174,-26,4,69236,7045113560,227144
1493,y1205,20110623,10144,10174,10100,10110,10010,10092,10068,-82,-106,77828,7836836240,241246
1494,y1205,20110624,10092,10068,10010,10094,10010,10058,10064,-10,-4,64120,6453384520,250864
1495,y1205,20110627,10058,10064,9998,10014,9832,9834,9908,-230,-156,96516,9563336680,248752
1496,y1205,20110628,9834,9908,9900,9916,9842,9850,9886,-58,-22,61174,6048878840,246106
1497,y1205,20110629,9850,9886,9902,9946,9902,9916,9924,30,38,46828,4647217120,245974
1498,y1205,20110630,9916,9924,9936,10002,9922,10000,9970,76,46,43946,4381961480,248112
1499,y1205,20110701,10000,9970,9898,9900,9832,9892,9876,-78,-94,81170,8017495640,252660
1500,y1205,20110704,9892,9876,9910,10052,9910,10030,9992,154,116,92418,9235371960,264008
1501,y1205,20110705,10030,9992,10014,10048,9972,9982,10004,-10,12,115042,11508860720,290410
1502,y1205,20110706,9982,10004,9996,10018,9948,9970,9980,-34,-24,125346,12510910920,323390
1503,y1205,20110707,9970,9980,9996,10048,9962,10040,9998,60,18,130088,13007340760,355746
1504,y1205,20110708,10040,9998,10128,10204,10118,10172,10162,174,164,241362,24529568120,392462
1505,y1205,20110711,10172,10162,10162,10248,10156,10206,10218,44,56,287408,29368187800,441890
1506,y1205,20110712,10206,10218,10184,10234,10094,10158,10158,-60,-60,372328,37822191440,476686
1507,y1205,20110713,10158,10158,10240,10318,10220,10304,10274,146,116,395808,40672954680,521774
1508,y1205,20110714,10304,10274,10378,10384,10306,10362,10346,88,72,424464,43922208880,576794
1509,y1205,20110715,10362,10346,10302,10362,10280,10344,10326,-2,-20,358494,37025061800,589434
1510,y1205,20110718,10344,10326,10350,10376,10252,10268,10328,-58,2,382530,39512473920,604720
1511,y1205,20110719,10268,10328,10308,10334,10264,10320,10292,-8,-36,344738,35485637080,614632
1512,y1205,20110720,10320,10292,10300,10408,10262,10360,10348,68,56,667882,69119682640,660822
1513,y1205,20110721,10360,10348,10330,10406,10324,10362,10362,14,14,591086,61254536880,696120
1514,y1205,20110722,10362,10362,10342,10378,10336,10366,10358,4,-4,287304,29762265560,707922
1515,y1205,20110725,10366,10358,10320,10326,10190,10194,10252,-164,-106,434266,44526241960,682754
1516,y1205,20110726,10194,10252,10208,10274,10202,10268,10240,16,-12,257462,26368840000,677462
1517,y1205,20110727,10268,10240,10308,10342,10294,10310,10314,70,74,310320,32012360960,678730
1518,y1205,20110728,10310,10314,10288,10288,10222,10242,10258,-72,-56,296280,30393127840,676162
1519,y1205,20110729,10242,10258,10198,10324,10168,10204,10258,-54,0,654402,67133260200,691092
1520,y1205,20110801,10204,10258,10260,10350,10250,10340,10290,82,32,439078,45185713040,745398
1521,y1205,20110802,10340,10290,10310,10398,10310,10330,10354,40,64,508362,52641160560,758578
1522,y1205,20110803,10330,10354,10400,10404,10354,10360,10376,6,22,357004,37043259920,748724
1523,y1205,20110804,10360,10376,10326,10344,10246,10278,10292,-98,-84,349896,36017359040,728228
1524,y1205,20110805,10278,10292,10060,10100,9926,10022,10024,-270,-268,678044,67978482520,668110
1525,y1205,20110808,10022,10024,9970,10064,9950,10010,10016,-14,-8,481206,48203101920,684178
1526,y1205,20110809,10010,10016,9790,9870,9626,9830,9760,-186,-256,658888,64317500000,652824
1527,y1205,20110810,9830,9760,9894,9942,9864,9896,9906,136,146,400714,39701470160,650810
1528,y1205,20110811,9896,9906,9834,9976,9834,9970,9916,64,10,556816,55222954040,716914
1529,y1205,20110812,9970,9916,10052,10076,9958,9968,10012,52,96,368392,36886473720,702814
1530,y1205,20110815,9968,10012,10052,10084,10032,10052,10056,40,44,331024,33293015480,698978
1531,y1205,20110816,10052,10056,10084,10090,9982,9994,10034,-62,-22,401990,40343119280,690972
1532,y1205,20110817,9994,10034,10028,10086,10020,10062,10054,28,20,365928,36797103120,680154
1533,y1205,20110818,10062,10054,10110,10116,10046,10066,10074,12,20,251154,25304598400,655252
1534,y1205,20110819,10066,10074,10012,10030,9966,10020,10004,-54,-70,322056,32220639880,649738
1535,y1205,20110822,10020,10004,10078,10100,10026,10036,10068,32,64,279622,28154201120,633926
1536,y1205,20110823,10036,10068,10092,10178,10072,10176,10128,108,60,450196,45600526160,662358
1537,y1205,20110824,10176,10128,10164,10202,10134,10162,10168,34,40,401224,40802688120,654912
1538,y1205,20110825,10162,10168,10162,10182,10116,10130,10138,-38,-30,262738,26640496760,646756
1539,y1205,20110826,10130,10138,10138,10170,10088,10120,10126,-18,-12,355228,35975153360,645072
1540,y1205,20110829,10120,10126,10290,10348,10254,10334,10290,208,164,491160,50540757920,664456
1541,y1205,20110830,10334,10290,10382,10426,10350,10378,10382,88,92,506464,52590998400,656314
1542,y1205,20110831,10378,10382,10400,10512,10390,10458,10468,76,86,846360,88597140320,706824
1543,y1205,20110901,10458,10468,10460,10476,10416,10436,10448,-32,-20,394462,41215222000,687382
1544,y1205,20110902,10436,10448,10400,10488,10396,10486,10454,38,6,681444,71242749040,751224
1545,y1205,20110905,10486,10454,10460,10566,10390,10426,10488,-28,34,889252,93268633640,744254
1546,y1205,20110906,10426,10488,10400,10430,10296,10380,10358,-108,-130,659984,68373075280,738648
1547,y1205,20110907,10380,10358,10400,10494,10384,10490,10434,132,76,590186,61581667720,808682
1548,y1205,20110908,10490,10434,10478,10506,10416,10470,10460,36,26,582368,60916685760,799036
1549,y1205,20110909,10470,10460,10460,10502,10442,10496,10474,36,14,508286,53240124440,812160
1550,y1205,20110913,10496,10474,10392,10402,10312,10322,10348,-152,-126,473598,49010173720,770092
1551,y1205,20110914,10322,10348,10350,10358,10192,10228,10270,-120,-78,567028,58243426960,740808
1552,y1205,20110915,10228,10270,10258,10268,10198,10228,10242,-42,-28,380392,38966435480,724434
1553,y1205,20110916,10228,10242,10154,10206,10138,10194,10176,-48,-66,439440,44725322520,740452
1554,y1205,20110919,10194,10176,10116,10146,10044,10048,10092,-128,-84,400036,40379188800,696176
1555,y1205,20110920,10048,10092,10070,10138,10056,10120,10108,28,16,373816,37788297200,697542
1556,y1205,20110921,10120,10108,10086,10124,10020,10094,10080,-14,-28,414308,41767462240,690518
1557,y1205,20110922,10094,10080,9900,9976,9860,9904,9928,-176,-152,453168,44993949400,652544
1558,y1205,20110923,9904,9928,9768,9818,9432,9566,9640,-362,-288,824628,79504428880,631726
1559,y1205,20110926,9566,9640,9544,9592,9168,9224,9404,-416,-236,776566,73041654800,583372
1560,y1205,20110927,9224,9404,9448,9494,9380,9468,9454,64,50,448738,42425549360,568892
1561,y1205,20110928,9468,9454,9400,9422,9288,9338,9358,-116,-96,475728,44525891360,551742
1562,y1205,20110929,9338,9358,9002,9184,8970,9160,9100,-198,-258,429640,39098694960,502396
1563,y1205,20110930,9160,9100,9220,9402,9200,9390,9320,290,220,347876,32426968560,508338
1564,y1205,20111010,9390,9320,9150,9206,9110,9130,9160,-190,-160,489198,44817404080,536898
1565,y1205,20111011,9130,9160,9180,9238,9090,9094,9172,-66,12,443120,40647781600,570754
1566,y1205,20111012,9094,9172,9240,9328,9182,9296,9266,124,94,592306,54891093360,542542
1567,y1205,20111013,9296,9266,9256,9326,9256,9316,9300,50,34,390766,36343286320,542718
1568,y1205,20111014,9316,9300,9370,9396,9344,9376,9364,76,64,319306,29903705760,526994
1569,y1205,20111017,9376,9364,9450,9460,9398,9402,9422,38,58,347972,32791115000,529242
1570,y1205,20111018,9402,9422,9356,9356,9198,9218,9268,-204,-154,333844,30943025760,533042
1571,y1205,20111019,9218,9268,9278,9316,9222,9250,9276,-18,8,362344,33616257000,521104
1572,y1205,20111020,9250,9276,9096,9096,8962,9066,9034,-210,-242,668832,60423568880,534802
1573,y1205,20111021,9066,9034,9126,9192,9116,9190,9152,156,118,360852,33030102880,514858
1574,y1205,20111024,9190,9152,9182,9388,9126,9292,9242,140,90,664136,61389188360,521954
1575,y1205,20111025,9292,9242,9300,9384,9266,9316,9318,74,76,546740,50953919720,520678
1576,y1205,20111026,9316,9318,9230,9308,9218,9290,9260,-28,-58,393530,36443275040,503508
1577,y1205,20111027,9290,9260,9254,9414,9240,9406,9350,146,90,674104,63033784560,564618
1578,y1205,20111028,9406,9350,9480,9498,9326,9336,9396,-14,46,488008,45858960160,533374
1579,y1205,20111031,9336,9396,9332,9340,9172,9196,9240,-200,-156,430532,39785911680,505694
1580,y1205,20111101,9196,9240,9220,9264,9166,9172,9216,-68,-24,400718,36935235080,497144
1581,y1205,20111102,9172,9216,9136,9274,9100,9268,9164,52,-52,454354,41639138240,469516
1582,y1205,20111103,9268,9164,9180,9222,9150,9152,9182,-12,18,326222,29957702400,473222
1583,y1205,20111104,9152,9182,9274,9316,9248,9280,9278,98,96,352060,32667094560,444748
1584,y1205,20111107,9280,9278,9270,9278,9164,9188,9194,-90,-84,258342,23755997360,435902
1585,y1205,20111108,9188,9194,9172,9198,9110,9156,9158,-38,-36,323556,29636257640,445538
1586,y1205,20111109,9156,9158,9200,9242,9158,9170,9200,12,42,304876,28054262040,436490
1587,y1205,20111110,9170,9200,9050,9066,8940,9028,9016,-172,-184,494126,44557990640,434806
1588,y1205,20111111,9028,9016,9050,9134,9024,9104,9072,88,56,309656,28095769520,435332
1589,y1205,20111114,9104,9072,9170,9242,9156,9210,9202,138,130,304126,27988963280,433346
1590,y1205,20111115,9210,9202,9172,9238,9148,9218,9202,16,0,274334,25247153800,431460
1591,y1205,20111116,9218,9202,9316,9318,9166,9188,9228,-14,26,294306,27161101600,420664
1592,y1205,20111117,9188,9228,9210,9282,9156,9252,9230,24,2,282482,26074390400,422584
1593,y1205,20111118,9252,9230,9118,9148,9066,9140,9126,-90,-104,219292,20015198000,407104
1594,y1205,20111121,9140,9126,9098,9124,9058,9098,9100,-28,-26,174222,15855710920,408134
1595,y1205,20111122,9098,9100,9060,9060,8956,8966,9014,-134,-86,349240,31482398600,436686
1596,y1205,20111123,8966,9014,9018,9024,8852,8876,8938,-138,-76,451500,40360901560,450982
1597,y1205,20111124,8876,8938,8822,8846,8618,8676,8710,-262,-228,616770,53722648080,454264
1598,y1205,20111125,8676,8710,8652,8708,8580,8606,8646,-104,-64,580580,50200660440,453362
1599,y1205,20111128,8606,8646,8662,8708,8628,8672,8674,26,28,408814,35466590280,430220
1600,y1205,20111129,8672,8674,8692,8718,8632,8702,8674,28,0,344326,29867643360,418020
1601,y1205,20111130,8702,8674,8734,8736,8586,8596,8658,-78,-16,386942,33506249480,410506
1602,y1205,20111201,8596,8658,8778,8872,8756,8834,8810,176,152,452480,39872370320,354480
1603,y1205,20111202,8834,8810,8800,8840,8784,8820,8810,10,0,279726,24647568000,354718
1604,y1205,20111205,8820,8810,8852,8890,8836,8862,8866,52,56,195954,17373922600,347554
1605,y1205,20111206,8862,8866,8840,8840,8782,8818,8810,-48,-56,150650,13273741160,342258
1606,y1205,20111207,8818,8810,8840,8860,8794,8848,8836,38,26,126588,11185920720,342432
1607,y1205,20111208,8848,8836,8840,8840,8726,8782,8770,-54,-66,284660,24967812800,351378
1608,y1205,20111209,8782,8770,8770,8816,8748,8782,8788,12,18,152186,13376564920,344604
1609,y1205,20111212,8782,8788,8726,8734,8662,8668,8698,-120,-90,157094,13666064080,339992
1610,y1205,20111213,8668,8698,8670,8718,8670,8680,8696,-18,-2,119564,10398770640,327014
1611,y1205,20111214,8680,8696,8688,8706,8654,8684,8682,-12,-14,72456,6291768440,319206
1612,y1205,20111215,8684,8682,8590,8654,8576,8638,8612,-44,-70,126070,10859485200,307014
1613,y1205,20111216,8638,8612,8652,8688,8642,8686,8668,74,56,77102,6684101040,304610
1614,y1205,20111219,8686,8668,8744,8746,8694,8744,8724,76,56,83994,7329071240,284450
1615,y1205,20111220,8744,8724,8734,8744,8700,8716,8722,-8,-2,58698,5119995440,276322
1616,y1205,20111221,8716,8722,8740,8762,8730,8744,8744,22,22,37874,3312321040,270014
1617,y1205,20111222,8744,8744,8754,8786,8742,8774,8762,30,18,52996,4643920960,259180
1618,y1205,20111223,8774,8762,8822,8848,8796,8834,8826,72,64,40194,3548308280,253312
1619,y1205,20111226,8834,8826,8866,8886,8812,8822,8842,-4,16,29406,2600592520,246940
1620,y1205,20111227,8822,8842,8820,8830,8770,8788,8804,-54,-38,26244,2310779800,238704
1621,y1205,20111228,8788,8804,8880,8912,8846,8900,8884,96,80,58014,5154914240,225432
1622,y1205,20111229,8900,8884,8894,8900,8866,8886,8884,2,0,20942,1860724000,218900
1623,y1205,20111230,8886,8884,8876,8910,8870,8908,8892,24,8,31780,2826023120,213648
1624,y1207,20110718,10410,10472,10452,10592,10428,10428,10504,-44,32,242,25422280,6
1625,y1207,20110719,10428,10504,10358,10358,10358,10358,10358,-146,-146,2,207160,6
1626,y1207,20110720,10358,10358,10516,10516,10400,10420,10446,62,88,28,2925200,4
1627,y1207,20110721,10420,10446,0,0,0,10446,10446,0,0,0,0,4
1628,y1207,20110722,10446,10446,0,0,0,10446,10446,0,0,0,0,4
1629,y1207,20110725,10446,10446,10376,10376,10238,10238,10306,-208,-140,4,412280,4
1630,y1207,20110726,10238,10306,0,0,0,10306,10306,0,0,0,0,4
1631,y1207,20110727,10306,10306,0,0,0,10306,10306,0,0,0,0,4
1632,y1207,20110728,10306,10306,0,0,0,10306,10306,0,0,0,0,4
1633,y1207,20110729,10306,10306,0,0,0,10306,10306,0,0,0,0,4
1634,y1207,20110801,10306,10306,0,0,0,10306,10306,0,0,0,0,4
1635,y1207,20110802,10306,10306,10456,10456,10330,10442,10402,136,96,14,1456360,8
1636,y1207,20110803,10442,10402,10390,10410,10390,10410,10400,8,-2,4,416000,6
1637,y1207,20110804,10410,10400,0,0,0,10400,10400,0,0,0,0,6
1638,y1207,20110805,10400,10400,10030,10154,10030,10044,10108,-356,-292,18,1819560,10
1639,y1207,20110808,10044,10108,10140,10140,10044,10044,10098,-64,-10,12,1211760,10
1640,y1207,20110809,10044,10098,9690,9918,9690,9918,9842,-180,-256,6,590520,12
1641,y1207,20110810,9918,9842,9940,9940,9940,9940,9940,98,98,4,397600,12
1642,y1207,20110811,9940,9940,9950,10020,9950,10020,9950,80,10,102,10150400,108
1643,y1207,20110812,10020,9950,9976,10184,9976,10078,10112,128,162,78,7888120,44
1644,y1207,20110815,10078,10112,0,0,0,10112,10112,0,0,0,0,44
1645,y1207,20110816,10112,10112,0,0,0,10112,10112,0,0,0,0,44
1646,y1207,20110817,10112,10112,0,0,0,10112,10112,0,0,0,0,44
1647,y1207,20110818,10112,10112,0,0,0,10112,10112,0,0,0,0,44
1648,y1207,20110819,10112,10112,0,0,0,10112,10112,0,0,0,0,44
1649,y1207,20110822,10112,10112,10100,10184,10092,10152,10132,40,20,8,810560,46
1650,y1207,20110823,10152,10132,0,0,0,10132,10132,0,0,0,0,46
1651,y1207,20110824,10132,10132,0,0,0,10132,10132,0,0,0,0,46
1652,y1207,20110825,10132,10132,10180,10212,10180,10212,10196,80,64,4,407840,46
1653,y1207,20110826,10212,10196,0,0,0,10196,10196,0,0,0,0,46
1654,y1207,20110829,10196,10196,0,0,0,10196,10196,0,0,0,0,46
1655,y1207,20110830,10196,10196,0,0,0,10196,10196,0,0,0,0,46
1656,y1207,20110831,10196,10196,10560,10560,10510,10510,10534,314,338,4,421400,44
1657,y1207,20110901,10510,10534,10490,10520,10490,10520,10496,-14,-38,10,1049600,38
1658,y1207,20110902,10520,10496,10462,10510,10462,10502,10484,6,-12,8,838720,38
1659,y1207,20110905,10502,10484,10496,10496,10496,10496,10496,12,12,2,209920,40
1660,y1207,20110906,10496,10496,10428,10428,10336,10336,10382,-160,-114,20,2076400,40
1661,y1207,20110907,10336,10382,10540,10540,10540,10540,10540,158,158,2,210800,38
1662,y1207,20110908,10540,10540,10518,10518,10434,10472,10488,-68,-52,430,45101080,178
1663,y1207,20110909,10472,10488,10480,10510,10480,10510,10490,22,2,18,1888400,178
1664,y1207,20110913,10510,10490,10360,10370,10334,10334,10338,-156,-152,52,5376240,142
1665,y1207,20110914,10334,10338,10298,10300,10222,10222,10272,-116,-66,6,616400,140
1666,y1207,20110915,10222,10272,0,0,0,10272,10272,0,0,0,0,140
1667,y1207,20110916,10272,10272,0,0,0,10272,10272,0,0,0,0,140
1668,y1207,20110919,10272,10272,10052,10088,10052,10088,10076,-184,-196,6,604560,140
1669,y1207,20110920,10088,10076,0,0,0,10076,10076,0,0,0,0,140
1670,y1207,20110921,10076,10076,9994,10104,9914,10104,10034,28,-42,32,3211360,142
1671,y1207,20110922,10104,10034,0,0,0,10034,10034,0,0,0,0,142
1672,y1207,20110923,10034,10034,9790,9804,9598,9598,9664,-436,-370,20,1932920,144
1673,y1207,20110926,9598,9664,9586,9586,9262,9262,9342,-402,-322,84,7847560,130
1674,y1207,20110927,9262,9342,9466,9466,9354,9354,9424,12,82,26,2450360,130
1675,y1207,20110928,9354,9424,9310,9392,9310,9392,9350,-32,-74,8,748080,132
1676,y1207,20110929,9392,9350,9070,9070,9002,9060,9046,-290,-304,10,904680,130
1677,y1207,20110930,9060,9046,9244,9316,9244,9316,9270,270,224,12,1112480,130
1678,y1207,20111010,9316,9270,9200,9200,9086,9130,9128,-140,-142,56,5111960,138
1679,y1207,20111011,9130,9128,9164,9168,9118,9118,9160,-10,32,18,1648920,138
1680,y1207,20111012,9118,9160,9204,9276,9204,9276,9248,116,88,10,924920,138
1681,y1207,20111013,9276,9248,9246,9288,9246,9270,9272,22,24,14,1298240,136
1682,y1207,20111014,9270,9272,9304,9318,9288,9318,9300,46,28,18,1674200,134
1683,y1207,20111017,9318,9300,9318,9370,9318,9332,9344,32,44,10,934480,134
1684,y1207,20111018,9332,9344,9248,9248,9248,9248,9248,-96,-96,2,184960,132
1685,y1207,20111019,9248,9248,9188,9198,9188,9198,9196,-50,-52,48,4414640,154
1686,y1207,20111020,9198,9196,8980,9002,8978,8978,8992,-218,-204,20,1798520,148
1687,y1207,20111021,8978,8992,9146,9156,9136,9156,9150,164,158,12,1098040,150
1688,y1207,20111024,9156,9150,9136,9240,9134,9240,9188,90,38,56,5145800,162
1689,y1207,20111025,9240,9188,0,0,0,9188,9188,0,0,0,0,162
1690,y1207,20111026,9188,9188,9230,9272,9210,9232,9232,44,44,24,2215760,156
1691,y1207,20111027,9232,9232,9356,9356,9248,9350,9326,118,94,8,746200,154
1692,y1207,20111028,9350,9326,9386,9458,9348,9348,9402,22,76,10,940320,154
1693,y1207,20111031,9348,9402,9180,9238,9108,9238,9184,-164,-218,116,10653760,148
1694,y1207,20111101,9238,9184,0,0,0,9184,9184,0,0,0,0,148
1695,y1207,20111102,9184,9184,9180,9180,9134,9134,9148,-50,-36,10,914960,146
1696,y1207,20111103,9134,9148,9240,9240,9190,9204,9208,56,60,8,736760,146
1697,y1207,20111104,9204,9208,0,0,0,9208,9208,0,0,0,0,146
1698,y1207,20111107,9208,9208,9298,9298,9212,9212,9282,4,74,130,12066880,220
1699,y1207,20111108,9212,9282,0,0,0,9282,9282,0,0,0,0,220
1700,y1207,20111109,9282,9282,9210,9210,9192,9204,9200,-78,-82,22,2024400,214
1701,y1207,20111110,9204,9200,0,0,0,9200,9200,0,0,0,0,214
1702,y1207,20111111,9200,9200,9030,9096,9030,9096,9062,-104,-138,4,362520,214
1703,y1207,20111114,9096,9062,9216,9238,9216,9238,9226,176,164,4,369080,214
1704,y1207,20111115,9238,9226,0,0,0,9226,9226,0,0,0,0,214
1705,y1207,20111116,9226,9226,9296,9296,9296,9296,9296,70,70,2,185920,214
1706,y1207,20111117,9296,9296,9218,9264,9218,9222,9234,-74,-62,6,554080,216
1707,y1207,20111118,9222,9234,9100,9100,9100,9100,9100,-134,-134,2,182000,216
1708,y1207,20111121,9100,9100,9148,9148,9090,9090,9118,-10,18,4,364760,214
1709,y1207,20111122,9090,9118,0,0,0,9118,9118,0,0,0,0,214
1710,y1207,20111123,9118,9118,0,0,0,9118,9118,0,0,0,0,214
1711,y1207,20111124,9118,9118,8664,8672,8664,8672,8666,-446,-452,6,520000,212
1712,y1207,20111125,8672,8666,8698,8698,8662,8662,8680,-4,14,4,347200,210
1713,y1207,20111128,8662,8680,8670,8700,8670,8700,8698,20,18,34,2957400,180
1714,y1207,20111129,8700,8698,8686,8686,8686,8686,8686,-12,-12,4,347440,180
1715,y1207,20111130,8686,8686,8706,8706,8706,8706,8706,20,20,2,174120,178
1716,y1207,20111201,8706,8706,8804,8804,8780,8780,8788,74,82,6,527280,176
1717,y1207,20111202,8780,8788,0,0,0,8788,8788,0,0,0,0,176
1718,y1207,20111205,8788,8788,8876,8876,8876,8876,8876,88,88,2,177520,176
1719,y1207,20111206,8876,8876,0,0,0,8876,8876,0,0,0,0,176
1720,y1207,20111207,8876,8876,0,0,0,8876,8876,0,0,0,0,176
1721,y1207,20111208,8876,8876,0,0,0,8876,8876,0,0,0,0,176
1722,y1207,20111209,8876,8876,0,0,0,8876,8876,0,0,0,0,176
1723,y1207,20111212,8876,8876,0,0,0,8876,8876,0,0,0,0,176
1724,y1207,20111213,8876,8876,8662,8760,8658,8674,8698,-202,-178,28,2435520,170
1725,y1207,20111214,8674,8698,0,0,0,8698,8698,0,0,0,0,170
1726,y1207,20111215,8698,8698,8650,8650,8650,8650,8650,-48,-48,4,346000,168
1727,y1207,20111216,8650,8650,8688,8724,8684,8684,8688,34,38,38,3301520,150
1728,y1207,20111219,8684,8688,8732,8732,8730,8730,8730,42,42,24,2095320,144
1729,y1207,20111220,8730,8730,8728,8728,8728,8728,8728,-2,-2,4,349120,144
1730,y1207,20111221,8728,8728,8756,8774,8732,8774,8756,46,28,12,1050720,146
1731,y1207,20111222,8774,8756,8766,8766,8766,8766,8766,10,10,2,175320,146
1732,y1207,20111223,8766,8766,8816,8824,8816,8824,8820,58,54,4,352800,144
1733,y1207,20111226,8824,8820,8840,8840,8840,8840,8840,20,20,4,353600,144
1734,y1207,20111227,8840,8840,0,0,0,8840,8840,0,0,0,0,144
1735,y1207,20111228,8840,8840,8876,8888,8876,8888,8884,48,44,6,533040,144
1736,y1207,20111229,8888,8884,0,0,0,8884,8884,0,0,0,0,144
1737,y1207,20111230,8884,8884,8894,8894,8894,8894,8894,10,10,2,177880,144
1738,y1208,20110816,9916,9916,0,0,0,9916,9916,0,0,0,0,0
1739,y1208,20110817,9916,9916,0,0,0,9916,9916,0,0,0,0,0
1740,y1208,20110818,9916,9916,0,0,0,9916,9916,0,0,0,0,0
1741,y1208,20110819,9916,9916,0,0,0,9916,9916,0,0,0,0,0
1742,y1208,20110822,9916,9916,0,0,0,9916,9916,0,0,0,0,0
1743,y1208,20110823,9916,9916,0,0,0,9916,9916,0,0,0,0,0
1744,y1208,20110824,9916,9916,0,0,0,9916,9916,0,0,0,0,0
1745,y1208,20110825,9916,9916,10038,10284,10038,10284,10150,368,234,8,812000,2
1746,y1208,20110826,10284,10150,0,0,0,10150,10150,0,0,0,0,2
1747,y1208,20110829,10150,10150,10390,10390,10388,10388,10388,238,238,12,1246600,12
1748,y1208,20110830,10388,10388,10434,10434,10434,10434,10434,46,46,2,208680,10
1749,y1208,20110831,10434,10434,10600,10600,10600,10600,10600,166,166,2,212000,12
1750,y1208,20110901,10600,10600,10538,10538,10538,10538,10538,-62,-62,6,632280,12
1751,y1208,20110902,10538,10538,0,0,0,10538,10538,0,0,0,0,12
1752,y1208,20110905,10538,10538,10640,10640,10640,10640,10640,102,102,2,212800,12
1753,y1208,20110906,10640,10640,0,0,0,10640,10640,0,0,0,0,12
1754,y1208,20110907,10640,10640,0,0,0,10640,10640,0,0,0,0,12
1755,y1208,20110908,10640,10640,0,0,0,10640,10640,0,0,0,0,12
1756,y1208,20110909,10640,10640,0,0,0,10640,10640,0,0,0,0,12
1757,y1208,20110913,10640,10640,0,0,0,10640,10640,0,0,0,0,12
1758,y1208,20110914,10640,10640,0,0,0,10640,10640,0,0,0,0,12
1759,y1208,20110915,10640,10640,10322,10322,10322,10322,10322,-318,-318,2,206440,14
1760,y1208,20110916,10322,10322,0,0,0,10322,10322,0,0,0,0,14
1761,y1208,20110919,10322,10322,0,0,0,10322,10322,0,0,0,0,14
1762,y1208,20110920,10322,10322,0,0,0,10322,10322,0,0,0,0,14
1763,y1208,20110921,10322,10322,0,0,0,10322,10322,0,0,0,0,14
1764,y1208,20110922,10322,10322,0,0,0,10322,10322,0,0,0,0,14
1765,y1208,20110923,10322,10322,9806,9898,9806,9806,9828,-516,-494,20,1965680,18
1766,y1208,20110926,9806,9828,9558,9560,9500,9560,9554,-268,-274,30,2866760,36
1767,y1208,20110927,9560,9554,9426,9426,9424,9424,9424,-130,-130,28,2638800,36
1768,y1208,20110928,9424,9424,0,0,0,9424,9424,0,0,0,0,36
1769,y1208,20110929,9424,9424,9026,9088,9026,9088,9056,-336,-368,4,362280,32
1770,y1208,20110930,9088,9056,9382,9404,9382,9404,9396,348,340,6,563800,26
1771,y1208,20111010,9404,9396,0,0,0,9396,9396,0,0,0,0,26
1772,y1208,20111011,9396,9396,0,0,0,9396,9396,0,0,0,0,26
1773,y1208,20111012,9396,9396,0,0,0,9396,9396,0,0,0,0,26
1774,y1208,20111013,9396,9396,9194,9194,9194,9194,9194,-202,-202,2,183880,26
1775,y1208,20111014,9194,9194,0,0,0,9194,9194,0,0,0,0,26
1776,y1208,20111017,9194,9194,0,0,0,9194,9194,0,0,0,0,26
1777,y1208,20111018,9194,9194,9370,9370,9370,9370,9370,176,176,2,187400,26
1778,y1208,20111019,9370,9370,0,0,0,9370,9370,0,0,0,0,26
1779,y1208,20111020,9370,9370,0,0,0,9370,9370,0,0,0,0,26
1780,y1208,20111021,9370,9370,0,0,0,9370,9370,0,0,0,0,26
1781,y1208,20111024,9370,9370,0,0,0,9370,9370,0,0,0,0,26
1782,y1208,20111025,9370,9370,0,0,0,9370,9370,0,0,0,0,26
1783,y1208,20111026,9370,9370,0,0,0,9370,9370,0,0,0,0,26
1784,y1208,20111027,9370,9370,9420,9470,9354,9386,9406,16,36,8,752600,26
1785,y1208,20111028,9386,9406,9460,9460,9290,9400,9404,-6,-2,38,3573880,22
1786,y1208,20111031,9400,9404,9258,9258,9220,9220,9238,-184,-166,4,369560,22
1787,y1208,20111101,9220,9238,0,0,0,9238,9238,0,0,0,0,22
1788,y1208,20111102,9238,9238,9218,9218,9164,9164,9190,-74,-48,4,367640,22
1789,y1208,20111103,9164,9190,0,0,0,9190,9190,0,0,0,0,22
1790,y1208,20111104,9190,9190,9340,9380,9268,9286,9312,96,122,26,2421360,22
1791,y1208,20111107,9286,9312,9184,9184,9182,9182,9182,-130,-130,4,367320,20
1792,y1208,20111108,9182,9182,9112,9180,9112,9180,9146,-2,-36,4,365840,24
1793,y1208,20111109,9180,9146,0,0,0,9146,9146,0,0,0,0,24
1794,y1208,20111110,9146,9146,9038,9038,9038,9038,9038,-108,-108,4,361520,20
1795,y1208,20111111,9038,9038,0,0,0,9038,9038,0,0,0,0,20
1796,y1208,20111114,9038,9038,0,0,0,9038,9038,0,0,0,0,20
1797,y1208,20111115,9038,9038,0,0,0,9038,9038,0,0,0,0,20
1798,y1208,20111116,9038,9038,0,0,0,9038,9038,0,0,0,0,20
1799,y1208,20111117,9038,9038,9202,9310,9202,9304,9258,266,220,24,2221920,20
1800,y1208,20111118,9304,9258,0,0,0,9258,9258,0,0,0,0,20
1801,y1208,20111121,9258,9258,9120,9120,9120,9120,9120,-138,-138,2,182400,18
1802,y1208,20111122,9120,9120,9056,9076,9056,9076,9062,-44,-58,6,543760,22
1803,y1208,20111123,9076,9062,0,0,0,9062,9062,0,0,0,0,22
1804,y1208,20111124,9062,9062,0,0,0,9062,9062,0,0,0,0,22
1805,y1208,20111125,9062,9062,0,0,0,9062,9062,0,0,0,0,22
1806,y1208,20111128,9062,9062,8748,8748,8686,8688,8712,-374,-350,16,1394120,26
1807,y1208,20111129,8688,8712,8666,8666,8660,8660,8662,-52,-50,4,346520,22
1808,y1208,20111130,8660,8662,0,0,0,8662,8662,0,0,0,0,22
1809,y1208,20111201,8662,8662,0,0,0,8662,8662,0,0,0,0,22
1810,y1208,20111202,8662,8662,8784,8840,8784,8790,8806,128,144,14,1232880,20
1811,y1208,20111205,8790,8806,8930,8930,8860,8870,8886,64,80,6,533200,20
1812,y1208,20111206,8870,8886,8862,9330,8552,8860,8984,-26,98,490,44022000,24
1813,y1208,20111207,8860,8984,8900,8900,8858,8858,8872,-126,-112,6,532360,26
1814,y1208,20111208,8858,8872,8830,8830,8762,8796,8796,-76,-76,24,2111400,24
1815,y1208,20111209,8796,8796,8814,8814,8796,8796,8806,0,10,8,704560,20
1816,y1208,20111212,8796,8806,0,0,0,8806,8806,0,0,0,0,20
1817,y1208,20111213,8806,8806,8748,8748,8692,8700,8716,-106,-90,132,11505520,18
1818,y1208,20111214,8700,8716,8726,8726,8726,8726,8726,10,10,20,1745200,36
1819,y1208,20111215,8726,8726,8668,8688,8620,8688,8652,-38,-74,8,692200,36
1820,y1208,20111216,8688,8652,8690,8712,8690,8712,8696,60,44,28,2434960,18
1821,y1208,20111219,8712,8696,8722,8760,8722,8760,8746,64,50,8,699760,16
1822,y1208,20111220,8760,8746,0,0,0,8746,8746,0,0,0,0,16
1823,y1208,20111221,8746,8746,0,0,0,8746,8746,0,0,0,0,16
1824,y1208,20111222,8746,8746,8858,8858,8858,8858,8858,112,112,2,177160,18
1825,y1208,20111223,8858,8858,8860,8860,8860,8860,8860,2,2,2,177200,16
1826,y1208,20111226,8860,8860,8896,8906,8840,8840,8870,-20,10,12,1064400,14
1827,y1208,20111227,8840,8870,8840,8840,8798,8800,8812,-70,-58,6,528760,12
1828,y1208,20111228,8800,8812,0,0,0,8812,8812,0,0,0,0,12
1829,y1208,20111229,8812,8812,0,0,0,8812,8812,0,0,0,0,12
1830,y1208,20111230,8812,8812,0,0,0,8812,8812,0,0,0,0,12
1831,y1209,20110919,10218,10202,10184,10184,10014,10030,10106,-172,-96,66604,6731842920,82670
1832,y1209,20110920,10030,10106,10034,10112,10034,10086,10088,-20,-18,46010,4642372360,106240
1833,y1209,20110921,10086,10088,10060,10102,10000,10082,10066,-6,-22,26044,2621600640,115962
1834,y1209,20110922,10082,10066,9936,9982,9852,9896,9920,-170,-146,37722,3742212360,125638
1835,y1209,20110923,9896,9920,9700,9804,9424,9560,9638,-360,-282,52894,5098778840,131184
1836,y1209,20110926,9560,9638,9568,9580,9158,9194,9382,-444,-256,42802,4016531360,134774
1837,y1209,20110927,9194,9382,9400,9480,9372,9454,9434,72,52,30552,2882678680,136716
1838,y1209,20110928,9454,9434,9400,9412,9280,9328,9342,-106,-92,18642,1741741520,135486
1839,y1209,20110929,9328,9342,9088,9158,8960,9142,9090,-200,-252,33614,3055630040,127238
1840,y1209,20110930,9142,9090,9168,9388,9168,9384,9302,294,212,13766,1280528480,126952
1841,y1209,20111010,9384,9302,9098,9196,9098,9122,9150,-180,-152,31612,2893075920,132746
1842,y1209,20111011,9122,9150,9192,9226,9078,9086,9172,-64,22,34650,3178238440,139944
1843,y1209,20111012,9086,9172,9286,9330,9188,9298,9266,126,94,50038,4636878120,149634
1844,y1209,20111013,9298,9266,9302,9330,9262,9304,9292,38,26,35072,3259450120,156290
1845,y1209,20111014,9304,9292,9362,9392,9342,9376,9362,84,70,22972,2150849400,158014
1846,y1209,20111017,9376,9362,9452,9458,9398,9398,9422,36,60,31530,2971130600,160862
1847,y1209,20111018,9398,9422,9300,9348,9198,9210,9262,-212,-160,28170,2609516960,159638
1848,y1209,20111019,9210,9262,9282,9314,9230,9256,9282,-6,20,32022,2972547920,157048
1849,y1209,20111020,9256,9282,9100,9102,8968,9072,9038,-210,-244,54130,4893204160,149020
1850,y1209,20111021,9072,9038,9100,9202,9100,9200,9156,162,118,37192,3405874080,152908
1851,y1209,20111024,9200,9156,9210,9378,9140,9304,9250,148,94,73376,6787396720,165700
1852,y1209,20111025,9304,9250,9302,9386,9274,9318,9324,68,74,56114,5232558840,170298
1853,y1209,20111026,9318,9324,9258,9318,9218,9304,9266,-20,-58,48244,4470365880,173668
1854,y1209,20111027,9304,9266,9266,9448,9252,9442,9372,176,106,104252,9771282240,199666
1855,y1209,20111028,9442,9372,9506,9538,9384,9394,9450,22,78,90196,8524818080,210644
1856,y1209,20111031,9394,9450,9392,9392,9232,9252,9312,-198,-138,71892,6695552760,209448
1857,y1209,20111101,9252,9312,9296,9344,9250,9264,9296,-48,-16,72962,6783238080,214366
1858,y1209,20111102,9264,9296,9206,9378,9204,9376,9266,80,-30,97572,9042045360,227314
1859,y1209,20111103,9376,9266,9288,9326,9238,9242,9284,-24,18,73182,6795579000,222986
1860,y1209,20111104,9242,9284,9370,9414,9352,9384,9378,100,94,71408,6696772720,229836
1861,y1209,20111107,9384,9378,9380,9380,9266,9296,9300,-82,-78,50524,4698978120,227238
1862,y1209,20111108,9296,9300,9230,9318,9220,9270,9268,-30,-32,65524,6072778480,219792
1863,y1209,20111109,9270,9268,9300,9350,9264,9280,9312,12,44,61026,5682941600,220786
1864,y1209,20111110,9280,9312,9100,9168,9038,9126,9112,-186,-200,72220,6581579000,214674
1865,y1209,20111111,9126,9112,9136,9236,9120,9218,9174,106,62,58618,5378410280,206592
1866,y1209,20111114,9218,9174,9290,9376,9270,9338,9324,164,150,86538,8068979680,204984
1867,y1209,20111115,9338,9324,9300,9378,9276,9354,9340,30,16,84048,7850637760,197836
1868,y1209,20111116,9354,9340,9426,9450,9296,9304,9360,-36,20,83520,7818873520,195922
1869,y1209,20111117,9304,9360,9312,9404,9280,9376,9352,16,-8,75220,7034600880,197306
1870,y1209,20111118,9376,9352,9126,9270,9126,9260,9248,-92,-104,65292,6039483520,193266
1871,y1209,20111121,9260,9248,9218,9248,9182,9216,9220,-32,-28,46330,4272414240,200080
1872,y1209,20111122,9216,9220,9130,9176,9018,9048,9106,-172,-114,110258,10041382200,231330
1873,y1209,20111123,9048,9106,9066,9106,8898,8922,8994,-184,-112,153128,13773282320,251938
1874,y1209,20111124,8922,8994,8872,8884,8648,8748,8752,-246,-242,248392,21744142400,258878
1875,y1209,20111125,8748,8752,8700,8768,8650,8684,8716,-68,-36,172572,15043870760,258664
1876,y1209,20111128,8684,8716,8778,8792,8720,8740,8754,24,38,133946,11726498120,259946
1877,y1209,20111129,8740,8754,8740,8778,8694,8766,8738,12,-16,124368,10867757880,264076
1878,y1209,20111130,8766,8738,8792,8796,8608,8618,8684,-120,-54,184762,16047493560,291178
1879,y1209,20111201,8618,8684,8818,8914,8802,8888,8862,204,178,262064,23228360480,276672
1880,y1209,20111202,8888,8862,8862,8898,8844,8888,8874,26,12,172242,15287080800,281280
1881,y1209,20111205,8888,8874,8922,8964,8906,8934,8936,60,62,134950,12061813680,283788
1882,y1209,20111206,8934,8936,8880,8898,8850,8894,8876,-42,-60,124046,11012433600,290516
1883,y1209,20111207,8894,8876,8910,8926,8864,8916,8904,40,28,96776,8617246720,290434
1884,y1209,20111208,8916,8904,8904,8908,8782,8838,8828,-66,-76,290012,25607695480,315862
1885,y1209,20111209,8838,8828,8836,8886,8808,8834,8850,6,22,200010,17701798640,314338
1886,y1209,20111212,8834,8850,8780,8796,8712,8718,8752,-132,-98,277206,24264487000,342444
1887,y1209,20111213,8718,8752,8738,8774,8720,8730,8748,-22,-4,263226,23031630240,344524
1888,y1209,20111214,8730,8748,8730,8760,8714,8746,8742,-2,-6,239142,20906347320,340388
1889,y1209,20111215,8746,8742,8626,8742,8626,8718,8688,-24,-54,365818,31783403200,357578
1890,y1209,20111216,8718,8688,8760,8798,8732,8790,8764,102,76,252956,22173363080,355766
1891,y1209,20111219,8790,8764,8850,8866,8794,8852,8838,88,74,383438,33894213160,365692
1892,y1209,20111220,8852,8838,8848,8852,8802,8812,8826,-26,-12,258142,22785185520,371790
1893,y1209,20111221,8812,8826,8854,8864,8818,8826,8840,0,14,191108,16897549360,374036
1894,y1209,20111222,8826,8840,8848,8896,8834,8876,8868,36,28,310006,27492357600,387980
1895,y1209,20111223,8876,8868,8900,8948,8892,8930,8928,62,60,255240,22789711240,385634
1896,y1209,20111226,8930,8928,8966,8982,8906,8918,8936,-10,8,197708,17671139720,384578
1897,y1209,20111227,8918,8936,8912,8926,8852,8874,8890,-62,-46,237318,21098461120,395664
1898,y1209,20111228,8874,8890,8940,8996,8928,8978,8966,88,76,278992,25017627280,392214
1899,y1209,20111229,8978,8966,8938,8978,8938,8968,8962,2,-4,173922,15588978720,385592
1900,y1209,20111230,8968,8962,8960,8998,8954,8994,8978,32,16,175160,15727114120,381116
1901,y1211,20111116,9172,9172,0,0,0,9172,9172,0,0,0,0,0
1902,y1211,20111117,9172,9172,0,0,0,9172,9172,0,0,0,0,0
1903,y1211,20111118,9172,9172,0,0,0,9172,9172,0,0,0,0,0
1904,y1211,20111121,9172,9172,0,0,0,9172,9172,0,0,0,0,0
1905,y1211,20111122,9172,9172,9200,9200,9078,9078,9108,-94,-64,8,728680,4
1906,y1211,20111123,9078,9108,9128,9128,8910,8930,9014,-178,-94,10,901400,8
1907,y1211,20111124,8930,9014,8920,8958,8712,8712,8878,-302,-136,8,710240,6
1908,y1211,20111125,8712,8878,0,0,0,8878,8878,0,0,0,0,6
1909,y1211,20111128,8878,8878,0,0,0,8878,8878,0,0,0,0,6
1910,y1211,20111129,8878,8878,0,0,0,8878,8878,0,0,0,0,6
1911,y1211,20111130,8878,8878,8748,8748,8722,8722,8734,-156,-144,4,349400,6
1912,y1211,20111201,8722,8734,0,0,0,8734,8734,0,0,0,0,6
1913,y1211,20111202,8734,8734,0,0,0,8734,8734,0,0,0,0,6
1914,y1211,20111205,8734,8734,8960,8960,8960,8960,8960,226,226,2,179200,6
1915,y1211,20111206,8960,8960,8960,8960,8932,8932,8946,-28,-14,4,357840,8
1916,y1211,20111207,8932,8946,8926,8926,8926,8926,8926,-20,-20,2,178520,6
1917,y1211,20111208,8926,8926,0,0,0,8926,8926,0,0,0,0,6
1918,y1211,20111209,8926,8926,0,0,0,8926,8926,0,0,0,0,6
1919,y1211,20111212,8926,8926,8860,8860,8860,8860,8860,-66,-66,2,177200,8
1920,y1211,20111213,8860,8860,0,0,0,8860,8860,0,0,0,0,8
1921,y1211,20111214,8860,8860,0,0,0,8860,8860,0,0,0,0,8
1922,y1211,20111215,8860,8860,8670,8798,8670,8794,8744,-66,-116,16,1399160,8
1923,y1211,20111216,8794,8744,0,0,0,8744,8744,0,0,0,0,8
1924,y1211,20111219,8744,8744,8850,8850,8850,8850,8850,106,106,2,177000,6
1925,y1211,20111220,8850,8850,0,0,0,8850,8850,0,0,0,0,6
1926,y1211,20111221,8850,8850,0,0,0,8850,8850,0,0,0,0,6
1927,y1211,20111222,8850,8850,0,0,0,8850,8850,0,0,0,0,6
1928,y1211,20111223,8850,8850,0,0,0,8850,8850,0,0,0,0,6
1929,y1211,20111226,8850,8850,8950,8992,8940,8940,8966,90,116,14,1255280,8
1930,y1211,20111227,8940,8966,8898,8930,8898,8930,8914,-36,-52,4,356560,8
1931,y1211,20111228,8930,8914,0,0,0,8914,8914,0,0,0,0,8
1932,y1211,20111229,8914,8914,0,0,0,8914,8914,0,0,0,0,8
1933,y1211,20111230,8914,8914,8978,8978,8978,8978,8978,64,64,2,179560,8
1934,y1212,20111216,8746,8746,0,0,0,8746,8746,0,0,0,0,0
1935,y1212,20111219,8746,8746,0,0,0,8746,8746,0,0,0,0,0
1936,y1212,20111220,8746,8746,0,0,0,8746,8746,0,0,0,0,0
1937,y1212,20111221,8746,8746,0,0,0,8746,8746,0,0,0,0,0
1938,y1212,20111222,8746,8746,0,0,0,8746,8746,0,0,0,0,0
1939,y1212,20111223,8746,8746,0,0,0,8746,8746,0,0,0,0,0
1940,y1212,20111226,8746,8746,0,0,0,8746,8746,0,0,0,0,0
1941,y1212,20111227,8746,8746,0,0,0,8746,8746,0,0,0,0,0
1942,y1212,20111228,8746,8746,0,0,0,8746,8746,0,0,0,0,0
1943,y1212,20111229,8746,8746,0,0,0,8746,8746,0,0,0,0,0
1944,y1212,20111230,8746,8746,0,0,0,8746,8746,0,0,0,0,0