   ,合约,日期,前收盘价,前结算价,开盘价,最高价,最低价,收盘价,结算价,涨跌1,涨跌2,成交量,成交金额,持仓量
1,y1201,20120104,8448,8634,8500,8764,8500,8760,8746,126,112,146,12771640,14446
2,y1201,20120105,8760,8746,8750,8790,8748,8770,8770,24,24,1450,127177080,14446
3,y1201,20120106,8770,8770,0,0,0,8770,8770,0,0,0,0,14446
4,y1201,20120109,8770,8770,0,0,0,8770,8770,0,0,0,0,14046
5,y1201,20120110,8770,8770,8800,8800,8760,8800,8762,30,-8,204,17874880,14046
6,y1201,20120111,8800,8762,8810,8810,8810,8810,8810,48,48,2,176200,14046
7,y1201,20120112,8810,8810,0,0,0,8810,8810,0,0,0,0,3120
8,y1201,20120113,8810,8810,0,0,0,8810,8810,0,0,0,0,3120
9,y1201,20120116,8810,8810,0,0,0,8810,8810,0,0,0,0,3120
10,y1201,20120117,8810,8810,0,0,0,8810,8768,0,-42,0,0,0
11,y1203,20120104,8720,8718,8826,9090,8826,8894,9004,176,286,46,4142080,96
12,y1203,20120105,8894,9004,8852,8900,8850,8872,8862,-132,-142,70,6204600,56
13,y1203,20120106,8872,8862,8860,8860,8860,8860,8860,-2,-2,2,177200,56
14,y1203,20120109,8860,8860,8720,8720,8720,8720,8720,-140,-140,2,174400,58
15,y1203,20120110,8720,8720,8916,8916,8908,8908,8912,188,192,4,356480,54
16,y1203,20120111,8908,8912,8924,8924,8924,8924,8924,12,12,2,178480,56
17,y1203,20120112,8924,8924,8896,8896,8896,8896,8896,-28,-28,2,177920,56
18,y1203,20120113,8896,8896,8896,8896,8828,8828,8860,-68,-36,8,708880,54
19,y1203,20120116,8828,8860,8744,8744,8744,8744,8744,-116,-116,2,174880,54
20,y1203,20120117,8744,8744,0,0,0,8744,8744,0,0,0,0,54
21,y1203,20120118,8744,8744,0,0,0,8744,8744,0,0,0,0,54
22,y1203,20120119,8744,8744,0,0,0,8744,8744,0,0,0,0,54
23,y1203,20120120,8744,8744,0,0,0,8744,8744,0,0,0,0,54
24,y1203,20120130,8744,8744,0,0,0,8744,8744,0,0,0,0,54
25,y1203,20120131,8744,8744,8812,8812,8812,8812,8812,68,68,2,176240,52
26,y1203,20120201,8812,8812,0,0,0,8812,8812,0,0,0,0,52
27,y1203,20120202,8812,8812,8868,8870,8868,8870,8868,58,56,4,354760,48
28,y1203,20120203,8870,8868,8900,8900,8900,8900,8900,32,32,2,178000,46
29,y1203,20120206,8900,8900,0,0,0,8900,8900,0,0,0,0,46
30,y1203,20120207,8900,8900,8974,8974,8974,8974,8974,74,74,2,179480,44
31,y1203,20120208,8974,8974,0,0,0,8974,8974,0,0,0,0,44
32,y1203,20120209,8974,8974,9170,9170,9038,9038,9112,64,138,18,1640160,44
33,y1203,20120210,9038,9112,9050,9050,9000,9000,9006,-112,-106,16,1441000,34
34,y1203,20120213,9000,9006,9090,9090,8960,8960,9024,-46,18,4,361000,32
35,y1203,20120214,8960,9024,0,0,0,9024,9024,0,0,0,0,32
36,y1203,20120215,9024,9024,0,0,0,9024,9024,0,0,0,0,32
37,y1203,20120216,9024,9024,0,0,0,9024,9024,0,0,0,0,32
38,y1203,20120217,9024,9024,0,0,0,9024,9024,0,0,0,0,32
39,y1203,20120220,9024,9024,0,0,0,9024,9024,0,0,0,0,32
40,y1203,20120221,9024,9024,0,0,0,9024,9024,0,0,0,0,32
41,y1203,20120222,9024,9024,8892,8892,8892,8892,8892,-132,-132,2,177840,32
42,y1203,20120223,8892,8892,8902,8902,8902,8902,8902,10,10,6,534120,28
43,y1203,20120224,8902,8902,0,0,0,8902,8902,0,0,0,0,28
44,y1203,20120227,8902,8902,9188,9188,8998,8998,9092,96,190,4,363720,26
45,y1203,20120228,8998,9092,0,0,0,9092,9092,0,0,0,0,26
46,y1203,20120229,9092,9092,8950,8950,8950,8950,8950,-142,-142,2,179000,24
47,y1203,20120301,8950,8950,0,0,0,8950,8950,0,0,0,0,24
48,y1203,20120302,8950,8950,0,0,0,8950,8950,0,0,0,0,24
49,y1203,20120305,8950,8950,0,0,0,8950,8950,0,0,0,0,10
50,y1203,20120306,8950,8950,0,0,0,8950,8950,0,0,0,0,10
51,y1203,20120307,8950,8950,0,0,0,8950,8950,0,0,0,0,10
52,y1203,20120308,8950,8950,0,0,0,8950,8950,0,0,0,0,10
53,y1203,20120309,8950,8950,0,0,0,8950,8950,0,0,0,0,10
54,y1203,20120312,8950,8950,0,0,0,8950,8950,0,0,0,0,10
55,y1203,20120313,8950,8950,0,0,0,8950,8950,0,0,0,0,10
56,y1203,20120314,8950,8950,0,0,0,8950,8950,0,0,0,0,0
57,y1205,20120104,8908,8892,8986,9038,8972,9000,9002,108,110,34076,3068045520,200636
58,y1205,20120105,9000,9002,9002,9074,8976,9008,9018,6,16,44074,3974979480,187498
59,y1205,20120106,9008,9018,8950,8984,8922,8984,8954,-34,-64,25426,2276746880,182954
60,y1205,20120109,8984,8954,8920,8962,8920,8948,8942,-6,-12,32896,2941693880,175438
61,y1205,20120110,8948,8942,9002,9042,8998,9006,9018,64,76,22554,2033935120,170132
62,y1205,20120111,9006,9018,9008,9040,8988,9018,9014,0,-4,14296,1288671480,168424
63,y1205,20120112,9018,9014,8980,8980,8956,8974,8966,-40,-48,13740,1232102720,167316
64,y1205,20120113,8974,8966,8918,8934,8872,8890,8902,-76,-64,28126,2504281520,162166
65,y1205,20120116,8890,8902,8890,8890,8742,8786,8784,-116,-118,26074,2290826720,157244
66,y1205,20120117,8786,8784,8790,8832,8770,8818,8806,34,22,29698,2615355440,150000
67,y1205,20120118,8818,8806,8806,8828,8758,8760,8790,-46,-16,20076,1764792080,148222
68,y1205,20120119,8760,8790,8796,8824,8766,8822,8794,32,4,20042,1762526640,146156
69,y1205,20120120,8822,8794,8852,8908,8820,8886,8868,92,74,15938,1413558080,141348
70,y1205,20120130,8886,8868,8910,8934,8892,8896,8912,28,44,10340,921642360,138210
71,y1205,20120131,8896,8912,8848,8854,8826,8846,8838,-66,-74,8662,765639440,137884
72,y1205,20120201,8846,8838,8852,8916,8852,8890,8886,52,48,9868,876999560,134956
73,y1205,20120202,8890,8886,8926,8976,8892,8956,8944,70,58,14310,1279949440,130732
74,y1205,20120203,8956,8944,8950,8984,8944,8954,8966,10,22,5292,474509560,130572
75,y1205,20120206,8954,8966,9006,9074,9006,9052,9046,86,80,21510,1945955960,122326
76,y1205,20120207,9052,9046,9066,9088,9004,9018,9038,-28,-8,9316,842120320,118182
77,y1205,20120208,9018,9038,9040,9132,9030,9132,9078,94,40,12704,1153400800,112922
78,y1205,20120209,9132,9078,9088,9142,9088,9120,9114,42,36,9310,848633800,110018
79,y1205,20120210,9120,9114,9112,9112,9046,9056,9066,-58,-48,5376,487445480,109286
80,y1205,20120213,9056,9066,9088,9168,9088,9158,9140,92,74,11460,1047616160,106738
81,y1205,20120214,9158,9140,9198,9198,9136,9140,9168,0,28,7690,705058560,105014
82,y1205,20120215,9140,9168,9168,9186,9144,9148,9164,-20,-4,4250,389550680,103210
83,y1205,20120216,9148,9164,9166,9166,9054,9100,9088,-64,-76,8034,730153000,100142
84,y1205,20120217,9100,9088,9130,9200,9120,9198,9174,110,86,5620,515610280,98352
85,y1205,20120220,9198,9174,9208,9272,9180,9190,9220,16,46,22336,2059597600,87044
86,y1205,20120221,9190,9220,9210,9228,9156,9212,9202,-8,-18,20070,1847211800,78524
87,y1205,20120222,9212,9202,9220,9234,9190,9198,9204,-4,2,17124,1576390480,69642
88,y1205,20120223,9198,9204,9200,9202,9144,9200,9164,-4,-40,10452,957877640,66800
89,y1205,20120224,9200,9164,9200,9200,9146,9162,9168,-2,4,11048,1012928560,66742
90,y1205,20120227,9162,9168,9178,9220,9174,9202,9198,34,30,7354,676565680,64872
91,y1205,20120228,9202,9198,9230,9260,9224,9260,9242,62,44,4846,447950400,62556
92,y1205,20120229,9260,9242,9246,9260,9214,9242,9232,0,-10,3218,297104920,61428
93,y1205,20120301,9242,9232,9240,9240,9152,9152,9190,-80,-42,5720,525761240,58822
94,y1205,20120302,9152,9190,9180,9212,9172,9198,9196,8,6,2552,234691320,57142
95,y1205,20120305,9198,9196,9206,9238,9180,9220,9204,24,8,2092,192553280,56170
96,y1205,20120306,9220,9204,9182,9182,9158,9164,9170,-40,-34,2362,216600800,54910
97,y1205,20120307,9164,9170,9150,9160,9112,9140,9136,-30,-34,3640,332596840,52614
98,y1205,20120308,9140,9136,9120,9186,9120,9184,9152,48,16,4452,407522360,51088
99,y1205,20120309,9184,9152,9198,9382,9198,9374,9322,222,170,5598,521849600,49174
100,y1205,20120312,9374,9322,9350,9364,9298,9324,9334,2,12,3288,306920640,46914
101,y1205,20120313,9324,9334,9364,9370,9298,9368,9320,34,-14,5624,524217040,43728
102,y1205,20120314,9368,9320,9398,9470,9348,9366,9404,46,84,4590,431692600,41976
103,y1205,20120315,9366,9404,9442,9442,9356,9402,9404,-2,0,2382,224048520,40626
104,y1205,20120316,9402,9404,9468,9486,9384,9390,9418,-14,14,2800,263756680,38298
105,y1205,20120319,9390,9418,9418,9470,9406,9440,9434,22,16,3444,324930040,35820
106,y1205,20120320,9440,9434,9432,9432,9330,9332,9368,-102,-66,5628,527321400,31446
107,y1205,20120321,9332,9368,9302,9330,9270,9310,9304,-58,-64,5924,551221560,29784
108,y1205,20120322,9310,9304,9338,9350,9298,9300,9332,-4,28,1394,130091360,29190
109,y1205,20120323,9300,9332,9288,9454,9288,9454,9390,122,58,8288,778304960,23254
110,y1205,20120326,9454,9390,9476,9570,9476,9562,9550,172,160,6920,660912280,20642
111,y1205,20120327,9562,9550,9562,9576,9522,9530,9540,-20,-10,2152,205315520,19758
112,y1205,20120328,9530,9540,9490,9570,9488,9528,9520,-12,-20,1748,166410880,18348
113,y1205,20120329,9528,9520,9502,9532,9448,9470,9474,-50,-46,1098,104044080,18088
114,y1205,20120330,9470,9474,9430,9456,9396,9398,9424,-76,-50,1552,146263440,17966
115,y1205,20120405,9398,9424,9650,9696,9620,9684,9648,260,224,4104,395988840,18170
116,y1205,20120406,9684,9648,9736,9898,9720,9818,9776,170,128,2280,222903000,16856
117,y1205,20120409,9818,9776,9830,9864,9804,9824,9832,48,56,1820,178946040,15324
118,y1205,20120410,9824,9832,9818,9888,9800,9886,9840,54,8,374,36804200,15134
119,y1205,20120411,9886,9840,9812,9812,9750,9772,9770,-68,-70,2404,234896920,14190
120,y1205,20120412,9772,9770,9770,9816,9762,9804,9780,34,10,1080,105632080,13392
121,y1205,20120413,9804,9780,9856,9886,9842,9866,9844,86,64,826,81327240,12672
122,y1205,20120416,9866,9844,9804,9804,9730,9748,9760,-96,-84,2542,248107160,11198
123,y1205,20120417,9748,9760,9748,9788,9748,9768,9766,8,6,3168,309417040,8714
124,y1205,20120418,9768,9766,9780,9826,9700,9768,9760,2,-6,1300,126899480,7578
125,y1205,20120419,9768,9760,9754,9754,9700,9720,9724,-40,-36,1064,103474560,7448
126,y1205,20120420,9720,9724,9700,9738,9678,9700,9700,-24,-24,936,90807760,6552
127,y1205,20120423,9700,9700,9722,9778,9722,9738,9762,38,62,1726,168511680,6498
128,y1205,20120424,9738,9762,9682,9740,9664,9720,9700,-42,-62,1240,120302720,6284
129,y1205,20120425,9720,9700,9720,9766,9710,9760,9738,60,38,778,75772000,5962
130,y1205,20120426,9760,9738,9722,9748,9718,9748,9736,10,-2,332,32326280,5756
131,y1205,20120427,9748,9736,9732,9840,9706,9750,9750,14,14,348,33932840,5730
132,y1205,20120502,9750,9750,9700,9770,9680,9722,9744,-28,-6,2316,225678880,4148
133,y1205,20120503,9722,9744,9700,9800,9648,9800,9756,56,12,478,46633680,3928
134,y1205,20120504,9800,9756,9800,9800,9800,9800,9800,44,44,6,588000,1208
135,y1205,20120507,9800,9800,9280,9700,9280,9700,9520,-100,-280,16,1523280,1204
136,y1205,20120508,9700,9520,0,0,0,9520,9520,0,0,0,0,1204
137,y1205,20120509,9520,9520,0,0,0,9520,9520,0,0,0,0,1204
138,y1205,20120510,9520,9520,0,0,0,9520,9520,0,0,0,0,1204
139,y1205,20120511,9520,9520,9800,9800,9800,9800,9800,280,280,2,196000,1202
140,y1205,20120514,9800,9800,0,0,0,9800,9800,0,0,0,0,1202
141,y1205,20120515,9800,9800,9800,9800,9800,9800,9744,0,-56,2,196000,0
142,y1207,20120104,8894,8894,9028,9028,8994,8994,9002,100,108,10,900320,136
143,y1207,20120105,8994,9002,9020,9060,9020,9032,9032,30,30,28,2529040,114
144,y1207,20120106,9032,9032,0,0,0,9032,9032,0,0,0,0,114
145,y1207,20120109,9032,9032,0,0,0,9032,9032,0,0,0,0,114
146,y1207,20120110,9032,9032,9030,9032,9016,9016,9026,-16,-6,30,2707920,108
147,y1207,20120111,9016,9026,0,0,0,9026,9026,0,0,0,0,108
148,y1207,20120112,9026,9026,8980,8980,8980,8980,8980,-46,-46,2,179600,108
149,y1207,20120113,8980,8980,8902,8906,8898,8898,8902,-82,-78,14,1246360,94
150,y1207,20120116,8898,8902,0,0,0,8902,8902,0,0,0,0,94
151,y1207,20120117,8902,8902,8820,8820,8762,8810,8796,-92,-106,6,527840,92
152,y1207,20120118,8810,8796,8812,8812,8812,8812,8812,16,16,2,176240,92
153,y1207,20120119,8812,8812,0,0,0,8812,8812,0,0,0,0,92
154,y1207,20120120,8812,8812,0,0,0,8812,8812,0,0,0,0,92
155,y1207,20120130,8812,8812,8900,8900,8900,8900,8900,88,88,4,356000,92
156,y1207,20120131,8900,8900,0,0,0,8900,8900,0,0,0,0,92
157,y1207,20120201,8900,8900,8918,8920,8918,8920,8918,20,18,4,356760,92
158,y1207,20120202,8920,8918,8970,8970,8970,8970,8970,52,52,2,179400,92
159,y1207,20120203,8970,8970,8990,8990,8990,8990,8990,20,20,2,179800,92
160,y1207,20120206,8990,8990,9028,9090,9028,9060,9042,70,52,30,2713040,90
161,y1207,20120207,9060,9042,9042,9042,9038,9038,9040,-4,-2,4,361600,90
162,y1207,20120208,9038,9040,9054,9116,9054,9116,9084,76,44,4,363400,90
163,y1207,20120209,9116,9084,9164,9216,9080,9080,9190,-4,106,24,2205800,100
164,y1207,20120210,9080,9190,0,0,0,9190,9190,0,0,0,0,100
165,y1207,20120213,9190,9190,0,0,0,9190,9190,0,0,0,0,100
166,y1207,20120214,9190,9190,0,0,0,9190,9190,0,0,0,0,100
167,y1207,20120215,9190,9190,9190,9190,9190,9190,9190,0,0,14,1286600,86
168,y1207,20120216,9190,9190,0,0,0,9190,9190,0,0,0,0,86
169,y1207,20120217,9190,9190,9194,9194,9194,9194,9194,4,4,2,183880,86
170,y1207,20120220,9194,9194,9252,9252,9252,9252,9252,58,58,8,740160,78
171,y1207,20120221,9252,9252,0,0,0,9252,9252,0,0,0,0,78
172,y1207,20120222,9252,9252,9224,9250,9224,9246,9242,-6,-10,12,1109200,78
173,y1207,20120223,9246,9242,0,0,0,9242,9242,0,0,0,0,78
174,y1207,20120224,9242,9242,9216,9216,9216,9216,9216,-26,-26,2,184320,78
175,y1207,20120227,9216,9216,0,0,0,9216,9216,0,0,0,0,78
176,y1207,20120228,9216,9216,0,0,0,9216,9216,0,0,0,0,78
177,y1207,20120229,9216,9216,9256,9256,9256,9256,9256,40,40,2,185120,78
178,y1207,20120301,9256,9256,9212,9286,9206,9270,9256,14,0,56,5183760,86
179,y1207,20120302,9270,9256,0,0,0,9256,9256,0,0,0,0,86
180,y1207,20120305,9256,9256,9256,9256,9256,9256,9256,0,0,8,740480,78
181,y1207,20120306,9256,9256,9256,9256,9256,9256,9256,0,0,6,555360,72
182,y1207,20120307,9256,9256,9216,9234,9156,9220,9200,-36,-56,20,1840120,76
183,y1207,20120308,9220,9200,9226,9226,9226,9226,9226,26,26,4,369040,72
184,y1207,20120309,9226,9226,9410,9436,9410,9420,9420,194,194,18,1695880,74
185,y1207,20120312,9420,9420,9384,9416,9356,9388,9384,-32,-36,18,1689360,70
186,y1207,20120313,9388,9384,0,0,0,9384,9384,0,0,0,0,70
187,y1207,20120314,9384,9384,9512,9512,9428,9472,9470,88,86,6,568240,70
188,y1207,20120315,9472,9470,0,0,0,9470,9470,0,0,0,0,70
189,y1207,20120316,9470,9470,9526,9526,9526,9526,9526,56,56,2,190520,70
190,y1207,20120319,9526,9526,0,0,0,9526,9526,0,0,0,0,70
191,y1207,20120320,9526,9526,0,0,0,9526,9526,0,0,0,0,70
192,y1207,20120321,9526,9526,0,0,0,9526,9526,0,0,0,0,70
193,y1207,20120322,9526,9526,0,0,0,9526,9526,0,0,0,0,70
194,y1207,20120323,9526,9526,9458,9458,9446,9446,9452,-80,-74,4,378080,68
195,y1207,20120326,9446,9452,0,0,0,9452,9452,0,0,0,0,68
196,y1207,20120327,9452,9452,9568,9568,9548,9548,9558,96,106,4,382320,66
197,y1207,20120328,9548,9558,9548,9548,9548,9548,9548,-10,-10,2,190960,66
198,y1207,20120329,9548,9548,0,0,0,9548,9548,0,0,0,0,66
199,y1207,20120330,9548,9548,9402,9492,9382,9382,9424,-166,-124,24,2262080,66
200,y1207,20120405,9382,9424,9710,9710,9710,9710,9710,286,286,2,194200,66
201,y1207,20120406,9710,9710,9762,9854,9734,9854,9782,144,72,16,1565240,64
202,y1207,20120409,9854,9782,0,0,0,9782,9782,0,0,0,0,64
203,y1207,20120410,9782,9782,0,0,0,9782,9782,0,0,0,0,64
204,y1207,20120411,9782,9782,9828,9828,9760,9812,9800,30,18,6,588000,64
205,y1207,20120412,9812,9800,9780,9780,9780,9780,9780,-20,-20,2,195600,64
206,y1207,20120413,9780,9780,9878,9878,9878,9878,9878,98,98,2,197560,64
207,y1207,20120416,9878,9878,9738,9738,9672,9702,9704,-176,-174,10,970440,66
208,y1207,20120417,9702,9704,0,0,0,9704,9704,0,0,0,0,66
209,y1207,20120418,9704,9704,9740,9740,9740,9740,9740,36,36,2,194800,66
210,y1207,20120419,9740,9740,0,0,0,9740,9740,0,0,0,0,66
211,y1207,20120420,9740,9740,0,0,0,9740,9740,0,0,0,0,66
212,y1207,20120423,9740,9740,9806,9806,9804,9804,9804,64,64,4,392200,64
213,y1207,20120424,9804,9804,9814,9814,9684,9692,9730,-112,-74,6,583800,66
214,y1207,20120425,9692,9730,9816,9816,9816,9816,9816,86,86,2,196320,64
215,y1207,20120426,9816,9816,0,0,0,9816,9816,0,0,0,0,64
216,y1207,20120427,9816,9816,9726,9730,9726,9730,9728,-86,-88,10,972920,64
217,y1207,20120502,9730,9728,9696,9696,9696,9696,9696,-32,-32,2,193920,64
218,y1207,20120503,9696,9696,9618,9618,9618,9618,9618,-78,-78,4,384720,64
219,y1207,20120504,9618,9618,9560,9560,9560,9560,9560,-58,-58,4,382400,64
220,y1207,20120507,9560,9560,0,0,0,9560,9560,0,0,0,0,64
221,y1207,20120508,9560,9560,0,0,0,9560,9560,0,0,0,0,64
222,y1207,20120509,9560,9560,9508,9508,9508,9508,9508,-52,-52,2,190160,62
223,y1207,20120510,9508,9508,0,0,0,9508,9508,0,0,0,0,62
224,y1207,20120511,9508,9508,9558,9558,9364,9516,9428,8,-80,28,2640040,64
225,y1207,20120514,9516,9428,9278,9278,9278,9278,9278,-150,-150,8,742240,64
226,y1207,20120515,9278,9278,9204,9204,9204,9204,9204,-74,-74,4,368160,64
227,y1207,20120516,9204,9204,9214,9214,9030,9038,9168,-166,-36,16,1467040,56
228,y1207,20120517,9038,9168,9100,9188,9100,9140,9162,-28,-6,90,8246880,124
229,y1207,20120518,9140,9162,0,0,0,9162,9162,0,0,0,0,124
230,y1207,20120521,9162,9162,9064,9186,9064,9116,9142,-46,-20,18,1645760,122
231,y1207,20120522,9116,9142,0,0,0,9142,9142,0,0,0,0,122
232,y1207,20120523,9142,9142,0,0,0,9142,9142,0,0,0,0,122
233,y1207,20120524,9142,9142,0,0,0,9142,9142,0,0,0,0,122
234,y1207,20120525,9142,9142,9028,9030,9028,9028,9028,-114,-114,8,722280,130
235,y1207,20120528,9028,9028,9030,9070,9030,9070,9056,42,28,6,543400,126
236,y1207,20120529,9070,9056,9090,9090,9084,9084,9086,28,30,4,363480,122
237,y1207,20120530,9084,9086,9036,9112,9036,9112,9074,26,-12,8,725920,122
238,y1207,20120531,9112,9074,0,0,0,9074,9074,0,0,0,0,122
239,y1207,20120601,9074,9074,8924,9018,8910,8910,8940,-164,-134,14,1251760,120
240,y1207,20120604,8910,8940,0,0,0,8940,8940,0,0,0,0,120
241,y1207,20120605,8940,8940,0,0,0,8940,8940,0,0,0,0,120
242,y1207,20120606,8940,8940,0,0,0,8940,8940,0,0,0,0,120
243,y1207,20120607,8940,8940,0,0,0,8940,8940,0,0,0,0,120
244,y1207,20120608,8940,8940,8900,8900,8900,8900,8900,-40,-40,2,178000,118
245,y1207,20120611,8900,8900,9148,9148,9000,9018,9046,118,146,8,723680,114
246,y1207,20120612,9018,9046,8914,9078,8886,9062,8976,16,-70,18,1615760,118
247,y1207,20120613,9062,8976,8886,9000,8886,8898,8918,-78,-58,16,1427040,108
248,y1207,20120614,8898,8918,8860,8860,8840,8860,8848,-58,-70,20,1769920,92
249,y1207,20120615,8860,8848,8564,8716,8564,8716,8638,-132,-210,8,691080,92
250,y1207,20120618,8716,8638,8860,8906,8860,8906,8882,268,244,4,355320,88
251,y1207,20120619,8906,8882,9030,9050,9010,9010,9020,128,138,42,3789200,48
252,y1207,20120620,9010,9020,9080,9080,9080,9080,9080,60,60,26,2360800,24
253,y1207,20120621,9080,9080,0,0,0,9080,9080,0,0,0,0,24
254,y1207,20120625,9080,9080,9150,9150,9150,9150,9150,70,70,16,1464000,8
255,y1207,20120626,9150,9150,8870,9508,8870,9150,9156,0,6,8,732600,6
256,y1207,20120627,9150,9156,0,0,0,9156,9156,0,0,0,0,6
257,y1207,20120628,9156,9156,9300,9300,9300,9300,9300,144,144,6,558000,0
258,y1207,20120629,9300,9300,0,0,0,9300,9300,0,0,0,0,0
259,y1207,20120702,9300,9300,0,0,0,9300,9300,0,0,0,0,0
260,y1207,20120703,9300,9300,0,0,0,9300,9300,0,0,0,0,0
261,y1207,20120704,9300,9300,0,0,0,9300,9300,0,0,0,0,0
262,y1207,20120705,9300,9300,0,0,0,9300,9300,0,0,0,0,0
263,y1207,20120706,9300,9300,0,0,0,9300,9300,0,0,0,0,0
264,y1207,20120709,9300,9300,0,0,0,9300,9300,0,0,0,0,0
265,y1207,20120710,9300,9300,0,0,0,9300,9300,0,0,0,0,0
266,y1207,20120711,9300,9300,0,0,0,9300,9300,0,0,0,0,0
267,y1207,20120712,9300,9300,0,0,0,9300,9300,0,0,0,0,0
268,y1207,20120713,9300,9300,0,0,0,9300,9300,0,0,0,0,0
269,y1208,20120104,8812,8812,8998,9042,8998,9042,9010,230,198,10,901000,18
270,y1208,20120105,9042,9010,9070,9070,9024,9058,9050,48,40,6,543040,16
271,y1208,20120106,9058,9050,9018,9018,8998,8998,9004,-52,-46,10,900560,18
272,y1208,20120109,8998,9004,0,0,0,9004,9004,0,0,0,0,18
273,y1208,20120110,9004,9004,9032,9058,9032,9058,9044,54,40,4,361800,16
274,y1208,20120111,9058,9044,9054,9054,9026,9026,9040,-18,-4,4,361600,14
275,y1208,20120112,9026,9040,9024,9024,9024,9024,9024,-16,-16,4,360960,14
276,y1208,20120113,9024,9024,8990,8990,8928,8928,8964,-96,-60,20,1793000,16
277,y1208,20120116,8928,8964,8800,8812,8800,8808,8806,-156,-158,6,528400,16
278,y1208,20120117,8808,8806,8920,8920,8858,8864,8888,58,82,42,3733000,18
279,y1208,20120118,8864,8888,0,0,0,8888,8888,0,0,0,0,18
280,y1208,20120119,8888,8888,8832,8832,8832,8832,8832,-56,-56,2,176640,16
281,y1208,20120120,8832,8832,8932,8980,8932,8980,8956,148,124,4,358240,18
282,y1208,20120130,8980,8956,0,0,0,8956,8956,0,0,0,0,18
283,y1208,20120131,8956,8956,8956,8956,8888,8888,8922,-68,-34,4,356880,18
284,y1208,20120201,8888,8922,8988,9056,8988,9056,9030,134,108,10,903160,26
285,y1208,20120202,9056,9030,9078,9078,9078,9078,9078,48,48,2,181560,26
286,y1208,20120203,9078,9078,9030,9058,9008,9008,9036,-70,-42,22,1988280,22
287,y1208,20120206,9008,9036,9108,9108,9108,9108,9108,72,72,6,546480,16
288,y1208,20120207,9108,9108,9190,9190,9072,9072,9148,-36,40,20,1829800,18
289,y1208,20120208,9072,9148,0,0,0,9148,9148,0,0,0,0,18
290,y1208,20120209,9148,9148,9206,9206,9182,9182,9194,34,46,10,919560,18
291,y1208,20120210,9182,9194,9084,9140,9034,9140,9096,-54,-98,36,3275160,18
292,y1208,20120213,9140,9096,9262,9262,9216,9226,9236,130,140,10,923640,18
293,y1208,20120214,9226,9236,9262,9262,9206,9206,9234,-30,-2,8,738720,18
294,y1208,20120215,9206,9234,0,0,0,9234,9234,0,0,0,0,18
295,y1208,20120216,9234,9234,0,0,0,9234,9234,0,0,0,0,18
296,y1208,20120217,9234,9234,9290,9290,9230,9234,9250,0,16,6,555080,16
297,y1208,20120220,9234,9250,9330,9330,9290,9290,9310,40,60,36,3351600,14
298,y1208,20120221,9290,9310,0,0,0,9310,9310,0,0,0,0,14
299,y1208,20120222,9310,9310,0,0,0,9310,9310,0,0,0,0,14
300,y1208,20120223,9310,9310,9226,9226,9226,9226,9226,-84,-84,4,369040,12
301,y1208,20120224,9226,9226,9282,9282,9254,9254,9268,28,42,4,370720,10
302,y1208,20120227,9254,9268,0,0,0,9268,9268,0,0,0,0,10
303,y1208,20120228,9268,9268,0,0,0,9268,9268,0,0,0,0,10
304,y1208,20120229,9268,9268,0,0,0,9268,9268,0,0,0,0,10
305,y1208,20120301,9268,9268,0,0,0,9268,9268,0,0,0,0,10
306,y1208,20120302,9268,9268,0,0,0,9268,9268,0,0,0,0,10
307,y1208,20120305,9268,9268,9350,9350,9290,9290,9320,22,52,12,1118400,14
308,y1208,20120306,9290,9320,9302,9302,9242,9294,9278,-26,-42,6,556760,12
309,y1208,20120307,9294,9278,0,0,0,9278,9278,0,0,0,0,12
310,y1208,20120308,9278,9278,0,0,0,9278,9278,0,0,0,0,12
311,y1208,20120309,9278,9278,9364,9464,9336,9464,9384,186,106,8,750720,10
312,y1208,20120312,9464,9384,9490,9490,9490,9490,9490,106,106,2,189800,10
313,y1208,20120313,9490,9490,9460,9460,9460,9460,9460,-30,-30,4,378400,12
314,y1208,20120314,9460,9460,9610,9610,9578,9578,9594,118,134,4,383760,12
315,y1208,20120315,9578,9594,9600,9608,9588,9588,9600,-6,6,8,768000,12
316,y1208,20120316,9588,9600,9600,9604,9568,9604,9590,4,-10,6,575440,14
317,y1208,20120319,9604,9590,0,0,0,9590,9590,0,0,0,0,14
318,y1208,20120320,9590,9590,0,0,0,9590,9590,0,0,0,0,14
319,y1208,20120321,9590,9590,0,0,0,9590,9590,0,0,0,0,14
320,y1208,20120322,9590,9590,9486,9526,9486,9486,9498,-104,-92,8,759840,10
321,y1208,20120323,9486,9498,9512,9512,9512,9512,9512,14,14,4,380480,14
322,y1208,20120326,9512,9512,9700,9750,9700,9750,9732,238,220,6,584000,20
323,y1208,20120327,9750,9732,9642,9720,9638,9720,9656,-12,-76,10,965600,16
324,y1208,20120328,9720,9656,9680,9680,9680,9680,9680,24,24,2,193600,14
325,y1208,20120329,9680,9680,9612,9660,9570,9630,9626,-50,-54,18,1732720,10
326,y1208,20120330,9630,9626,9562,9576,9514,9566,9548,-60,-78,20,1909800,12
327,y1208,20120405,9566,9548,9724,9724,9724,9724,9724,176,176,6,583440,6
328,y1208,20120406,9724,9724,9910,9950,9872,9950,9910,226,186,8,792840,4
329,y1208,20120409,9950,9910,9954,9998,9902,9912,9962,2,52,74,7372960,10
330,y1208,20120410,9912,9962,9964,9964,9964,9964,9964,2,2,2,199280,12
331,y1208,20120411,9964,9964,9920,9920,9850,9858,9880,-106,-84,16,1580920,8
332,y1208,20120412,9858,9880,9858,9902,9834,9898,9872,18,-8,16,1579600,8
333,y1208,20120413,9898,9872,9930,9930,9930,9930,9930,58,58,4,397200,4
334,y1208,20120416,9930,9930,9930,9968,9778,9794,9854,-136,-76,22,2168040,4
335,y1208,20120417,9794,9854,9848,9848,9792,9806,9818,-48,-36,12,1178360,4
336,y1208,20120418,9806,9818,9900,9910,9776,9776,9862,-42,44,10,986280,4
337,y1208,20120419,9776,9862,0,0,0,9862,9862,0,0,0,0,4
338,y1208,20120420,9862,9862,9852,9852,9826,9826,9838,-36,-24,4,393560,6
339,y1208,20120423,9826,9838,0,0,0,9838,9838,0,0,0,0,6
340,y1208,20120424,9838,9838,0,0,0,9838,9838,0,0,0,0,6
341,y1208,20120425,9838,9838,0,0,0,9838,9838,0,0,0,0,6
342,y1208,20120426,9838,9838,0,0,0,9838,9838,0,0,0,0,6
343,y1208,20120427,9838,9838,0,0,0,9838,9838,0,0,0,0,6
344,y1208,20120502,9838,9838,9780,9832,9780,9832,9806,-6,-32,4,392240,8
345,y1208,20120503,9832,9806,0,0,0,9806,9806,0,0,0,0,8
346,y1208,20120504,9806,9806,0,0,0,9806,9806,0,0,0,0,8
347,y1208,20120507,9806,9806,9636,9636,9574,9580,9596,-226,-210,12,1151600,6
348,y1208,20120508,9580,9596,9674,9676,9674,9676,9674,80,78,6,580520,4
349,y1208,20120509,9676,9674,0,0,0,9674,9674,0,0,0,0,4
350,y1208,20120510,9674,9674,9898,9898,9668,9736,9758,62,84,26,2537520,14
351,y1208,20120511,9736,9758,9592,9592,9532,9532,9562,-226,-196,4,382480,14
352,y1208,20120514,9532,9562,9460,9478,9358,9358,9450,-204,-112,148,13986320,86
353,y1208,20120515,9358,9450,9292,9306,9292,9302,9300,-148,-150,32,2976280,72
354,y1208,20120516,9302,9300,9362,9362,9180,9180,9242,-120,-58,34,3142400,66
355,y1208,20120517,9180,9242,9230,9264,9230,9264,9244,22,2,14,1294160,66
356,y1208,20120518,9264,9244,9220,9220,9152,9152,9172,-92,-72,10,917200,64
357,y1208,20120521,9152,9172,9196,9272,9196,9272,9226,100,54,6,553640,62
358,y1208,20120522,9272,9226,9250,9266,9214,9266,9238,40,12,16,1478240,64
359,y1208,20120523,9266,9238,9142,9142,9100,9100,9116,-138,-122,12,1093920,64
360,y1208,20120524,9100,9116,9052,9076,8984,9022,9028,-94,-88,76,6862560,54
361,y1208,20120525,9022,9028,0,0,0,9028,9028,0,0,0,0,54
362,y1208,20120528,9028,9028,9048,9102,9048,9102,9074,74,46,14,1270400,48
363,y1208,20120529,9102,9074,9070,9102,9070,9102,9082,28,8,10,908360,46
364,y1208,20120530,9102,9082,9118,9118,9114,9116,9116,34,34,6,546960,46
365,y1208,20120531,9116,9116,0,0,0,9116,9116,0,0,0,0,46
366,y1208,20120601,9116,9116,0,0,0,9116,9116,0,0,0,0,46
367,y1208,20120604,9116,9116,8760,8760,8760,8760,8760,-356,-356,2,175200,46
368,y1208,20120605,8760,8760,8800,8800,8772,8800,8788,40,28,8,703080,46
369,y1208,20120606,8800,8788,0,0,0,8788,8788,0,0,0,0,46
370,y1208,20120607,8788,8788,0,0,0,8788,8788,0,0,0,0,46
371,y1208,20120608,8788,8788,8918,8918,8918,8918,8918,130,130,4,356720,46
372,y1208,20120611,8918,8918,0,0,0,8918,8918,0,0,0,0,46
373,y1208,20120612,8918,8918,0,0,0,8918,8918,0,0,0,0,46
374,y1208,20120613,8918,8918,0,0,0,8918,8918,0,0,0,0,46
375,y1208,20120614,8918,8918,0,0,0,8918,8918,0,0,0,0,46
376,y1208,20120615,8918,8918,0,0,0,8918,8918,0,0,0,0,46
377,y1208,20120618,8918,8918,0,0,0,8918,8918,0,0,0,0,46
378,y1208,20120619,8918,8918,0,0,0,8918,8918,0,0,0,0,46
379,y1208,20120620,8918,8918,0,0,0,8918,8918,0,0,0,0,46
380,y1208,20120621,8918,8918,0,0,0,8918,8918,0,0,0,0,46
381,y1208,20120625,8918,8918,9274,9274,9274,9274,9274,356,356,6,556440,42
382,y1208,20120626,9274,9274,9184,9230,9180,9180,9196,-94,-78,12,1103720,38
383,y1208,20120627,9180,9196,9182,9182,9182,9182,9182,-14,-14,4,367280,38
384,y1208,20120628,9182,9182,9198,9198,9198,9198,9198,16,16,2,183960,36
385,y1208,20120629,9198,9198,0,0,0,9198,9198,0,0,0,0,36
386,y1208,20120702,9198,9198,9366,9374,9366,9374,9370,176,172,4,374800,34
387,y1208,20120703,9374,9370,9360,9436,9360,9392,9404,22,34,14,1316560,38
388,y1208,20120704,9392,9404,0,0,0,9404,9404,0,0,0,0,38
389,y1208,20120705,9404,9404,9490,9582,9464,9464,9502,60,98,10,950320,32
390,y1208,20120706,9464,9502,0,0,0,9502,9502,0,0,0,0,32
391,y1208,20120709,9502,9502,0,0,0,9502,9502,0,0,0,0,32
392,y1208,20120710,9502,9502,9502,9502,9500,9500,9500,-2,-2,10,950080,26
393,y1208,20120711,9500,9500,0,0,0,9500,9500,0,0,0,0,26
394,y1208,20120712,9500,9500,0,0,0,9500,9500,0,0,0,0,26
395,y1208,20120713,9500,9500,9320,9320,9320,9320,9320,-180,-180,4,372800,22
396,y1208,20120716,9320,9320,0,0,0,9320,9320,0,0,0,0,22
397,y1208,20120717,9320,9320,0,0,0,9320,9320,0,0,0,0,22
398,y1208,20120718,9320,9320,0,0,0,9320,9320,0,0,0,0,22
399,y1208,20120719,9320,9320,0,0,0,9320,9320,0,0,0,0,22
400,y1208,20120720,9320,9320,9550,9550,9530,9530,9540,210,220,4,381600,18
401,y1208,20120723,9530,9540,9430,9430,9430,9430,9430,-110,-110,2,188600,16
402,y1208,20120724,9430,9430,0,0,0,9430,9430,0,0,0,0,16
403,y1208,20120725,9430,9430,9130,9200,9130,9190,9150,-240,-280,12,1098200,4
404,y1208,20120726,9190,9150,0,0,0,9150,9150,0,0,0,0,4
405,y1208,20120727,9150,9150,9400,9400,9400,9400,9400,250,250,4,376000,0
406,y1208,20120730,9400,9400,0,0,0,9400,9400,0,0,0,0,0
407,y1208,20120731,9400,9400,9472,9472,9250,9250,9360,-150,-40,4,374440,0
408,y1208,20120801,9250,9360,0,0,0,9360,9360,0,0,0,0,0
409,y1208,20120802,9360,9360,0,0,0,9360,9360,0,0,0,0,0
410,y1208,20120803,9360,9360,0,0,0,9360,9360,0,0,0,0,0
411,y1208,20120806,9360,9360,0,0,0,9360,9360,0,0,0,0,0
412,y1208,20120807,9360,9360,0,0,0,9360,9360,0,0,0,0,0
413,y1208,20120808,9360,9360,0,0,0,9360,9360,0,0,0,0,0
414,y1208,20120809,9360,9360,0,0,0,9360,9360,0,0,0,0,0
415,y1208,20120810,9360,9360,0,0,0,9360,9360,0,0,0,0,0
416,y1208,20120813,9360,9360,0,0,0,9360,9360,0,0,0,0,0
417,y1208,20120814,9360,9360,0,0,0,9360,9360,0,0,0,0,0
418,y1209,20120104,8994,8978,9088,9128,9058,9084,9096,106,118,200678,18256262120,369904
419,y1209,20120105,9084,9096,9110,9174,9052,9108,9112,12,16,292632,26665332920,393176
420,y1209,20120106,9108,9112,9008,9082,9008,9080,9050,-32,-62,220654,19970287280,398374
421,y1209,20120109,9080,9050,9016,9074,9016,9048,9048,-2,-2,253290,22921834960,395068
422,y1209,20120110,9048,9048,9146,9154,9100,9106,9124,58,76,228784,20877333320,393866
423,y1209,20120111,9106,9124,9110,9144,9082,9122,9114,-2,-10,219284,19989182960,403656
424,y1209,20120112,9122,9114,9072,9092,9058,9082,9074,-32,-40,164286,14907564400,412498
425,y1209,20120113,9082,9074,9022,9050,8988,9004,9022,-70,-52,226790,20461745560,420438
426,y1209,20120116,9004,9022,8908,8926,8852,8886,8886,-136,-136,192304,17089056840,418764
427,y1209,20120117,8886,8886,8932,8960,8882,8954,8926,68,40,259170,23135415680,427450
428,y1209,20120118,8954,8926,8942,8972,8902,8902,8936,-24,10,220502,19706297000,429114
429,y1209,20120119,8902,8936,8936,8970,8910,8960,8938,24,2,190142,16997358720,410400
430,y1209,20120120,8960,8938,8982,9068,8968,9054,9026,116,88,205158,18519793160,406036
431,y1209,20120130,9054,9026,9066,9094,9046,9046,9068,20,42,147976,13419602640,391540
432,y1209,20120131,9046,9068,8972,9008,8972,9000,8990,-68,-78,174094,15653401920,410370
433,y1209,20120201,9000,8990,9018,9068,9012,9032,9044,42,54,249442,22563036560,420506
434,y1209,20120202,9032,9044,9032,9124,9032,9094,9088,50,44,338370,30752754280,446842
435,y1209,20120203,9094,9088,9102,9134,9088,9104,9110,16,22,229776,20932612360,446588
436,y1209,20120206,9104,9110,9162,9234,9154,9208,9200,98,90,265822,24460375880,466604
437,y1209,20120207,9208,9200,9226,9252,9156,9178,9200,-22,0,300242,27623813120,454532
438,y1209,20120208,9178,9200,9200,9304,9188,9302,9240,102,40,391112,36140653000,502040
439,y1209,20120209,9302,9240,9276,9314,9252,9286,9280,46,40,351008,32579222040,497150
440,y1209,20120210,9286,9280,9268,9268,9202,9220,9228,-60,-52,247782,22867132840,496862
441,y1209,20120213,9220,9228,9270,9348,9254,9332,9310,104,82,429844,40021746120,538400
442,y1209,20120214,9332,9310,9350,9376,9302,9310,9336,0,26,338218,31577257360,516176
443,y1209,20120215,9310,9336,9338,9354,9306,9308,9326,-28,-10,238024,22199828320,507310
444,y1209,20120216,9308,9326,9328,9330,9200,9252,9254,-74,-72,371452,34377999320,488616
445,y1209,20120217,9252,9254,9280,9366,9276,9352,9336,98,82,341186,31854728240,491012
446,y1209,20120220,9352,9336,9402,9446,9362,9376,9402,40,66,346728,32600881080,473372
447,y1209,20120221,9376,9402,9378,9416,9336,9402,9382,0,-20,338306,31741434480,484384
448,y1209,20120222,9402,9382,9412,9432,9382,9390,9402,8,20,308574,29013683000,479490
449,y1209,20120223,9390,9402,9396,9404,9342,9404,9366,2,-36,277572,25998329120,476650
450,y1209,20120224,9404,9366,9400,9412,9352,9362,9378,-4,12,302636,28383696320,457208
451,y1209,20120227,9362,9378,9374,9436,9374,9416,9414,38,36,262910,24752667960,461928
452,y1209,20120228,9416,9414,9436,9472,9436,9470,9456,56,42,220070,20814109040,477622
453,y1209,20120229,9470,9456,9460,9466,9424,9446,9438,-10,-18,200264,18902674640,457930
454,y1209,20120301,9446,9438,9380,9430,9332,9336,9388,-102,-50,309694,29076248560,464774
455,y1209,20120302,9336,9388,9370,9400,9368,9388,9384,0,-4,209032,19616703000,448320
456,y1209,20120305,9388,9384,9414,9434,9364,9402,9398,18,14,267434,25135841440,433660
457,y1209,20120306,9402,9398,9380,9384,9344,9354,9360,-44,-38,194144,18174065200,423846
458,y1209,20120307,9354,9360,9320,9340,9292,9310,9316,-50,-44,212580,19808107280,421290
459,y1209,20120308,9310,9316,9300,9372,9300,9360,9346,44,30,318068,29729298520,436036
460,y1209,20120309,9360,9346,9396,9584,9382,9576,9508,230,162,707966,67320831160,501318
461,y1209,20120312,9576,9508,9542,9564,9496,9526,9530,18,22,385166,36712690560,470938
462,y1209,20120313,9526,9530,9500,9596,9498,9588,9558,58,28,394128,37674405600,516602
463,y1209,20120314,9588,9558,9628,9718,9586,9612,9646,54,88,698192,67354233000,539940
464,y1209,20120315,9612,9646,9638,9686,9600,9640,9650,-6,4,611450,59008971080,565350
465,y1209,20120316,9640,9650,9698,9724,9620,9642,9674,-8,24,498424,48226102640,533760
466,y1209,20120319,9642,9674,9680,9720,9646,9678,9684,4,10,455168,44082389480,549164
467,y1209,20120320,9678,9684,9676,9676,9554,9558,9604,-126,-80,493268,47374429640,529370
468,y1209,20120321,9558,9604,9528,9572,9520,9554,9548,-50,-56,356868,34077900280,531350
469,y1209,20120322,9554,9548,9560,9600,9526,9532,9566,-16,18,492852,47146330560,509820
470,y1209,20120323,9532,9566,9552,9654,9550,9654,9598,88,32,511610,49107070320,544282
471,y1209,20120326,9654,9598,9682,9742,9666,9736,9720,138,122,458404,44563502880,553408
472,y1209,20120327,9736,9720,9750,9754,9708,9728,9724,8,4,334666,32548507680,538194
473,y1209,20120328,9728,9724,9690,9764,9670,9702,9716,-22,-8,548878,53333920520,543538
474,y1209,20120329,9702,9716,9680,9722,9606,9642,9660,-74,-56,589938,56999291000,516440
475,y1209,20120330,9642,9660,9600,9612,9558,9560,9584,-100,-76,374854,35928702000,496744
476,y1209,20120405,9560,9584,9810,9892,9776,9882,9826,298,242,491324,48278649160,503428
477,y1209,20120406,9882,9826,9926,9998,9898,9996,9948,170,122,607886,60474783640,522196
478,y1209,20120409,9996,9948,10020,10050,9978,9996,10012,48,64,572568,57330066920,531364
479,y1209,20120410,9996,10012,10000,10080,9976,10066,10016,54,4,502924,50379364080,547550
480,y1209,20120411,10066,10016,9978,9984,9894,9912,9926,-104,-90,473708,47026995280,507702
481,y1209,20120412,9912,9926,9910,9962,9888,9950,9928,24,2,430556,42748587920,519408
482,y1209,20120413,9950,9928,10030,10046,9984,9994,10012,66,84,495936,49655061440,517848
483,y1209,20120416,9994,10012,9850,9898,9830,9872,9868,-140,-144,447870,44199804800,506294
484,y1209,20120417,9872,9868,9858,9898,9852,9886,9878,18,10,363416,35904825800,514426
485,y1209,20120418,9886,9878,9916,9960,9800,9880,9884,2,6,804234,79496745280,489006
486,y1209,20120419,9880,9884,9848,9888,9834,9886,9858,2,-26,367024,36184205880,482110
487,y1209,20120420,9886,9858,9880,9914,9838,9876,9874,18,16,426104,42074271080,482356
488,y1209,20120423,9876,9874,9980,10010,9952,9960,9976,86,102,409210,40829116040,478066
489,y1209,20120424,9960,9976,9940,9958,9872,9898,9916,-78,-60,466310,46245895040,481822
490,y1209,20120425,9898,9916,9964,9978,9918,9928,9944,12,28,433334,43097807920,471066
491,y1209,20120426,9928,9944,9904,9958,9904,9932,9936,-12,-8,421744,41910231840,464246
492,y1209,20120427,9932,9936,9948,9968,9928,9946,9946,10,10,288440,28688527000,434938
493,y1209,20120502,9946,9946,9916,9952,9852,9864,9886,-82,-60,433236,42835393200,476718
494,y1209,20120503,9864,9886,9830,9848,9750,9758,9802,-128,-84,432424,42389618520,492240
495,y1209,20120504,9758,9802,9730,9778,9724,9772,9760,-30,-42,342144,33393577320,486232
496,y1209,20120507,9772,9760,9688,9704,9636,9666,9664,-94,-96,374212,36165695760,469600
497,y1209,20120508,9666,9664,9688,9738,9676,9712,9714,48,50,347528,33761258240,457744
498,y1209,20120509,9712,9714,9650,9696,9638,9692,9666,-22,-48,380638,36792871240,446616
499,y1209,20120510,9692,9666,9680,9764,9662,9750,9712,84,46,468710,45523939120,462532
500,y1209,20120511,9750,9712,9758,9760,9558,9566,9644,-146,-68,546946,52750226480,425474
501,y1209,20120514,9566,9644,9550,9556,9354,9390,9434,-254,-210,613196,57855606320,395764
502,y1209,20120515,9390,9434,9348,9374,9282,9362,9334,-72,-100,378936,35370630960,377450
503,y1209,20120516,9362,9334,9360,9402,9212,9230,9316,-104,-18,411780,38367495840,365238
504,y1209,20120517,9230,9316,9332,9350,9246,9314,9304,-2,-12,399706,37188732160,362514
505,y1209,20120518,9314,9304,9290,9290,9166,9188,9220,-116,-84,491984,45365478560,372792
506,y1209,20120521,9188,9220,9250,9324,9216,9288,9274,68,54,354994,32923946480,361260
507,y1209,20120522,9288,9274,9284,9330,9274,9296,9304,22,30,333366,31019423840,357876
508,y1209,20120523,9296,9304,9200,9200,9086,9110,9140,-194,-164,396108,36205990000,339402
509,y1209,20120524,9110,9140,9052,9136,9030,9128,9090,-12,-50,375354,34122214680,316368
510,y1209,20120525,9128,9090,9126,9130,9060,9112,9102,22,12,228642,20811671160,309058
511,y1209,20120528,9112,9102,9158,9214,9148,9196,9182,94,80,176128,16173196040,275868
512,y1209,20120529,9196,9182,9182,9238,9164,9226,9200,44,18,144520,13296257840,255556
513,y1209,20120530,9226,9200,9198,9210,9158,9168,9186,-32,-14,112250,10312560480,248388
514,y1209,20120531,9168,9186,9104,9144,9090,9094,9120,-92,-66,70042,6388060280,245880
515,y1209,20120601,9094,9120,9066,9078,8998,8998,9038,-122,-82,111628,10089771520,252448
516,y1209,20120604,8998,9038,8988,8988,8766,8810,8856,-228,-182,140864,12476614560,234952
517,y1209,20120605,8810,8856,8856,8920,8850,8904,8884,48,28,77414,6877513640,222750
518,y1209,20120606,8904,8884,8930,8992,8910,8956,8968,72,84,69532,6235874360,218194
519,y1209,20120607,8956,8968,9012,9056,8960,8988,9014,20,46,59368,5352139080,210584
520,y1209,20120608,8988,9014,9050,9050,8976,9004,9014,-10,0,80240,7233248720,199244
521,y1209,20120611,9004,9014,9120,9158,9052,9146,9120,132,106,78280,7139193040,189186
522,y1209,20120612,9146,9120,9000,9092,9000,9090,9066,-30,-54,47048,4265715600,180478
523,y1209,20120613,9090,9066,9116,9116,9062,9082,9076,16,10,37424,3397020560,168040
524,y1209,20120614,9082,9076,9038,9038,8922,8924,8968,-152,-108,53932,4837138280,160450
525,y1209,20120615,8924,8968,8900,8978,8900,8944,8948,-24,-20,35330,3161696000,160158
526,y1209,20120618,8944,8948,9050,9050,8976,9038,9022,90,74,26390,2381151760,157660
527,y1209,20120619,9038,9022,9058,9132,9050,9108,9096,86,74,33774,3072735160,148884
528,y1209,20120620,9108,9096,9198,9296,9170,9290,9238,194,142,41746,3857154200,133168
529,y1209,20120621,9290,9238,9240,9254,9176,9208,9218,-30,-20,31210,2877187960,120466
530,y1209,20120625,9208,9218,9268,9390,9268,9306,9350,88,132,20566,1922938040,114364
531,y1209,20120626,9306,9350,9350,9364,9242,9290,9290,-60,-60,18202,1691035880,109020
532,y1209,20120627,9290,9290,9290,9310,9242,9294,9274,4,-16,9996,927117040,105904
533,y1209,20120628,9294,9274,9308,9338,9258,9272,9286,-2,12,7978,740963040,103328
534,y1209,20120629,9272,9286,9258,9338,9234,9334,9294,48,8,7690,714778840,100740
535,y1209,20120702,9334,9294,9454,9520,9408,9424,9438,130,144,13828,1305279360,94838
536,y1209,20120703,9424,9438,9424,9500,9424,9492,9468,54,30,9082,859923320,91024
537,y1209,20120704,9492,9468,9468,9564,9468,9514,9534,46,66,15390,1467395960,84914
538,y1209,20120705,9514,9534,9504,9594,9492,9552,9534,18,0,10842,1033819000,80884
539,y1209,20120706,9552,9534,9596,9620,9516,9528,9576,-6,42,15900,1522730880,72978
540,y1209,20120709,9528,9576,9556,9662,9488,9652,9604,76,28,12752,1224736400,69670
541,y1209,20120710,9652,9604,9602,9634,9552,9552,9592,-52,-12,5622,539349520,68106
542,y1209,20120711,9552,9592,9558,9630,9454,9492,9558,-100,-34,6524,623613360,66640
543,y1209,20120712,9492,9558,9454,9456,9342,9354,9384,-204,-174,5274,494951800,65692
544,y1209,20120713,9354,9384,9384,9408,9342,9404,9382,20,-2,5534,519237560,63746
545,y1209,20120716,9404,9382,9450,9666,9450,9640,9614,258,232,6080,584550840,62788
546,y1209,20120717,9640,9614,9720,9720,9516,9600,9608,-14,-6,5758,553259960,61802
547,y1209,20120718,9600,9608,9594,9626,9466,9490,9504,-118,-104,8652,822414280,59100
548,y1209,20120719,9490,9504,9530,9584,9516,9564,9560,60,56,3950,377695440,56362
549,y1209,20120720,9564,9560,9574,9622,9532,9578,9576,18,16,5044,483060640,53280
550,y1209,20120723,9578,9576,9480,9480,9384,9404,9426,-172,-150,4738,446689480,49972
551,y1209,20120724,9404,9426,9286,9286,9062,9206,9224,-220,-202,12826,1183273120,48538
552,y1209,20120725,9206,9224,9170,9258,9106,9184,9198,-40,-26,18666,1717226520,45214
553,y1209,20120726,9184,9198,9210,9258,9168,9224,9212,26,14,5758,530445000,43278
554,y1209,20120727,9224,9212,9200,9310,9200,9308,9264,96,52,2906,269220680,44248
555,y1209,20120730,9308,9264,9324,9472,9324,9440,9432,176,168,1552,146403800,43644
556,y1209,20120731,9440,9432,9422,9448,9384,9442,9418,10,-14,6090,573557760,42412
557,y1209,20120801,9442,9418,9418,9522,9418,9496,9472,78,54,8350,790933920,34716
558,y1209,20120802,9496,9472,9380,9440,9340,9432,9396,-40,-76,1600,150356720,33870
559,y1209,20120803,9432,9396,9400,9436,9380,9434,9412,38,16,6732,633709920,33188
560,y1209,20120806,9434,9412,9398,9496,9398,9450,9464,38,52,1048,99194080,32722
561,y1209,20120807,9450,9464,9476,9538,9476,9520,9520,56,56,3952,376267800,29284
562,y1209,20120808,9520,9520,9466,9508,9462,9488,9490,-32,-30,2968,281690600,28610
563,y1209,20120809,9488,9490,9530,9620,9530,9616,9580,126,90,5580,534669840,23820
564,y1209,20120810,9616,9580,9650,9680,9582,9590,9624,10,44,7314,704023440,21346
565,y1209,20120813,9590,9624,9636,9690,9620,9650,9660,26,36,2374,229374400,20166
566,y1209,20120814,9650,9660,9630,9658,9510,9600,9602,-60,-58,6224,597731680,14992
567,y1209,20120815,9600,9602,9582,9594,9556,9588,9582,-14,-20,878,84138480,14382
568,y1209,20120816,9588,9582,9620,9620,9484,9520,9532,-62,-50,1790,170634240,13542
569,y1209,20120817,9520,9532,9568,9568,9516,9520,9536,-12,4,528,50350480,13198
570,y1209,20120820,9520,9536,9550,9550,9486,9508,9518,-28,-18,484,46071760,12868
571,y1209,20120821,9508,9518,9520,9598,9502,9580,9548,62,30,2824,269638680,11990
572,y1209,20120822,9580,9548,9620,9720,9608,9688,9672,140,124,1318,127493200,11130
573,y1209,20120823,9688,9672,9700,9742,9646,9658,9692,-14,20,912,88393840,10362
574,y1209,20120824,9658,9692,9684,9750,9622,9748,9692,56,0,186,18028480,10324
575,y1209,20120827,9748,9692,9820,9828,9800,9802,9804,110,112,290,28433440,10240
576,y1209,20120828,9802,9804,9748,9800,9740,9760,9758,-44,-46,1374,134093680,9010
577,y1209,20120829,9760,9758,9800,9800,9712,9796,9776,38,18,140,13687920,8916
578,y1209,20120830,9796,9776,9704,9818,9704,9816,9738,40,-38,728,70901560,8842
579,y1209,20120831,9816,9738,9652,9794,9652,9702,9700,-36,-38,212,20565440,8762
580,y1209,20120903,9702,9700,9920,9950,9700,9800,9848,100,148,18,1772800,6548
581,y1209,20120904,9800,9848,0,0,0,9848,9848,0,0,0,0,6016
582,y1209,20120905,9848,9848,10000,10000,9850,9850,9900,2,52,16,1584000,3416
583,y1209,20120906,9850,9900,9500,9940,9500,9800,9844,-100,-56,44,4331640,3366
584,y1209,20120907,9800,9844,9780,9780,9780,9780,9780,-64,-64,4,391200,2468
585,y1209,20120910,9780,9780,9900,9900,9200,9700,9600,-80,-180,6,576000,1920
586,y1209,20120911,9700,9600,0,0,0,9600,9600,0,0,0,0,1920
587,y1209,20120912,9600,9600,0,0,0,9600,9600,0,0,0,0,1350
588,y1209,20120913,9600,9600,0,0,0,9600,9600,0,0,0,0,1350
589,y1209,20120914,9600,9600,0,0,0,9600,9834,0,234,0,0,0
590,y1211,20120104,8978,8978,9120,9120,9120,9120,9120,142,142,2,182400,6
591,y1211,20120105,9120,9120,0,0,0,9120,9120,0,0,0,0,6
592,y1211,20120106,9120,9120,0,0,0,9120,9120,0,0,0,0,6
593,y1211,20120109,9120,9120,9104,9104,9104,9104,9104,-16,-16,2,182080,6
594,y1211,20120110,9104,9104,9122,9174,9122,9160,9144,56,40,22,2011680,4
595,y1211,20120111,9160,9144,0,0,0,9144,9144,0,0,0,0,4
596,y1211,20120112,9144,9144,0,0,0,9144,9144,0,0,0,0,4
597,y1211,20120113,9144,9144,0,0,0,9144,9144,0,0,0,0,4
598,y1211,20120116,9144,9144,0,0,0,9144,9144,0,0,0,0,4
599,y1211,20120117,9144,9144,8990,9010,8960,8962,8996,-182,-148,24,2159280,26
600,y1211,20120118,8962,8996,0,0,0,8996,8996,0,0,0,0,26
601,y1211,20120119,8996,8996,0,0,0,8996,8996,0,0,0,0,26
602,y1211,20120120,8996,8996,9068,9068,9004,9028,9034,32,38,10,903440,24
603,y1211,20120130,9028,9034,9040,9088,9040,9068,9062,34,28,16,1450200,8
604,y1211,20120131,9068,9062,0,0,0,9062,9062,0,0,0,0,8
605,y1211,20120201,9062,9062,0,0,0,9062,9062,0,0,0,0,8
606,y1211,20120202,9062,9062,0,0,0,9062,9062,0,0,0,0,8
607,y1211,20120203,9062,9062,0,0,0,9062,9062,0,0,0,0,8
608,y1211,20120206,9062,9062,0,0,0,9062,9062,0,0,0,0,8
609,y1211,20120207,9062,9062,0,0,0,9062,9062,0,0,0,0,8
610,y1211,20120208,9062,9062,9190,9272,9190,9272,9240,210,178,16,1478600,4
611,y1211,20120209,9272,9240,0,0,0,9240,9240,0,0,0,0,4
612,y1211,20120210,9240,9240,9258,9258,9258,9258,9258,18,18,2,185160,4
613,y1211,20120213,9258,9258,9324,9360,9324,9330,9338,72,80,12,1120560,4
614,y1211,20120214,9330,9338,9320,9348,9320,9348,9334,10,-4,4,373360,6
615,y1211,20120215,9348,9334,9322,9348,9316,9316,9334,-18,0,24,2240280,4
616,y1211,20120216,9316,9334,0,0,0,9334,9334,0,0,0,0,4
617,y1211,20120217,9334,9334,9352,9384,9352,9384,9368,50,34,4,374720,4
618,y1211,20120220,9384,9368,9480,9480,9398,9398,9436,30,68,14,1321240,6
619,y1211,20120221,9398,9436,9408,9444,9408,9412,9410,-24,-26,40,3764000,38
620,y1211,20120222,9412,9410,9444,9470,9418,9418,9454,8,44,40,3781800,4
621,y1211,20120223,9418,9454,0,0,0,9454,9454,0,0,0,0,4
622,y1211,20120224,9454,9454,0,0,0,9454,9454,0,0,0,0,4
623,y1211,20120227,9454,9454,0,0,0,9454,9454,0,0,0,0,4
624,y1211,20120228,9454,9454,0,0,0,9454,9454,0,0,0,0,4
625,y1211,20120229,9454,9454,0,0,0,9454,9454,0,0,0,0,4
626,y1211,20120301,9454,9454,0,0,0,9454,9454,0,0,0,0,4
627,y1211,20120302,9454,9454,9390,9438,9388,9394,9408,-60,-46,10,940800,6
628,y1211,20120305,9394,9408,9442,9442,9442,9442,9442,34,34,2,188840,6
629,y1211,20120306,9442,9442,9368,9416,9368,9400,9384,-42,-58,60,5631360,8
630,y1211,20120307,9400,9384,0,0,0,9384,9384,0,0,0,0,8
631,y1211,20120308,9384,9384,9370,9370,9370,9370,9370,-14,-14,10,937000,14
632,y1211,20120309,9370,9370,9500,9594,9500,9594,9560,224,190,24,2294600,4
633,y1211,20120312,9594,9560,0,0,0,9560,9560,0,0,0,0,4
634,y1211,20120313,9560,9560,0,0,0,9560,9560,0,0,0,0,4
635,y1211,20120314,9560,9560,9754,9754,9670,9670,9712,110,152,4,388480,6
636,y1211,20120315,9670,9712,9670,9686,9546,9686,9618,-26,-94,42,4039800,12
637,y1211,20120316,9686,9618,9722,9736,9722,9736,9726,118,108,6,583600,6
638,y1211,20120319,9736,9726,9686,9734,9680,9686,9692,-40,-34,10,969360,4
639,y1211,20120320,9686,9692,9666,9668,9666,9668,9666,-24,-26,4,386680,4
640,y1211,20120321,9668,9666,9562,9562,9562,9562,9562,-104,-104,22,2103640,18
641,y1211,20120322,9562,9562,9600,9616,9594,9594,9606,32,44,16,1536960,4
642,y1211,20120323,9594,9606,9608,9648,9608,9648,9626,42,20,16,1540160,8
643,y1211,20120326,9648,9626,0,0,0,9626,9626,0,0,0,0,8
644,y1211,20120327,9626,9626,0,0,0,9626,9626,0,0,0,0,8
645,y1211,20120328,9626,9626,9626,9770,9626,9750,9736,124,110,20,1947520,8
646,y1211,20120329,9750,9736,9700,9700,9634,9634,9660,-102,-76,18,1738880,14
647,y1211,20120330,9634,9660,9600,9654,9596,9628,9620,-32,-40,14,1346920,14
648,y1211,20120405,9628,9620,0,0,0,9620,9620,0,0,0,0,14
649,y1211,20120406,9620,9620,9922,10026,9922,10018,9978,398,358,54,5388840,22
650,y1211,20120409,10018,9978,10076,10076,10002,10002,10034,24,56,8,802760,24
651,y1211,20120410,10002,10034,10060,10064,10060,10064,10062,30,28,4,402480,28
652,y1211,20120411,10064,10062,10004,10004,10004,10004,10004,-58,-58,2,200080,28
653,y1211,20120412,10004,10004,0,0,0,10004,10004,0,0,0,0,28
654,y1211,20120413,10004,10004,0,0,0,10004,10004,0,0,0,0,28
655,y1211,20120416,10004,10004,9900,9930,9880,9896,9900,-108,-104,40,3960400,8
656,y1211,20120417,9896,9900,0,0,0,9900,9900,0,0,0,0,8
657,y1211,20120418,9900,9900,9840,9876,9840,9870,9860,-30,-40,18,1774840,10
658,y1211,20120419,9870,9860,0,0,0,9860,9860,0,0,0,0,10
659,y1211,20120420,9860,9860,0,0,0,9860,9860,0,0,0,0,10
660,y1211,20120423,9860,9860,9970,9988,9970,9988,9978,128,118,4,399160,12
661,y1211,20120424,9988,9978,9954,9978,9954,9978,9966,0,-12,4,398640,10
662,y1211,20120425,9978,9966,9986,9986,9986,9986,9986,20,20,2,199720,8
663,y1211,20120426,9986,9986,0,0,0,9986,9986,0,0,0,0,8
664,y1211,20120427,9986,9986,0,0,0,9986,9986,0,0,0,0,8
665,y1211,20120502,9986,9986,9864,9930,9864,9900,9908,-86,-78,18,1783480,10
666,y1211,20120503,9900,9908,0,0,0,9908,9908,0,0,0,0,10
667,y1211,20120504,9908,9908,9768,9830,9768,9820,9808,-88,-100,20,1961960,12
668,y1211,20120507,9820,9808,9746,9746,9702,9710,9718,-98,-90,14,1360520,10
669,y1211,20120508,9710,9718,9702,9840,9702,9794,9764,76,46,178,17380680,10
670,y1211,20120509,9794,9764,9702,9702,9700,9700,9700,-64,-64,4,388040,8
671,y1211,20120510,9700,9700,9728,9780,9728,9780,9754,80,54,4,390160,6
672,y1211,20120511,9780,9754,9702,9702,9594,9594,9652,-160,-102,8,772280,8
673,y1211,20120514,9594,9652,9456,9578,9414,9414,9504,-238,-148,12,1140600,8
674,y1211,20120515,9414,9504,9366,9366,9366,9366,9366,-138,-138,2,187320,6
675,y1211,20120516,9366,9366,9272,9428,9272,9428,9324,62,-42,6,559440,8
676,y1211,20120517,9428,9324,9386,9386,9386,9386,9386,62,62,4,375440,6
677,y1211,20120518,9386,9386,0,0,0,9386,9386,0,0,0,0,6
678,y1211,20120521,9386,9386,0,0,0,9386,9386,0,0,0,0,6
679,y1211,20120522,9386,9386,0,0,0,9386,9386,0,0,0,0,6
680,y1211,20120523,9386,9386,0,0,0,9386,9386,0,0,0,0,6
681,y1211,20120524,9386,9386,9102,9150,9102,9150,9132,-236,-254,8,730640,6
682,y1211,20120525,9150,9132,9150,9162,9150,9162,9156,30,24,4,366240,4
683,y1211,20120528,9162,9156,0,0,0,9156,9156,0,0,0,0,4
684,y1211,20120529,9156,9156,0,0,0,9156,9156,0,0,0,0,4
685,y1211,20120530,9156,9156,0,0,0,9156,9156,0,0,0,0,4
686,y1211,20120531,9156,9156,0,0,0,9156,9156,0,0,0,0,4
687,y1211,20120601,9156,9156,0,0,0,9156,9156,0,0,0,0,4
688,y1211,20120604,9156,9156,0,0,0,9156,9156,0,0,0,0,4
689,y1211,20120605,9156,9156,0,0,0,9156,9156,0,0,0,0,4
690,y1211,20120606,9156,9156,0,0,0,9156,9156,0,0,0,0,4
691,y1211,20120607,9156,9156,0,0,0,9156,9156,0,0,0,0,4
692,y1211,20120608,9156,9156,0,0,0,9156,9156,0,0,0,0,4
693,y1211,20120611,9156,9156,9138,9138,9138,9138,9138,-18,-18,2,182760,4
694,y1211,20120612,9138,9138,0,0,0,9138,9138,0,0,0,0,4
695,y1211,20120613,9138,9138,0,0,0,9138,9138,0,0,0,0,4
696,y1211,20120614,9138,9138,9046,9046,9046,9046,9046,-92,-92,2,180920,4
697,y1211,20120615,9046,9046,0,0,0,9046,9046,0,0,0,0,4
698,y1211,20120618,9046,9046,0,0,0,9046,9046,0,0,0,0,4
699,y1211,20120619,9046,9046,0,0,0,9046,9046,0,0,0,0,4
700,y1211,20120620,9046,9046,0,0,0,9046,9046,0,0,0,0,4
701,y1211,20120621,9046,9046,0,0,0,9046,9046,0,0,0,0,4
702,y1211,20120625,9046,9046,9406,9406,9406,9406,9406,360,360,2,188120,4
703,y1211,20120626,9406,9406,0,0,0,9406,9406,0,0,0,0,4
704,y1211,20120627,9406,9406,9350,9350,9350,9350,9350,-56,-56,4,374000,4
705,y1211,20120628,9350,9350,0,0,0,9350,9350,0,0,0,0,4
706,y1211,20120629,9350,9350,0,0,0,9350,9350,0,0,0,0,4
707,y1211,20120702,9350,9350,0,0,0,9350,9350,0,0,0,0,4
708,y1211,20120703,9350,9350,0,0,0,9350,9350,0,0,0,0,4
709,y1211,20120704,9350,9350,0,0,0,9350,9350,0,0,0,0,4
710,y1211,20120705,9350,9350,0,0,0,9350,9350,0,0,0,0,4
711,y1211,20120706,9350,9350,0,0,0,9350,9350,0,0,0,0,4
712,y1211,20120709,9350,9350,0,0,0,9350,9350,0,0,0,0,4
713,y1211,20120710,9350,9350,0,0,0,9350,9350,0,0,0,0,4
714,y1211,20120711,9350,9350,0,0,0,9350,9350,0,0,0,0,4
715,y1211,20120712,9350,9350,9614,9614,9494,9494,9558,144,208,10,955800,6
716,y1211,20120713,9494,9558,9480,9484,9478,9484,9480,-74,-78,6,568840,4
717,y1211,20120716,9484,9480,9796,9796,9700,9700,9740,220,260,8,779240,4
718,y1211,20120717,9700,9740,0,0,0,9740,9740,0,0,0,0,4
719,y1211,20120718,9740,9740,0,0,0,9740,9740,0,0,0,0,4
720,y1211,20120719,9740,9740,0,0,0,9740,9740,0,0,0,0,4
721,y1211,20120720,9740,9740,0,0,0,9740,9740,0,0,0,0,4
722,y1211,20120723,9740,9740,9526,9582,9354,9582,9452,-158,-288,148,13990880,6
723,y1211,20120724,9582,9452,0,0,0,9452,9452,0,0,0,0,6
724,y1211,20120725,9452,9452,9278,9278,9212,9212,9244,-240,-208,4,369800,4
725,y1211,20120726,9212,9244,0,0,0,9244,9244,0,0,0,0,4
726,y1211,20120727,9244,9244,0,0,0,9244,9244,0,0,0,0,4
727,y1211,20120730,9244,9244,0,0,0,9244,9244,0,0,0,0,4
728,y1211,20120731,9244,9244,0,0,0,9244,9244,0,0,0,0,4
729,y1211,20120801,9244,9244,0,0,0,9244,9244,0,0,0,0,4
730,y1211,20120802,9244,9244,0,0,0,9244,9244,0,0,0,0,4
731,y1211,20120803,9244,9244,0,0,0,9244,9244,0,0,0,0,4
732,y1211,20120806,9244,9244,0,0,0,9244,9244,0,0,0,0,4
733,y1211,20120807,9244,9244,0,0,0,9244,9244,0,0,0,0,4
734,y1211,20120808,9244,9244,0,0,0,9244,9244,0,0,0,0,4
735,y1211,20120809,9244,9244,0,0,0,9244,9244,0,0,0,0,4
736,y1211,20120810,9244,9244,0,0,0,9244,9244,0,0,0,0,4
737,y1211,20120813,9244,9244,0,0,0,9244,9244,0,0,0,0,4
738,y1211,20120814,9244,9244,0,0,0,9244,9244,0,0,0,0,4
739,y1211,20120815,9244,9244,0,0,0,9244,9244,0,0,0,0,4
740,y1211,20120816,9244,9244,0,0,0,9244,9244,0,0,0,0,4
741,y1211,20120817,9244,9244,0,0,0,9244,9244,0,0,0,0,4
742,y1211,20120820,9244,9244,0,0,0,9244,9244,0,0,0,0,4
743,y1211,20120821,9244,9244,0,0,0,9244,9244,0,0,0,0,4
744,y1211,20120822,9244,9244,0,0,0,9244,9244,0,0,0,0,4
745,y1211,20120823,9244,9244,0,0,0,9244,9244,0,0,0,0,4
746,y1211,20120824,9244,9244,0,0,0,9244,9244,0,0,0,0,4
747,y1211,20120827,9244,9244,0,0,0,9244,9244,0,0,0,0,4
748,y1211,20120828,9244,9244,9870,9870,9870,9870,9870,626,626,2,197400,2
749,y1211,20120829,9870,9870,0,0,0,9870,9870,0,0,0,0,2
750,y1211,20120830,9870,9870,0,0,0,9870,9870,0,0,0,0,2
751,y1211,20120831,9870,9870,0,0,0,9870,9870,0,0,0,0,2
752,y1211,20120903,9870,9870,0,0,0,9870,9870,0,0,0,0,2
753,y1211,20120904,9870,9870,0,0,0,9870,9870,0,0,0,0,2
754,y1211,20120905,9870,9870,0,0,0,9870,9870,0,0,0,0,2
755,y1211,20120906,9870,9870,0,0,0,9870,9870,0,0,0,0,2
756,y1211,20120907,9870,9870,0,0,0,9870,9870,0,0,0,0,2
757,y1211,20120910,9870,9870,0,0,0,9870,9870,0,0,0,0,2
758,y1211,20120911,9870,9870,0,0,0,9870,9870,0,0,0,0,2
759,y1211,20120912,9870,9870,0,0,0,9870,9870,0,0,0,0,2
760,y1211,20120913,9870,9870,0,0,0,9870,9870,0,0,0,0,2
761,y1211,20120914,9870,9870,0,0,0,9870,9870,0,0,0,0,2
762,y1211,20120917,9870,9870,0,0,0,9870,9870,0,0,0,0,2
763,y1211,20120918,9870,9870,9790,9790,9658,9712,9722,-158,-148,10,972200,2
764,y1211,20120919,9712,9722,9706,9706,9706,9706,9706,-16,-16,2,194120,2
765,y1211,20120920,9706,9706,9620,9620,9620,9620,9620,-86,-86,2,192400,2
766,y1211,20120921,9620,9620,0,0,0,9620,9620,0,0,0,0,2
767,y1211,20120924,9620,9620,9610,9610,9610,9610,9610,-10,-10,2,192200,2
768,y1211,20120925,9610,9610,9236,9642,9236,9400,9384,-210,-226,16,1501720,2
769,y1211,20120926,9400,9384,0,0,0,9384,9384,0,0,0,0,2
770,y1211,20120927,9384,9384,0,0,0,9384,9384,0,0,0,0,2
771,y1211,20120928,9384,9384,8780,9550,8780,9140,9162,-244,-222,216,19790880,10
772,y1211,20121008,9140,9162,9042,9042,8850,9020,8982,-142,-180,8,718640,8
773,y1211,20121009,9020,8982,0,0,0,8982,8982,0,0,0,0,8
774,y1211,20121010,8982,8982,0,0,0,8982,8982,0,0,0,0,8
775,y1211,20121011,8982,8982,9044,9044,9044,9044,9044,62,62,4,361760,4
776,y1211,20121012,9044,9044,0,0,0,9044,9044,0,0,0,0,4
777,y1211,20121015,9044,9044,0,0,0,9044,9044,0,0,0,0,4
778,y1211,20121016,9044,9044,0,0,0,9044,9044,0,0,0,0,4
779,y1211,20121017,9044,9044,0,0,0,9044,9044,0,0,0,0,4
780,y1211,20121018,9044,9044,0,0,0,9044,9044,0,0,0,0,4
781,y1211,20121019,9044,9044,0,0,0,9044,9044,0,0,0,0,4
782,y1211,20121022,9044,9044,0,0,0,9044,9044,0,0,0,0,4
783,y1211,20121023,9044,9044,9172,9284,9172,9284,9228,240,184,8,738240,4
784,y1211,20121024,9284,9228,0,0,0,9228,9228,0,0,0,0,4
785,y1211,20121025,9228,9228,9488,9488,9488,9488,9488,260,260,4,379520,4
786,y1211,20121026,9488,9488,0,0,0,9488,9488,0,0,0,0,4
787,y1211,20121029,9488,9488,0,0,0,9488,9488,0,0,0,0,4
788,y1211,20121030,9488,9488,0,0,0,9488,9488,0,0,0,0,4
789,y1211,20121031,9488,9488,9110,9120,9110,9120,9112,-368,-376,6,546800,4
790,y1211,20121101,9120,9112,8566,8566,8566,8566,8566,-546,-546,2,171320,4
791,y1211,20121102,8566,8566,0,0,0,8566,8566,0,0,0,0,4
792,y1211,20121105,8566,8566,0,0,0,8566,8566,0,0,0,0,4
793,y1211,20121106,8566,8566,0,0,0,8566,8566,0,0,0,0,4
794,y1211,20121107,8566,8566,0,0,0,8566,8566,0,0,0,0,0
795,y1211,20121108,8566,8566,0,0,0,8566,8566,0,0,0,0,0
796,y1211,20121109,8566,8566,0,0,0,8566,8566,0,0,0,0,0
797,y1211,20121112,8566,8566,0,0,0,8566,8566,0,0,0,0,0
798,y1211,20121113,8566,8566,0,0,0,8566,8566,0,0,0,0,0
799,y1211,20121114,8566,8566,0,0,0,8566,8566,0,0,0,0,0
800,y1212,20120104,8746,8746,0,0,0,8746,8746,0,0,0,0,0
801,y1212,20120105,8746,8746,0,0,0,8746,8746,0,0,0,0,0
802,y1212,20120106,8746,8746,0,0,0,8746,8746,0,0,0,0,0
803,y1212,20120109,8746,8746,0,0,0,8746,8746,0,0,0,0,0
804,y1212,20120110,8746,8746,0,0,0,8746,8746,0,0,0,0,0
805,y1212,20120111,8746,8746,0,0,0,8746,8746,0,0,0,0,0
806,y1212,20120112,8746,8746,0,0,0,8746,8746,0,0,0,0,0
807,y1212,20120113,8746,8746,0,0,0,8746,8746,0,0,0,0,0
808,y1212,20120116,8746,8746,0,0,0,8746,8746,0,0,0,0,0
809,y1212,20120117,8746,8746,0,0,0,8746,8746,0,0,0,0,0
810,y1212,20120118,8746,8746,0,0,0,8746,8746,0,0,0,0,0
811,y1212,20120119,8746,8746,0,0,0,8746,8746,0,0,0,0,0
812,y1212,20120120,8746,8746,0,0,0,8746,8746,0,0,0,0,0
813,y1212,20120130,8746,8746,0,0,0,8746,8746,0,0,0,0,0
814,y1212,20120131,8746,8746,0,0,0,8746,8746,0,0,0,0,0
815,y1212,20120201,8746,8746,0,0,0,8746,8746,0,0,0,0,0
816,y1212,20120202,8746,8746,0,0,0,8746,8746,0,0,0,0,0
817,y1212,20120203,8746,8746,0,0,0,8746,8746,0,0,0,0,0
818,y1212,20120206,8746,8746,9188,9256,9188,9240,9220,494,474,28,2581680,4
819,y1212,20120207,9240,9220,0,0,0,9220,9220,0,0,0,0,4
820,y1212,20120208,9220,9220,0,0,0,9220,9220,0,0,0,0,4
821,y1212,20120209,9220,9220,0,0,0,9220,9220,0,0,0,0,4
822,y1212,20120210,9220,9220,0,0,0,9220,9220,0,0,0,0,4
823,y1212,20120213,9220,9220,0,0,0,9220,9220,0,0,0,0,4
824,y1212,20120214,9220,9220,9220,9364,9220,9364,9292,144,72,4,371680,6
825,y1212,20120215,9364,9292,0,0,0,9292,9292,0,0,0,0,6
826,y1212,20120216,9292,9292,9250,9250,9250,9250,9250,-42,-42,2,185000,6
827,y1212,20120217,9250,9250,9380,9524,9332,9366,9420,116,170,94,8855760,12
828,y1212,20120220,9366,9420,0,0,0,9420,9420,0,0,0,0,12
829,y1212,20120221,9420,9420,9380,9470,9380,9470,9424,50,4,4,377000,14
830,y1212,20120222,9470,9424,9452,9452,9444,9444,9448,20,24,6,566960,10
831,y1212,20120223,9444,9448,9400,9400,9400,9400,9400,-48,-48,2,188000,10
832,y1212,20120224,9400,9400,0,0,0,9400,9400,0,0,0,0,10
833,y1212,20120227,9400,9400,0,0,0,9400,9400,0,0,0,0,10
834,y1212,20120228,9400,9400,9474,9474,9470,9470,9472,70,72,4,378880,6
835,y1212,20120229,9470,9472,9498,9498,9450,9450,9474,-22,2,4,378960,8
836,y1212,20120301,9450,9474,0,0,0,9474,9474,0,0,0,0,8
837,y1212,20120302,9474,9474,0,0,0,9474,9474,0,0,0,0,8
838,y1212,20120305,9474,9474,0,0,0,9474,9474,0,0,0,0,8
839,y1212,20120306,9474,9474,0,0,0,9474,9474,0,0,0,0,8
840,y1212,20120307,9474,9474,0,0,0,9474,9474,0,0,0,0,8
841,y1212,20120308,9474,9474,0,0,0,9474,9474,0,0,0,0,8
842,y1212,20120309,9474,9474,0,0,0,9474,9474,0,0,0,0,8
843,y1212,20120312,9474,9474,0,0,0,9474,9474,0,0,0,0,8
844,y1212,20120313,9474,9474,9600,9600,9530,9530,9564,56,90,4,382600,6
845,y1212,20120314,9530,9564,0,0,0,9564,9564,0,0,0,0,6
846,y1212,20120315,9564,9564,0,0,0,9564,9564,0,0,0,0,6
847,y1212,20120316,9564,9564,0,0,0,9564,9564,0,0,0,0,6
848,y1212,20120319,9564,9564,0,0,0,9564,9564,0,0,0,0,6
849,y1212,20120320,9564,9564,0,0,0,9564,9564,0,0,0,0,6
850,y1212,20120321,9564,9564,0,0,0,9564,9564,0,0,0,0,6
851,y1212,20120322,9564,9564,9610,9610,9610,9610,9610,46,46,2,192200,8
852,y1212,20120323,9610,9610,0,0,0,9610,9610,0,0,0,0,8
853,y1212,20120326,9610,9610,9738,9738,9738,9738,9738,128,128,2,194760,6
854,y1212,20120327,9738,9738,9718,9718,9718,9718,9718,-20,-20,2,194360,6
855,y1212,20120328,9718,9718,0,0,0,9718,9718,0,0,0,0,6
856,y1212,20120329,9718,9718,0,0,0,9718,9718,0,0,0,0,6
857,y1212,20120330,9718,9718,9642,9642,9550,9562,9594,-156,-124,8,767600,6
858,y1212,20120405,9562,9594,0,0,0,9594,9594,0,0,0,0,6
859,y1212,20120406,9594,9594,0,0,0,9594,9594,0,0,0,0,6
860,y1212,20120409,9594,9594,0,0,0,9594,9594,0,0,0,0,6
861,y1212,20120410,9594,9594,0,0,0,9594,9594,0,0,0,0,6
862,y1212,20120411,9594,9594,0,0,0,9594,9594,0,0,0,0,6
863,y1212,20120412,9594,9594,0,0,0,9594,9594,0,0,0,0,6
864,y1212,20120413,9594,9594,0,0,0,9594,9594,0,0,0,0,6
865,y1212,20120416,9594,9594,0,0,0,9594,9594,0,0,0,0,6
866,y1212,20120417,9594,9594,9976,9976,9976,9976,9976,382,382,6,598560,12
867,y1212,20120418,9976,9976,9976,9978,9960,9960,9974,-16,-2,14,1396400,6
868,y1212,20120419,9960,9974,0,0,0,9974,9974,0,0,0,0,6
869,y1212,20120420,9974,9974,0,0,0,9974,9974,0,0,0,0,6
870,y1212,20120423,9974,9974,0,0,0,9974,9974,0,0,0,0,6
871,y1212,20120424,9974,9974,9960,9960,9960,9960,9960,-14,-14,2,199200,6
872,y1212,20120425,9960,9960,9970,9970,9970,9970,9970,10,10,4,398800,2
873,y1212,20120426,9970,9970,0,0,0,9970,9970,0,0,0,0,2
874,y1212,20120427,9970,9970,0,0,0,9970,9970,0,0,0,0,2
875,y1212,20120502,9970,9970,0,0,0,9970,9970,0,0,0,0,2
876,y1212,20120503,9970,9970,0,0,0,9970,9970,0,0,0,0,2
877,y1212,20120504,9970,9970,0,0,0,9970,9970,0,0,0,0,2
878,y1212,20120507,9970,9970,9676,9676,9676,9676,9676,-294,-294,4,387040,6
879,y1212,20120508,9676,9676,0,0,0,9676,9676,0,0,0,0,6
880,y1212,20120509,9676,9676,9688,9688,9688,9688,9688,12,12,2,193760,6
881,y1212,20120510,9688,9688,0,0,0,9688,9688,0,0,0,0,6
882,y1212,20120511,9688,9688,9724,9726,9724,9726,9724,38,36,4,389000,4
883,y1212,20120514,9726,9724,0,0,0,9724,9724,0,0,0,0,4
884,y1212,20120515,9724,9724,9420,9420,9420,9420,9420,-304,-304,2,188400,4
885,y1212,20120516,9420,9420,0,0,0,9420,9420,0,0,0,0,4
886,y1212,20120517,9420,9420,0,0,0,9420,9420,0,0,0,0,4
887,y1212,20120518,9420,9420,9340,9340,9260,9300,9300,-120,-120,86,7999040,6
888,y1212,20120521,9300,9300,0,0,0,9300,9300,0,0,0,0,6
889,y1212,20120522,9300,9300,9318,9376,9318,9376,9358,76,58,14,1310320,14
890,y1212,20120523,9376,9358,9222,9222,9140,9156,9182,-202,-176,14,1285680,12
891,y1212,20120524,9156,9182,9156,9156,9156,9156,9156,-26,-26,2,183120,12
892,y1212,20120525,9156,9156,9150,9150,9150,9150,9150,-6,-6,2,183000,12
893,y1212,20120528,9150,9150,0,0,0,9150,9150,0,0,0,0,12
894,y1212,20120529,9150,9150,0,0,0,9150,9150,0,0,0,0,12
895,y1212,20120530,9150,9150,9318,9318,9254,9254,9286,104,136,4,371440,12
896,y1212,20120531,9254,9286,9202,9268,9154,9174,9230,-112,-56,80,7385520,14
897,y1212,20120601,9174,9230,0,0,0,9230,9230,0,0,0,0,14
898,y1212,20120604,9230,9230,8950,8950,8950,8950,8950,-280,-280,2,179000,16
899,y1212,20120605,8950,8950,8868,9010,8868,9010,8946,60,-4,22,1968200,24
900,y1212,20120606,9010,8946,9030,9030,9006,9006,9010,60,64,10,901080,16
901,y1212,20120607,9006,9010,9140,9140,9080,9112,9110,102,100,6,546640,18
902,y1212,20120608,9112,9110,9122,9150,9122,9150,9144,40,34,10,914400,18
903,y1212,20120611,9150,9144,9288,9288,9260,9260,9274,116,130,4,370960,18
904,y1212,20120612,9260,9274,9200,9236,9200,9210,9212,-64,-62,14,1289720,16
905,y1212,20120613,9210,9212,9224,9224,9132,9180,9182,-32,-30,20,1836440,16
906,y1212,20120614,9180,9182,9088,9088,9042,9066,9064,-116,-118,6,543920,18
907,y1212,20120615,9066,9064,0,0,0,9064,9064,0,0,0,0,18
908,y1212,20120618,9064,9064,0,0,0,9064,9064,0,0,0,0,18
909,y1212,20120619,9064,9064,9202,9202,9014,9014,9108,-50,44,4,364320,16
910,y1212,20120620,9014,9108,9354,9430,9330,9420,9360,312,252,48,4493000,16
911,y1212,20120621,9420,9360,9342,9428,9320,9336,9356,-24,-4,50,4678520,14
912,y1212,20120625,9336,9356,9452,9544,9438,9538,9510,182,154,38,3614320,10
913,y1212,20120626,9538,9510,0,0,0,9510,9510,0,0,0,0,10
914,y1212,20120627,9510,9510,9458,9458,9458,9458,9458,-52,-52,2,189160,12
915,y1212,20120628,9458,9458,9452,9452,9432,9432,9442,-26,-16,4,377680,12
916,y1212,20120629,9432,9442,0,0,0,9442,9442,0,0,0,0,12
917,y1212,20120702,9442,9442,9590,9590,9564,9564,9576,122,134,4,383080,8
918,y1212,20120703,9564,9576,0,0,0,9576,9576,0,0,0,0,8
919,y1212,20120704,9576,9576,0,0,0,9576,9576,0,0,0,0,8
920,y1212,20120705,9576,9576,0,0,0,9576,9576,0,0,0,0,8
921,y1212,20120706,9576,9576,0,0,0,9576,9576,0,0,0,0,8
922,y1212,20120709,9576,9576,9608,9688,9608,9682,9646,106,70,8,771720,8
923,y1212,20120710,9682,9646,0,0,0,9646,9646,0,0,0,0,8
924,y1212,20120711,9646,9646,0,0,0,9646,9646,0,0,0,0,8
925,y1212,20120712,9646,9646,9666,9666,9478,9478,9572,-168,-74,4,382880,8
926,y1212,20120713,9478,9572,0,0,0,9572,9572,0,0,0,0,8
927,y1212,20120716,9572,9572,9808,9808,9754,9798,9778,226,206,8,782280,6
928,y1212,20120717,9798,9778,0,0,0,9778,9778,0,0,0,0,6
929,y1212,20120718,9778,9778,0,0,0,9778,9778,0,0,0,0,6
930,y1212,20120719,9778,9778,9778,9778,9724,9724,9750,-54,-28,4,390040,4
931,y1212,20120720,9724,9750,0,0,0,9750,9750,0,0,0,0,4
932,y1212,20120723,9750,9750,0,0,0,9750,9750,0,0,0,0,4
933,y1212,20120724,9750,9750,0,0,0,9750,9750,0,0,0,0,4
934,y1212,20120725,9750,9750,0,0,0,9750,9750,0,0,0,0,4
935,y1212,20120726,9750,9750,9270,9302,9268,9268,9288,-482,-462,12,1114760,6
936,y1212,20120727,9268,9288,9286,9286,9286,9286,9286,-2,-2,2,185720,6
937,y1212,20120730,9286,9286,9472,9508,9470,9508,9482,222,196,6,569000,6
938,y1212,20120731,9508,9482,9400,9400,9400,9400,9400,-82,-82,2,188000,6
939,y1212,20120801,9400,9400,9500,9514,9450,9514,9486,114,86,10,948680,6
940,y1212,20120802,9514,9486,0,0,0,9486,9486,0,0,0,0,6
941,y1212,20120803,9486,9486,0,0,0,9486,9486,0,0,0,0,6
942,y1212,20120806,9486,9486,9486,9486,9486,9486,9486,0,0,2,189720,6
943,y1212,20120807,9486,9486,9522,9522,9522,9522,9522,36,36,2,190440,4
944,y1212,20120808,9522,9522,0,0,0,9522,9522,0,0,0,0,4
945,y1212,20120809,9522,9522,9650,9650,9650,9650,9650,128,128,4,386000,6
946,y1212,20120810,9650,9650,9680,9680,9680,9680,9680,30,30,6,580800,10
947,y1212,20120813,9680,9680,9696,9696,9696,9696,9696,16,16,2,193920,8
948,y1212,20120814,9696,9696,9622,9622,9566,9566,9594,-130,-102,4,383760,8
949,y1212,20120815,9566,9594,9646,9646,9614,9614,9630,20,36,4,385200,8
950,y1212,20120816,9614,9630,9704,9704,9624,9624,9664,-6,34,4,386560,8
951,y1212,20120817,9624,9664,9664,9668,9620,9620,9642,-44,-22,8,771440,8
952,y1212,20120820,9620,9642,0,0,0,9642,9642,0,0,0,0,8
953,y1212,20120821,9642,9642,0,0,0,9642,9642,0,0,0,0,8
954,y1212,20120822,9642,9642,0,0,0,9642,9642,0,0,0,0,8
955,y1212,20120823,9642,9642,0,0,0,9642,9642,0,0,0,0,8
956,y1212,20120824,9642,9642,9978,9978,9870,9944,9908,302,266,22,2179960,6
957,y1212,20120827,9944,9908,0,0,0,9908,9908,0,0,0,0,6
958,y1212,20120828,9908,9908,9876,9876,9876,9876,9876,-32,-32,4,395040,10
959,y1212,20120829,9876,9876,9854,9854,9854,9854,9854,-22,-22,2,197080,8
960,y1212,20120830,9854,9854,9948,9948,9948,9948,9948,94,94,2,198960,8
961,y1212,20120831,9948,9948,9928,9928,9854,9854,9896,-94,-52,26,2572960,8
962,y1212,20120903,9854,9896,0,0,0,9896,9896,0,0,0,0,8
963,y1212,20120904,9896,9896,0,0,0,9896,9896,0,0,0,0,8
964,y1212,20120905,9896,9896,0,0,0,9896,9896,0,0,0,0,8
965,y1212,20120906,9896,9896,10068,10098,9954,9954,10042,58,146,44,4419280,10
966,y1212,20120907,9954,10042,0,0,0,10042,10042,0,0,0,0,10
967,y1212,20120910,10042,10042,0,0,0,10042,10042,0,0,0,0,10
968,y1212,20120911,10042,10042,0,0,0,10042,10042,0,0,0,0,10
969,y1212,20120912,10042,10042,0,0,0,10042,10042,0,0,0,0,10
970,y1212,20120913,10042,10042,9940,10018,9926,9926,9974,-116,-68,18,1795440,12
971,y1212,20120914,9926,9974,10050,10066,9994,9994,10032,20,58,8,802640,14
972,y1212,20120917,9994,10032,0,0,0,10032,10032,0,0,0,0,14
973,y1212,20120918,10032,10032,9752,9806,9670,9682,9704,-350,-328,22,2134880,12
974,y1212,20120919,9682,9704,9720,9720,9676,9714,9708,10,4,12,1165000,12
975,y1212,20120920,9714,9708,0,0,0,9708,9708,0,0,0,0,12
976,y1212,20120921,9708,9708,0,0,0,9708,9708,0,0,0,0,12
977,y1212,20120924,9708,9708,9384,9384,9344,9344,9372,-364,-336,20,1874400,12
978,y1212,20120925,9344,9372,9466,9466,9466,9466,9466,94,94,2,189320,10
979,y1212,20120926,9466,9466,9260,9260,9260,9260,9260,-206,-206,2,185200,8
980,y1212,20120927,9260,9260,0,0,0,9260,9260,0,0,0,0,8
981,y1212,20120928,9260,9260,0,0,0,9260,9260,0,0,0,0,8
982,y1212,20121008,9260,9260,9030,9040,9030,9040,9034,-220,-226,4,361400,10
983,y1212,20121009,9040,9034,9106,9148,9002,9072,9088,38,54,12,1090680,12
984,y1212,20121010,9072,9088,0,0,0,9088,9088,0,0,0,0,12
985,y1212,20121011,9088,9088,9046,9248,9046,9112,9142,24,54,28,2560160,18
986,y1212,20121012,9112,9142,9014,9184,9014,9070,9104,-72,-38,272,24768240,26
987,y1212,20121015,9070,9104,9008,9048,8764,8980,8974,-124,-130,58,5205160,30
988,y1212,20121016,8980,8974,9078,9080,9028,9076,9056,102,82,38,3441920,34
989,y1212,20121017,9076,9056,9104,9106,9076,9082,9086,26,30,12,1090480,30
990,y1212,20121018,9082,9086,9120,9138,9100,9100,9114,14,28,24,2187520,18
991,y1212,20121019,9100,9114,9092,9122,9092,9122,9106,8,-8,4,364280,16
992,y1212,20121022,9122,9106,0,0,0,9106,9106,0,0,0,0,16
993,y1212,20121023,9106,9106,0,0,0,9106,9106,0,0,0,0,16
994,y1212,20121024,9106,9106,9132,9132,9122,9122,9126,16,20,4,365080,12
995,y1212,20121025,9122,9126,0,0,0,9126,9126,0,0,0,0,12
996,y1212,20121026,9126,9126,9004,9004,8996,8996,9000,-130,-126,4,360000,8
997,y1212,20121029,8996,9000,0,0,0,9000,9000,0,0,0,0,8
998,y1212,20121030,9000,9000,0,0,0,9000,9000,0,0,0,0,8
999,y1212,20121031,9000,9000,8842,8908,8830,8908,8862,-92,-138,8,709040,8
1000,y1212,20121101,8908,8862,8862,8862,8862,8862,8862,0,0,2,177240,10
1001,y1212,20121102,8862,8862,0,0,0,8862,8862,0,0,0,0,10
1002,y1212,20121105,8862,8862,8542,8542,8518,8518,8532,-344,-330,10,853200,8
1003,y1212,20121106,8518,8532,8540,8638,8540,8638,8584,106,52,6,515120,6
1004,y1212,20121107,8638,8584,8314,8738,8314,8580,8530,-4,-54,236,20132640,6
1005,y1212,20121108,8580,8530,0,0,0,8530,8530,0,0,0,0,6
1006,y1212,20121109,8530,8530,0,0,0,8530,8530,0,0,0,0,6
1007,y1212,20121112,8530,8530,0,0,0,8530,8530,0,0,0,0,6
1008,y1212,20121113,8530,8530,0,0,0,8530,8530,0,0,0,0,6
1009,y1212,20121114,8530,8530,0,0,0,8530,8530,0,0,0,0,6
1010,y1212,20121115,8530,8530,8190,8190,8190,8190,8190,-340,-340,2,163800,6
1011,y1212,20121116,8190,8190,7864,8188,7864,8188,8026,-2,-164,4,321040,6
1012,y1212,20121119,8188,8026,0,0,0,8026,8026,0,0,0,0,6
1013,y1212,20121120,8026,8026,8180,8180,7832,8144,8084,118,58,10,808520,6
1014,y1212,20121121,8144,8084,8246,8246,8246,8246,8246,162,162,2,164920,8
1015,y1212,20121122,8246,8246,0,0,0,8246,8246,0,0,0,0,8
1016,y1212,20121123,8246,8246,8266,8266,8236,8236,8250,-10,4,4,330040,6
1017,y1212,20121126,8236,8250,0,0,0,8250,8250,0,0,0,0,6
1018,y1212,20121127,8250,8250,0,0,0,8250,8250,0,0,0,0,6
1019,y1212,20121128,8250,8250,8270,8270,8270,8270,8270,20,20,2,165400,8
1020,y1212,20121129,8270,8270,8280,8280,8280,8280,8280,10,10,2,165600,6
1021,y1212,20121130,8280,8280,0,0,0,8280,8280,0,0,0,0,6
1022,y1212,20121203,8280,8280,7784,7784,7784,7784,7784,-496,-496,6,467040,2
1023,y1212,20121204,7784,7784,0,0,0,7784,7784,0,0,0,0,0
1024,y1212,20121205,7784,7784,0,0,0,7784,7784,0,0,0,0,0
1025,y1212,20121206,7784,7784,0,0,0,7784,7784,0,0,0,0,0
1026,y1212,20121207,7784,7784,0,0,0,7784,7784,0,0,0,0,0
1027,y1212,20121210,7784,7784,0,0,0,7784,7784,0,0,0,0,0
1028,y1212,20121211,7784,7784,0,0,0,7784,7784,0,0,0,0,0
1029,y1212,20121212,7784,7784,0,0,0,7784,7784,0,0,0,0,0
1030,y1212,20121213,7784,7784,0,0,0,7784,7784,0,0,0,0,0
1031,y1212,20121214,7784,7784,0,0,0,7784,7784,0,0,0,0,0
1032,y1301,20120119,8998,9014,8998,9006,8998,9004,9000,-10,-14,26,2340360,74
1033,y1301,20120120,9004,9000,9080,9178,9080,9178,9112,178,112,116,10572160,128
1034,y1301,20120130,9178,9112,9202,9218,9170,9190,9196,78,84,132,12140160,224
1035,y1301,20120131,9190,9196,9132,9162,9132,9160,9152,-36,-44,212,19404880,390
1036,y1301,20120201,9160,9152,9160,9218,9160,9182,9200,30,48,588,54105000,654
1037,y1301,20120202,9182,9200,9210,9260,9200,9242,9218,42,18,1036,95503320,1332
1038,y1301,20120203,9242,9218,9242,9262,9220,9250,9242,32,24,254,23479040,1512
1039,y1301,20120206,9250,9242,9286,9352,9286,9346,9336,104,94,384,35852880,1710
1040,y1301,20120207,9346,9336,9358,9374,9294,9306,9334,-30,-2,278,25948600,1756
1041,y1301,20120208,9306,9334,9332,9432,9324,9432,9402,98,68,446,41937960,1876
1042,y1301,20120209,9432,9402,9430,9440,9400,9414,9416,12,14,412,38796720,2134
1043,y1301,20120210,9414,9416,9414,9414,9376,9384,9394,-32,-22,2858,268495880,3470
1044,y1301,20120213,9384,9394,9404,9492,9404,9484,9472,90,78,918,86965400,3456
1045,y1301,20120214,9484,9472,9524,9532,9460,9470,9488,-2,16,4188,397431880,6272
1046,y1301,20120215,9470,9488,9496,9508,9432,9438,9462,-50,-26,2242,212143880,7808
1047,y1301,20120216,9438,9462,9466,9470,9350,9406,9424,-56,-38,5536,521727680,10890
1048,y1301,20120217,9406,9424,9380,9508,9380,9490,9480,66,56,2252,213520520,10824
1049,y1301,20120220,9490,9480,9560,9570,9500,9516,9526,36,46,1858,177016800,11762
1050,y1301,20120221,9516,9526,9526,9542,9470,9532,9504,6,-22,2672,253995880,13450
1051,y1301,20120222,9532,9504,9548,9548,9518,9524,9532,20,28,1826,174058000,13112
1052,y1301,20120223,9524,9532,9548,9548,9490,9532,9510,0,-22,3082,293134160,12686
1053,y1301,20120224,9532,9510,9530,9548,9504,9512,9522,2,12,4992,475395680,15614
1054,y1301,20120227,9512,9522,9528,9568,9526,9550,9542,28,20,2782,265500640,14852
1055,y1301,20120228,9550,9542,9552,9598,9552,9598,9582,56,40,2276,218114000,15832
1056,y1301,20120229,9598,9582,9598,9598,9562,9582,9572,0,-10,1732,165806800,14962
1057,y1301,20120301,9582,9572,9552,9566,9478,9478,9532,-94,-40,3592,342427400,15094
1058,y1301,20120302,9478,9532,9520,9532,9484,9524,9520,-8,-12,4236,403302720,14878
1059,y1301,20120305,9524,9520,9540,9564,9506,9536,9538,16,18,2720,259470920,15190
1060,y1301,20120306,9536,9538,9500,9518,9488,9502,9500,-36,-38,2150,204253640,16094
1061,y1301,20120307,9502,9500,9452,9476,9446,9450,9460,-50,-40,3918,370698200,17996
1062,y1301,20120308,9450,9460,9446,9492,9442,9486,9478,26,18,10374,983265240,22142
1063,y1301,20120309,9486,9478,9486,9692,9486,9690,9614,212,136,13954,1341751800,26840
1064,y1301,20120312,9690,9614,9698,9698,9620,9642,9644,28,30,7424,716098320,27350
1065,y1301,20120313,9642,9644,9608,9698,9608,9688,9666,44,22,6150,594462000,29638
1066,y1301,20120314,9688,9666,9736,9806,9700,9716,9744,50,78,12478,1215999200,33282
1067,y1301,20120315,9716,9744,9746,9780,9712,9744,9748,0,4,10468,1020512960,36046
1068,y1301,20120316,9744,9748,9800,9816,9730,9750,9776,2,28,8344,815852120,37584
1069,y1301,20120319,9750,9776,9780,9822,9750,9778,9792,2,16,9248,905573040,40346
1070,y1301,20120320,9778,9792,9772,9774,9662,9668,9712,-124,-80,10550,1024628960,42132
1071,y1301,20120321,9668,9712,9608,9686,9608,9666,9664,-46,-48,6454,623748960,42582
1072,y1301,20120322,9666,9664,9684,9706,9646,9654,9682,-10,18,17118,1657397080,37096
1073,y1301,20120323,9654,9682,9660,9760,9660,9760,9700,78,18,14852,1440814640,38340
1074,y1301,20120326,9760,9700,9788,9842,9768,9838,9814,138,114,9896,971327840,42600
1075,y1301,20120327,9838,9814,9840,9854,9810,9836,9828,22,14,5972,587026520,43688
1076,y1301,20120328,9836,9828,9796,9868,9774,9810,9818,-18,-10,15200,1492569360,42494
1077,y1301,20120329,9810,9818,9800,9824,9708,9740,9768,-78,-50,15648,1528777640,45210
1078,y1301,20120330,9740,9768,9710,9718,9654,9660,9684,-108,-84,10496,1016580240,47516
1079,y1301,20120405,9660,9684,10050,10050,9880,10000,9944,316,260,23664,2353246640,50560
1080,y1301,20120406,10000,9944,10020,10114,10020,10106,10074,162,130,29866,3008734000,53982
1081,y1301,20120409,10106,10074,10190,10190,10080,10092,10116,18,42,55516,5616884520,80504
1082,y1301,20120410,10092,10116,10100,10178,10080,10162,10116,46,0,45328,4585439240,93012
1083,y1301,20120411,10162,10116,10070,10078,9990,10010,10022,-106,-94,56084,5621524240,102808
1084,y1301,20120412,10010,10022,10020,10048,9986,10036,10020,14,-2,56172,5628630520,116832
1085,y1301,20120413,10036,10020,10098,10132,10072,10080,10102,60,82,58124,5871928800,125036
1086,y1301,20120416,10080,10102,9866,9986,9866,9970,9968,-132,-134,66352,6614076680,125730
1087,y1301,20120417,9970,9968,9962,9998,9962,9978,9980,10,12,45826,4574164160,131970
1088,y1301,20120418,9978,9980,10000,10048,9904,9974,9982,-6,2,113092,11289501000,140450
1089,y1301,20120419,9974,9982,9950,9990,9946,9988,9968,6,-14,65614,6541623720,147234
1090,y1301,20120420,9988,9968,9970,10012,9954,9986,9984,18,16,69476,6936486040,158476
1091,y1301,20120423,9986,9984,10050,10120,10050,10064,10082,80,98,85554,8626027000,176988
1092,y1301,20120424,10064,10082,10020,10058,9972,9990,10018,-92,-64,108758,10895732160,188042
1093,y1301,20120425,9990,10018,10058,10068,10008,10016,10034,-2,16,105976,10634026720,200802
1094,y1301,20120426,10016,10034,10014,10046,10004,10018,10026,-16,-8,82726,8294278160,199110
1095,y1301,20120427,10018,10026,10016,10052,10016,10030,10030,4,4,66184,6639392240,203212
1096,y1301,20120502,10030,10030,10012,10052,9952,9968,9994,-62,-36,128770,12871568800,208414
1097,y1301,20120503,9968,9994,9946,9950,9854,9860,9902,-134,-92,97960,9700256000,212088
1098,y1301,20120504,9860,9902,9838,9886,9832,9882,9866,-20,-36,71866,7091366160,211694
1099,y1301,20120507,9882,9866,9842,9842,9758,9780,9784,-86,-82,104672,10241828680,209400
1100,y1301,20120508,9780,9784,9800,9858,9798,9820,9830,36,46,87432,8595896360,211590
1101,y1301,20120509,9820,9830,9778,9802,9736,9788,9770,-42,-60,109258,10674565200,225824
1102,y1301,20120510,9788,9770,9780,9858,9764,9850,9810,80,40,117612,11537956880,226926
1103,y1301,20120511,9850,9810,9850,9852,9696,9702,9770,-108,-40,203046,19839537840,213734
1104,y1301,20120514,9702,9770,9680,9690,9496,9536,9582,-234,-188,169928,16284877880,223638
1105,y1301,20120515,9536,9582,9486,9518,9426,9496,9476,-86,-106,125202,11864848280,217894
1106,y1301,20120516,9496,9476,9500,9558,9358,9376,9466,-100,-10,189068,17897561840,241222
1107,y1301,20120517,9376,9466,9460,9488,9386,9450,9442,-16,-24,154792,14617135240,237170
1108,y1301,20120518,9450,9442,9402,9428,9270,9308,9338,-134,-104,187646,17523811400,237376
1109,y1301,20120521,9308,9338,9352,9450,9334,9412,9398,74,60,156674,14727038920,237894
1110,y1301,20120522,9412,9398,9412,9442,9390,9418,9418,20,20,123678,11648991400,245218
1111,y1301,20120523,9418,9418,9320,9322,9178,9200,9238,-218,-180,215548,19915472280,269348
1112,y1301,20120524,9200,9238,9186,9238,9122,9234,9192,-4,-46,289132,26578715560,284156
1113,y1301,20120525,9234,9192,9228,9230,9164,9222,9206,30,14,236556,21778593280,283082
1114,y1301,20120528,9222,9206,9270,9350,9260,9338,9308,132,102,254868,23723584200,286428
1115,y1301,20120529,9338,9308,9310,9382,9286,9366,9336,58,28,331260,30928286280,304134
1116,y1301,20120530,9366,9336,9328,9350,9288,9304,9320,-32,-16,339358,31630219160,311378
1117,y1301,20120531,9304,9320,9242,9292,9226,9240,9260,-80,-60,245774,22762237120,307558
1118,y1301,20120601,9240,9260,9228,9228,9140,9152,9182,-108,-78,382564,35130861440,311784
1119,y1301,20120604,9152,9182,9100,9138,8930,8974,9014,-208,-168,534704,48205109080,317506
1120,y1301,20120605,8974,9014,9030,9092,9008,9052,9048,38,34,353236,31967653760,314818
1121,y1301,20120606,9052,9048,9064,9174,9062,9124,9136,76,88,464062,42404750480,325638
1122,y1301,20120607,9124,9136,9182,9248,9148,9176,9202,40,66,345322,31782459080,325534
1123,y1301,20120608,9176,9202,9246,9248,9148,9200,9198,-2,-4,543220,49965822720,338264
1124,y1301,20120611,9200,9198,9242,9364,9238,9362,9328,164,130,494598,46141666960,354898
1125,y1301,20120612,9362,9328,9288,9320,9260,9318,9292,-10,-36,427918,39762600560,370018
1126,y1301,20120613,9318,9292,9298,9320,9274,9276,9296,-16,4,344240,32001979960,373648
1127,y1301,20120614,9276,9296,9220,9222,9098,9100,9146,-196,-150,634538,58036525920,385124
1128,y1301,20120615,9100,9146,9090,9156,9088,9132,9128,-14,-18,476428,43494070840,360480
1129,y1301,20120618,9132,9128,9200,9242,9162,9232,9206,104,78,483230,44489886520,370784
1130,y1301,20120619,9232,9206,9286,9354,9252,9318,9316,112,110,554532,51664723400,391372
1131,y1301,20120620,9318,9316,9410,9514,9388,9506,9454,190,138,566414,53549678760,412948
1132,y1301,20120621,9506,9454,9450,9474,9396,9440,9436,-14,-18,527894,49817695000,385486
1133,y1301,20120625,9440,9436,9508,9620,9504,9526,9574,90,138,595508,57020424760,412810
1134,y1301,20120626,9526,9574,9588,9588,9462,9500,9508,-74,-66,617158,58685247000,404450
1135,y1301,20120627,9500,9508,9500,9526,9442,9500,9482,-8,-26,578046,54818330960,400282
1136,y1301,20120628,9500,9482,9538,9548,9452,9472,9484,-10,2,512244,48582741480,402076
1137,y1301,20120629,9472,9484,9470,9550,9444,9548,9496,64,12,463754,44043396880,405586
1138,y1301,20120702,9548,9496,9744,9746,9620,9632,9654,136,158,520246,50228563160,426760
1139,y1301,20120703,9632,9654,9646,9712,9634,9710,9678,56,24,525070,50822271000,431260
1140,y1301,20120704,9710,9678,9730,9788,9690,9718,9744,40,66,517180,50399838040,440560
1141,y1301,20120705,9718,9744,9724,9802,9692,9778,9756,34,12,555356,54182581960,449766
1142,y1301,20120706,9778,9756,9802,9848,9744,9756,9800,0,44,561496,55028142800,438392
1143,y1301,20120709,9756,9800,9770,9910,9710,9876,9828,76,28,896380,88102406480,475802
1144,y1301,20120710,9876,9828,9840,9868,9782,9786,9830,-42,2,536006,52696115240,465720
1145,y1301,20120711,9786,9830,9800,9880,9686,9734,9786,-96,-44,813214,79581387200,439344
1146,y1301,20120712,9734,9786,9690,9700,9570,9570,9614,-216,-172,556014,53458993840,420982
1147,y1301,20120713,9570,9614,9600,9646,9574,9642,9614,28,0,475562,45729203400,410140
1148,y1301,20120716,9642,9614,9720,9906,9720,9886,9860,272,246,789272,77835266600,443834
1149,y1301,20120717,9886,9860,9920,9928,9752,9828,9840,-32,-20,743520,73176943080,442854
1150,y1301,20120718,9828,9840,9840,9858,9702,9744,9780,-96,-60,553480,54136976800,436168
1151,y1301,20120719,9744,9780,9816,9838,9758,9820,9808,40,28,564358,55356937480,432602
1152,y1301,20120720,9820,9808,9832,9908,9792,9826,9842,18,34,613448,60384322000,415966
1153,y1301,20120723,9826,9842,9760,9766,9626,9630,9670,-212,-172,420580,40672019160,399094
1154,y1301,20120724,9630,9670,9386,9478,9284,9396,9408,-274,-262,579114,54489191800,409004
1155,y1301,20120725,9396,9408,9300,9408,9264,9336,9344,-72,-64,557780,52123347440,375432
1156,y1301,20120726,9336,9344,9380,9398,9324,9348,9356,4,12,378738,35442132320,388084
1157,y1301,20120727,9348,9356,9330,9408,9320,9402,9366,46,10,302764,28362855360,382376
1158,y1301,20120730,9402,9366,9490,9592,9464,9524,9538,158,172,584350,55736226560,384432
1159,y1301,20120731,9524,9538,9498,9526,9470,9522,9496,-16,-42,397398,37738860320,394196
1160,y1301,20120801,9522,9496,9560,9632,9532,9570,9588,74,92,546482,52404532280,415388
1161,y1301,20120802,9570,9588,9502,9516,9434,9510,9478,-78,-110,420110,39821980840,406372
1162,y1301,20120803,9510,9478,9452,9516,9432,9490,9478,12,0,369254,35001193960,418170
1163,y1301,20120806,9490,9478,9426,9558,9426,9530,9516,52,38,596184,56742217520,453488
1164,y1301,20120807,9530,9516,9526,9624,9522,9612,9588,96,72,547482,52495447760,462526
1165,y1301,20120808,9612,9588,9572,9596,9536,9536,9566,-52,-22,363868,34811841520,440814
1166,y1301,20120809,9536,9566,9572,9706,9572,9696,9652,130,86,737660,71205176000,517834
1167,y1301,20120810,9696,9652,9750,9758,9628,9654,9686,2,34,480276,46522341800,443388
1168,y1301,20120813,9654,9686,9748,9788,9708,9720,9744,34,58,614376,59874161080,463520
1169,y1301,20120814,9720,9744,9694,9716,9608,9684,9662,-60,-82,648882,62701574440,441598
1170,y1301,20120815,9684,9662,9650,9710,9626,9678,9664,16,2,520820,50337962920,450584
1171,y1301,20120816,9678,9664,9700,9708,9642,9654,9666,-10,2,394914,38176564320,461564
1172,y1301,20120817,9654,9666,9666,9726,9660,9690,9690,24,24,349936,33911357320,454114
1173,y1301,20120820,9690,9690,9704,9736,9696,9722,9718,32,28,314676,30580835160,447546
1174,y1301,20120821,9722,9718,9788,9816,9732,9794,9776,76,58,392248,38350004600,447962
1175,y1301,20120822,9794,9776,9900,9980,9878,9954,9936,178,160,584044,58031169440,483660
1176,y1301,20120823,9954,9936,10000,10036,9938,9952,9978,16,42,436926,43602975280,463832
1177,y1301,20120824,9952,9978,9924,10060,9906,10056,9988,78,10,496594,49601186680,492188
1178,y1301,20120827,10056,9988,10110,10156,10076,10130,10116,142,128,495306,50113751640,490254
1179,y1301,20120828,10130,10116,10040,10072,9976,9980,10022,-136,-94,411696,41266918720,482766
1180,y1301,20120829,9980,10022,9964,10014,9888,9960,9948,-62,-74,521402,51876170760,479238
1181,y1301,20120830,9960,9948,9998,10090,9980,10078,10022,130,74,510830,51201659040,494902
1182,y1301,20120831,10078,10022,10058,10068,9952,9966,9998,-56,-24,451200,45118015880,471948
1183,y1301,20120903,9966,9998,9998,10278,9950,10238,10172,240,174,1002206,1.01949E+11,530824
1184,y1301,20120904,10238,10172,10222,10308,10212,10264,10254,92,82,557472,57170381680,505772
1185,y1301,20120905,10264,10254,10218,10264,10156,10180,10210,-74,-44,446016,45538755040,459938
1186,y1301,20120906,10180,10210,10104,10132,10032,10074,10072,-136,-138,429280,43242289360,448732
1187,y1301,20120907,10074,10072,10080,10146,10016,10024,10090,-48,18,529962,53482709040,455032
1188,y1301,20120910,10024,10090,10000,10088,9980,10064,10042,-26,-48,394912,39657762080,441594
1189,y1301,20120911,10064,10042,10024,10136,9962,9992,10038,-50,-4,790650,79375153080,457196
1190,y1301,20120912,9992,10038,9972,10030,9942,10016,9986,-22,-52,481606,48101905720,455550
1191,y1301,20120913,10016,9986,10098,10140,10050,10060,10098,74,112,533740,53900871240,470070
1192,y1301,20120914,10060,10098,10150,10230,10136,10216,10190,118,92,548468,55888900600,494298
1193,y1301,20120917,10216,10190,10190,10204,9964,9980,10106,-210,-84,588684,59494418280,460252
1194,y1301,20120918,9980,10106,9850,9922,9756,9820,9844,-286,-262,598680,58939140920,431488
1195,y1301,20120919,9820,9844,9890,9916,9854,9876,9882,32,38,421778,41687449840,423580
1196,y1301,20120920,9876,9882,9944,9944,9828,9850,9884,-32,2,533330,52718787040,432434
1197,y1301,20120921,9850,9884,9770,9810,9720,9738,9762,-146,-122,510238,49817178880,446312
1198,y1301,20120924,9738,9762,9680,9680,9394,9498,9498,-264,-264,1037548,98563316000,435606
1199,y1301,20120925,9498,9498,9536,9590,9462,9518,9522,20,24,558688,53199846480,407698
1200,y1301,20120926,9518,9522,9470,9490,9348,9348,9402,-174,-120,652402,61351412280,412824
1201,y1301,20120927,9348,9402,9288,9314,9224,9232,9272,-170,-130,535696,49674779200,404940
1202,y1301,20120928,9232,9272,9278,9328,9250,9278,9278,6,6,305268,28323838960,362442
1203,y1301,20121008,9278,9278,9176,9204,9050,9088,9114,-190,-164,405378,36953893160,328744
1204,y1301,20121009,9088,9114,9140,9228,9120,9218,9176,104,62,373606,34288878160,333824
1205,y1301,20121010,9218,9176,9152,9262,9134,9240,9194,64,18,415276,38184034280,384408
1206,y1301,20121011,9240,9194,9172,9252,9164,9210,9212,16,18,457478,42145267840,368472
1207,y1301,20121012,9210,9212,9242,9256,9068,9092,9154,-120,-58,572178,52386974000,388842
1208,y1301,20121015,9092,9154,9000,9036,8936,9006,9004,-148,-150,384420,34614468240,358436
1209,y1301,20121016,9006,9004,9042,9148,9042,9138,9108,134,104,313738,28579122400,333114
1210,y1301,20121017,9138,9108,9112,9164,9080,9116,9118,8,10,276286,25193505640,293174
1211,y1301,20121018,9116,9118,9150,9226,9150,9204,9194,86,76,165808,15246092280,275982
1212,y1301,20121019,9204,9194,9272,9278,9226,9242,9250,48,56,154244,14269593000,268470
1213,y1301,20121022,9242,9250,9242,9274,9166,9274,9248,24,-2,117334,10851231520,253122
1214,y1301,20121023,9274,9248,9260,9286,9196,9198,9244,-50,-4,95718,8849940640,244636
1215,y1301,20121024,9198,9244,9220,9260,9220,9250,9240,6,-4,62374,5764121240,239318
1216,y1301,20121025,9250,9240,9244,9256,9196,9198,9234,-42,-6,72512,6696646800,230766
1217,y1301,20121026,9198,9234,9186,9186,9050,9086,9112,-148,-122,141726,12916269920,221696
1218,y1301,20121029,9086,9112,9030,9050,8980,8982,9010,-130,-102,102182,9207647200,222968
1219,y1301,20121030,8982,9010,8980,8986,8914,8942,8946,-68,-64,101102,9044905120,214060
1220,y1301,20121031,8942,8946,8930,9040,8930,9032,8988,86,42,110394,9923272800,201090
1221,y1301,20121101,9032,8988,9022,9086,9016,9066,9058,78,70,64532,5846300520,193218
1222,y1301,20121102,9066,9058,9058,9060,8850,8856,8934,-202,-124,122154,10914157600,187636
1223,y1301,20121105,8856,8934,8800,8800,8616,8640,8698,-294,-236,151434,13172889560,164258
1224,y1301,20121106,8640,8698,8676,8760,8660,8710,8716,12,18,78916,6879293520,152660
1225,y1301,20121107,8710,8716,8720,8740,8618,8706,8686,-10,-30,71352,6198808280,142768
1226,y1301,20121108,8706,8686,8680,8730,8632,8680,8694,-6,8,61396,5338295840,141146
1227,y1301,20121109,8680,8694,8660,8690,8534,8550,8620,-144,-74,89572,7722771840,139642
1228,y1301,20121112,8550,8620,8426,8450,8276,8276,8318,-344,-302,92438,7689994680,126332
1229,y1301,20121113,8276,8318,8326,8340,8230,8288,8294,-30,-24,88078,7306453560,121248
1230,y1301,20121114,8288,8294,8270,8344,8218,8336,8282,42,-12,85178,7056035280,112514
1231,y1301,20121115,8336,8282,8328,8428,8298,8304,8378,22,96,83696,7012330400,100948
1232,y1301,20121116,8304,8378,8322,8350,8236,8256,8296,-122,-82,69294,5748962800,93932
1233,y1301,20121119,8256,8296,8300,8340,8282,8334,8316,38,20,35622,2962446520,90886
1234,y1301,20121120,8334,8316,8370,8382,8308,8372,8350,56,34,26112,2180749400,84900
1235,y1301,20121121,8372,8350,8402,8416,8354,8398,8388,48,38,21232,1781093680,82086
1236,y1301,20121122,8398,8388,8420,8420,8374,8404,8396,16,8,17532,1472194800,80418
1237,y1301,20121123,8404,8396,8396,8420,8332,8418,8374,22,-22,22234,1862131840,75230
1238,y1301,20121126,8418,8374,8444,8492,8442,8452,8464,78,90,28154,2383113800,65506
1239,y1301,20121127,8452,8464,8500,8502,8424,8426,8474,-38,10,18686,1583553720,61674
1240,y1301,20121128,8426,8474,8490,8510,8426,8438,8468,-36,-6,19498,1651315080,57128
1241,y1301,20121129,8438,8468,8500,8500,8394,8474,8454,6,-14,18618,1573984520,51422
1242,y1301,20121130,8474,8454,8460,8540,8444,8528,8498,74,44,24930,2118873480,44312
1243,y1301,20121203,8528,8498,8530,8636,8530,8606,8598,108,100,17778,1528761920,33078
1244,y1301,20121204,8606,8598,8620,8620,8550,8600,8574,2,-24,5684,487406000,29536
1245,y1301,20121205,8600,8574,8598,8674,8590,8666,8624,92,50,7954,686046040,24428
1246,y1301,20121206,8666,8624,8718,8738,8650,8656,8694,32,70,4224,367239520,22584
1247,y1301,20121207,8656,8694,8664,8716,8636,8712,8678,18,-16,3082,267484440,20734
1248,y1301,20121210,8712,8678,8686,8724,8684,8698,8698,20,20,4192,364674240,17342
1249,y1301,20121211,8698,8698,8690,8770,8690,8730,8744,32,46,3388,296246960,15098
1250,y1301,20121212,8730,8744,8660,8692,8598,8600,8652,-144,-92,5000,432685120,10976
1251,y1301,20121213,8600,8652,8608,8638,8590,8628,8616,-24,-36,3046,262491160,9460
1252,y1301,20121214,8628,8616,8604,8742,8600,8742,8676,126,60,1690,146649600,8418
1253,y1301,20121217,8742,8676,8788,8832,8778,8810,8804,134,128,1708,150394240,7126
1254,y1301,20121218,8810,8804,8810,8838,8784,8814,8806,10,2,2474,217880280,4966
1255,y1301,20121219,8814,8806,8738,8788,8718,8744,8738,-62,-68,1364,119201440,4294
1256,y1301,20121220,8744,8738,8690,8690,8600,8666,8630,-72,-108,920,79407120,3594
1257,y1301,20121221,8666,8630,8640,8698,8634,8682,8666,52,36,314,27212120,3396
1258,y1301,20121224,8682,8666,8652,8770,8652,8714,8728,48,62,1210,105620240,2392
1259,y1301,20121225,8714,8728,8678,8740,8678,8708,8708,-20,-20,414,36055840,2086
1260,y1301,20121226,8708,8708,8760,8780,8696,8700,8732,-8,24,300,26196480,1894
1261,y1301,20121227,8700,8732,8662,8720,8620,8628,8676,-104,-56,326,28284760,1678
1262,y1301,20121228,8628,8676,8574,8664,8574,8598,8612,-78,-64,364,31349000,1340
1263,y1301,20121231,8598,8612,8608,8610,8430,8560,8576,-52,-36,340,29161960,1064
1264,y1303,20120316,9664,9664,9978,9978,9978,9978,9978,314,314,2,199560,2
1265,y1303,20120319,9978,9978,9802,9802,9802,9802,9802,-176,-176,2,196040,2
1266,y1303,20120320,9802,9802,9760,9760,9760,9760,9760,-42,-42,2,195200,2
1267,y1303,20120321,9760,9760,0,0,0,9760,9760,0,0,0,0,2
1268,y1303,20120322,9760,9760,0,0,0,9760,9760,0,0,0,0,2
1269,y1303,20120323,9760,9760,0,0,0,9760,9760,0,0,0,0,2
1270,y1303,20120326,9760,9760,0,0,0,9760,9760,0,0,0,0,2
1271,y1303,20120327,9760,9760,9760,9760,9714,9714,9716,-46,-44,40,3886520,40
1272,y1303,20120328,9714,9716,9860,9860,9832,9832,9858,116,142,44,4337600,4
1273,y1303,20120329,9832,9858,9802,9802,9794,9796,9796,-62,-62,6,587840,2
1274,y1303,20120330,9796,9796,0,0,0,9796,9796,0,0,0,0,2
1275,y1303,20120405,9796,9796,0,0,0,9796,9796,0,0,0,0,2
1276,y1303,20120406,9796,9796,10068,10068,10068,10068,10068,272,272,2,201360,0
1277,y1303,20120409,10068,10068,0,0,0,10068,10068,0,0,0,0,0
1278,y1303,20120410,10068,10068,10208,10208,10208,10208,10208,140,140,2,204160,2
1279,y1303,20120411,10208,10208,10100,10616,9944,10198,10110,-10,-98,92,9301360,8
1280,y1303,20120412,10198,10110,10050,10088,10016,10088,10044,-22,-66,10,1004400,8
1281,y1303,20120413,10088,10044,10140,10140,10106,10106,10118,62,74,6,607120,6
1282,y1303,20120416,10106,10118,0,0,0,10118,10118,0,0,0,0,6
1283,y1303,20120417,10118,10118,0,0,0,10118,10118,0,0,0,0,6
1284,y1303,20120418,10118,10118,9998,10036,9998,10036,10016,-82,-102,4,400680,8
1285,y1303,20120419,10036,10016,9998,10000,9998,10000,9998,-16,-18,4,399960,8
1286,y1303,20120420,10000,9998,9996,9998,9996,9998,9996,0,-2,6,599840,12
1287,y1303,20120423,9998,9996,0,0,0,9996,9996,0,0,0,0,12
1288,y1303,20120424,9996,9996,10122,10132,9910,10004,10044,8,48,36,3616280,16
1289,y1303,20120425,10004,10044,10036,10036,10036,10036,10036,-8,-8,2,200720,14
1290,y1303,20120426,10036,10036,10058,10058,10058,10058,10058,22,22,2,201160,12
1291,y1303,20120427,10058,10058,10010,10060,10010,10060,10034,2,-24,4,401400,12
1292,y1303,20120502,10060,10034,9964,9964,9964,9964,9964,-70,-70,2,199280,14
1293,y1303,20120503,9964,9964,9956,9970,9900,9924,9942,-40,-22,10,994360,14
1294,y1303,20120504,9924,9942,9880,9898,9880,9898,9884,-44,-58,12,1186280,16
1295,y1303,20120507,9898,9884,9862,9862,9816,9816,9850,-68,-34,32,3152360,34
1296,y1303,20120508,9816,9850,9868,9868,9868,9868,9868,18,18,22,2170960,20
1297,y1303,20120509,9868,9868,9800,9996,9788,9996,9844,128,-24,8,787600,18
1298,y1303,20120510,9996,9844,9830,9830,9816,9816,9820,-28,-24,6,589240,18
1299,y1303,20120511,9816,9820,9882,9882,9814,9814,9842,-6,22,14,1378040,18
1300,y1303,20120514,9814,9842,9628,9634,9558,9578,9598,-264,-244,10,959960,24
1301,y1303,20120515,9578,9598,9516,9516,9516,9516,9516,-82,-82,2,190320,24
1302,y1303,20120516,9516,9516,9430,9430,9418,9418,9426,-98,-90,6,565560,22
1303,y1303,20120517,9418,9426,9476,9476,9442,9442,9452,16,26,6,567200,18
1304,y1303,20120518,9442,9452,9264,9334,9264,9294,9296,-158,-156,6,557840,16
1305,y1303,20120521,9294,9296,9388,9396,9382,9396,9388,100,92,10,938840,14
1306,y1303,20120522,9396,9388,0,0,0,9388,9388,0,0,0,0,14
1307,y1303,20120523,9388,9388,9202,9202,9202,9202,9202,-186,-186,2,184040,14
1308,y1303,20120524,9202,9202,9180,9220,9108,9220,9140,18,-62,40,3656640,34
1309,y1303,20120525,9220,9140,9218,9236,9184,9208,9208,68,68,34,3131200,26
1310,y1303,20120528,9208,9208,0,0,0,9208,9208,0,0,0,0,26
1311,y1303,20120529,9208,9208,9368,9370,9358,9358,9362,150,154,18,1685160,20
1312,y1303,20120530,9358,9362,0,0,0,9362,9362,0,0,0,0,20
1313,y1303,20120531,9362,9362,9188,9262,9188,9256,9244,-106,-118,16,1479280,20
1314,y1303,20120601,9256,9244,9170,9170,9146,9146,9158,-98,-86,4,366320,22
1315,y1303,20120604,9146,9158,9092,9092,9092,9092,9092,-66,-66,2,181840,22
1316,y1303,20120605,9092,9092,0,0,0,9092,9092,0,0,0,0,22
1317,y1303,20120606,9092,9092,0,0,0,9092,9092,0,0,0,0,22
1318,y1303,20120607,9092,9092,9200,9230,9172,9172,9198,80,106,18,1655680,22
1319,y1303,20120608,9172,9198,9158,9212,9124,9184,9156,-14,-42,26,2381000,20
1320,y1303,20120611,9184,9156,9320,9326,9298,9298,9314,142,158,6,558880,18
1321,y1303,20120612,9298,9314,9242,9290,9242,9290,9266,-24,-48,4,370640,18
1322,y1303,20120613,9290,9266,0,0,0,9266,9266,0,0,0,0,18
1323,y1303,20120614,9266,9266,9118,9118,9100,9100,9112,-166,-154,6,546720,20
1324,y1303,20120615,9100,9112,0,0,0,9112,9112,0,0,0,0,20
1325,y1303,20120618,9112,9112,9190,9230,9190,9230,9204,118,92,16,1472640,16
1326,y1303,20120619,9230,9204,9210,9322,9210,9300,9280,96,76,14,1299240,10
1327,y1303,20120620,9300,9280,9478,9486,9478,9486,9482,206,202,6,569000,16
1328,y1303,20120621,9486,9482,9392,9418,9386,9410,9396,-72,-86,22,2067480,10
1329,y1303,20120625,9410,9396,9518,9562,9518,9540,9534,144,138,10,953560,12
1330,y1303,20120626,9540,9534,9566,9566,9470,9496,9506,-38,-28,14,1330960,16
1331,y1303,20120627,9496,9506,9486,9486,9486,9486,9486,-20,-20,2,189720,14
1332,y1303,20120628,9486,9486,0,0,0,9486,9486,0,0,0,0,14
1333,y1303,20120629,9486,9486,9472,9510,9458,9510,9484,24,-2,14,1327840,10
1334,y1303,20120702,9510,9484,9658,9658,9522,9622,9622,138,138,18,1731960,10
1335,y1303,20120703,9622,9622,9674,9684,9632,9658,9662,36,40,52,5024720,18
1336,y1303,20120704,9658,9662,9716,9716,9690,9690,9702,28,40,6,582120,18
1337,y1303,20120705,9690,9702,9720,9766,9720,9726,9744,24,42,12,1169320,18
1338,y1303,20120706,9726,9744,9764,9764,9764,9764,9764,20,20,2,195280,18
1339,y1303,20120709,9764,9764,9764,9860,9764,9790,9786,26,22,12,1174360,20
1340,y1303,20120710,9790,9786,9790,9790,9732,9732,9760,-54,-26,4,390440,20
1341,y1303,20120711,9732,9760,9846,9872,9716,9716,9770,-44,10,50,4885680,10
1342,y1303,20120712,9716,9770,9606,9606,9528,9562,9572,-208,-198,10,957320,8
1343,y1303,20120713,9562,9572,9568,9568,9542,9542,9554,-30,-18,4,382200,8
1344,y1303,20120716,9542,9554,9778,9850,9742,9850,9772,296,218,70,6840800,12
1345,y1303,20120717,9850,9772,9840,9840,9788,9806,9802,34,30,14,1372440,16
1346,y1303,20120718,9806,9802,9806,9826,9730,9760,9764,-42,-38,608,59369160,536
1347,y1303,20120719,9760,9764,9780,9780,9780,9780,9780,16,16,2,195600,534
1348,y1303,20120720,9780,9780,9800,9818,9712,9720,9794,-60,14,578,56610640,104
1349,y1303,20120723,9720,9794,9550,9550,9546,9546,9546,-248,-248,8,763760,98
1350,y1303,20120724,9546,9546,9230,9448,9230,9272,9332,-274,-214,52,4853280,96
1351,y1303,20120725,9272,9332,0,0,0,9332,9332,0,0,0,0,96
1352,y1303,20120726,9332,9332,9244,9244,9206,9206,9224,-126,-108,4,369000,96
1353,y1303,20120727,9206,9224,0,0,0,9224,9224,0,0,0,0,96
1354,y1303,20120730,9224,9224,9468,9468,9416,9416,9442,192,218,4,377680,96
1355,y1303,20120731,9416,9442,9378,9378,9378,9378,9378,-64,-64,2,187560,96
1356,y1303,20120801,9378,9378,9510,9540,9474,9474,9498,96,120,8,759960,94
1357,y1303,20120802,9474,9498,9372,9372,9346,9346,9358,-152,-140,4,374360,94
1358,y1303,20120803,9346,9358,0,0,0,9358,9358,0,0,0,0,94
1359,y1303,20120806,9358,9358,9448,9448,9410,9444,9434,86,76,62,5849800,78
1360,y1303,20120807,9444,9434,9494,9556,9460,9520,9502,86,68,50,4751800,84
1361,y1303,20120808,9520,9502,9448,9448,9448,9448,9448,-54,-54,10,944800,86
1362,y1303,20120809,9448,9448,9552,9630,9536,9622,9572,174,124,88,8424600,88
1363,y1303,20120810,9622,9572,9618,9662,9610,9634,9634,62,62,22,2119600,92
1364,y1303,20120813,9634,9634,9692,9692,9656,9660,9666,26,32,12,1160000,86
1365,y1303,20120814,9660,9666,9582,9582,9582,9582,9582,-84,-84,2,191640,84
1366,y1303,20120815,9582,9582,9614,9650,9590,9648,9628,66,46,38,3658760,74
1367,y1303,20120816,9648,9628,9610,9616,9600,9600,9608,-28,-20,12,1153080,64
1368,y1303,20120817,9600,9608,9600,9600,9600,9600,9600,-8,-8,4,384000,64
1369,y1303,20120820,9600,9600,0,0,0,9600,9600,0,0,0,0,64
1370,y1303,20120821,9600,9600,9696,9700,9664,9700,9692,100,92,14,1357120,58
1371,y1303,20120822,9700,9692,9820,9876,9820,9876,9864,184,172,10,986480,52
1372,y1303,20120823,9876,9864,9924,9946,9868,9868,9898,4,34,104,10294440,32
1373,y1303,20120824,9868,9898,9906,9928,9906,9912,9914,14,16,6,594920,32
1374,y1303,20120827,9912,9914,10066,10066,10042,10042,10054,128,140,4,402160,30
1375,y1303,20120828,10042,10054,0,0,0,10054,10054,0,0,0,0,30
1376,y1303,20120829,10054,10054,0,0,0,10054,10054,0,0,0,0,30
1377,y1303,20120830,10054,10054,0,0,0,10054,10054,0,0,0,0,30
1378,y1303,20120831,10054,10054,9968,9968,9882,9882,9924,-172,-130,4,397000,30
1379,y1303,20120903,9882,9924,9950,10170,9932,10128,10078,204,154,54,5442680,32
1380,y1303,20120904,10128,10078,9966,10200,9966,10172,10130,94,52,20,2026000,30
1381,y1303,20120905,10172,10130,10002,10492,9766,10120,10122,-10,-8,364,36848640,16
1382,y1303,20120906,10120,10122,10064,10070,10002,10016,10026,-106,-96,18,1804840,12
1383,y1303,20120907,10016,10026,10058,10076,10042,10076,10072,50,46,50,5036600,42
1384,y1303,20120910,10076,10072,0,0,0,10072,10072,0,0,0,0,42
1385,y1303,20120911,10072,10072,0,0,0,10072,10072,0,0,0,0,42
1386,y1303,20120912,10072,10072,0,0,0,10072,10072,0,0,0,0,42
1387,y1303,20120913,10072,10072,10048,10048,10048,10048,10048,-24,-24,2,200960,42
1388,y1303,20120914,10048,10048,0,0,0,10048,10048,0,0,0,0,42
1389,y1303,20120917,10048,10048,10210,10210,10012,10012,10104,-36,56,62,6264920,30
1390,y1303,20120918,10012,10104,9838,9848,9756,9756,9822,-348,-282,20,1964600,30
1391,y1303,20120919,9756,9822,9812,9814,9812,9814,9812,-8,-10,8,785040,28
1392,y1303,20120920,9814,9812,9858,9858,9816,9816,9820,4,8,30,2946440,42
1393,y1303,20120921,9816,9820,9716,9716,9676,9676,9696,-144,-124,4,387840,42
1394,y1303,20120924,9676,9696,9456,9456,9332,9332,9394,-364,-302,12,1127480,44
1395,y1303,20120925,9332,9394,9440,9440,9422,9422,9424,28,30,10,942560,48
1396,y1303,20120926,9422,9424,9376,9380,9376,9380,9376,-44,-48,6,562640,46
1397,y1303,20120927,9380,9376,9270,9294,9214,9214,9250,-162,-126,40,3700080,40
1398,y1303,20120928,9214,9250,9288,9288,9236,9236,9262,-14,12,4,370480,40
1399,y1303,20121008,9236,9262,9092,9144,9000,9080,9092,-182,-170,30,2727960,40
1400,y1303,20121009,9080,9092,9100,9170,9100,9170,9142,78,50,10,914200,40
1401,y1303,20121010,9170,9142,9188,9198,9188,9196,9194,54,52,12,1103440,32
1402,y1303,20121011,9196,9194,9190,9242,9190,9218,9212,24,18,18,1658480,26
1403,y1303,20121012,9218,9212,9132,9132,9086,9120,9104,-92,-108,68,6191600,26
1404,y1303,20121015,9120,9104,9022,9064,9022,9064,9050,-40,-54,10,905040,26
1405,y1303,20121016,9064,9050,9104,9204,9100,9182,9146,132,96,54,4938880,40
1406,y1303,20121017,9182,9146,9198,9198,9120,9136,9150,-10,4,30,2745000,34
1407,y1303,20121018,9136,9150,0,0,0,9150,9150,0,0,0,0,34
1408,y1303,20121019,9150,9150,9264,9298,9254,9288,9280,138,130,30,2784520,34
1409,y1303,20121022,9288,9280,9288,9338,9288,9336,9310,56,30,12,1117280,40
1410,y1303,20121023,9336,9310,9338,9338,9266,9266,9310,-44,0,16,1489760,38
1411,y1303,20121024,9266,9310,9324,9330,9266,9314,9306,4,-4,66,6143200,36
1412,y1303,20121025,9314,9306,0,0,0,9306,9306,0,0,0,0,36
1413,y1303,20121026,9306,9306,9224,9224,9130,9130,9168,-176,-138,10,916960,34
1414,y1303,20121029,9130,9168,9098,9098,9060,9080,9074,-88,-94,10,907560,34
1415,y1303,20121030,9080,9074,9060,9060,9000,9038,9002,-36,-72,136,12245320,152
1416,y1303,20121031,9038,9002,0,0,0,9002,9002,0,0,0,0,152
1417,y1303,20121101,9002,9002,0,0,0,9002,9002,0,0,0,0,152
1418,y1303,20121102,9002,9002,9000,9000,8950,8952,8974,-50,-28,180,16155360,88
1419,y1303,20121105,8952,8974,8870,8870,8692,8730,8822,-244,-152,86,7588040,66
1420,y1303,20121106,8730,8822,8784,8828,8784,8814,8812,-8,-10,36,3172880,66
1421,y1303,20121107,8814,8812,8848,8848,8772,8826,8804,14,-8,50,4402960,64
1422,y1303,20121108,8826,8804,8702,8828,8702,8828,8750,24,-54,34,2975040,52
1423,y1303,20121109,8828,8750,8754,8754,8744,8744,8750,-6,0,6,525040,48
1424,y1303,20121112,8744,8750,8404,8404,8404,8404,8404,-346,-346,2,168080,48
1425,y1303,20121113,8404,8404,8446,8458,8370,8396,8418,-8,14,12,1010320,50
1426,y1303,20121114,8396,8418,8478,8480,8280,8384,8392,-34,-26,942,79061800,144
1427,y1303,20121115,8384,8392,8366,8474,8366,8376,8420,-16,28,58,4884440,148
1428,y1303,20121116,8376,8420,8380,8412,8294,8300,8352,-120,-68,32,2672800,142
1429,y1303,20121119,8300,8352,8300,8398,8300,8364,8370,12,18,40,3348520,136
1430,y1303,20121120,8364,8370,8408,8416,8342,8414,8382,44,12,34,2850440,140
1431,y1303,20121121,8414,8382,8478,8478,8426,8452,8450,70,68,18,1521160,138
1432,y1303,20121122,8452,8450,8476,8480,8458,8468,8468,18,18,34,2879200,116
1433,y1303,20121123,8468,8468,8502,8502,8450,8472,8468,4,0,12,1016160,116
1434,y1303,20121126,8472,8468,8544,8566,8530,8552,8546,84,78,40,3418800,96
1435,y1303,20121127,8552,8546,8566,8578,8550,8550,8564,4,18,28,2398080,92
1436,y1303,20121128,8550,8564,8580,8588,8250,8490,8452,-74,-112,246,20793040,116
1437,y1303,20121129,8490,8452,8496,8522,8460,8522,8486,70,34,48,4073840,112
1438,y1303,20121130,8522,8486,8548,8566,8462,8558,8516,72,30,88,7495040,96
1439,y1303,20121203,8558,8516,8596,8650,8596,8624,8630,108,114,68,5868800,70
1440,y1303,20121204,8624,8630,8640,8640,8594,8626,8614,-4,-16,24,2067360,64
1441,y1303,20121205,8626,8614,8628,8742,8618,8682,8648,68,34,112,9687560,64
1442,y1303,20121206,8682,8648,8710,8734,8668,8684,8700,36,52,16,1392200,64
1443,y1303,20121207,8684,8700,8700,8700,8686,8686,8696,-14,-4,18,1565320,62
1444,y1303,20121210,8686,8696,8700,8700,8700,8700,8700,4,4,6,522000,60
1445,y1303,20121211,8700,8700,8736,8790,8362,8674,8702,-26,2,248,21585600,130
1446,y1303,20121212,8674,8702,8688,8688,8558,8560,8582,-142,-120,66,5664440,124
1447,y1303,20121213,8560,8582,8582,8596,8538,8560,8562,-22,-20,22,1884040,124
1448,y1303,20121214,8560,8562,8562,8690,8548,8652,8618,90,56,92,7930120,94
1449,y1303,20121217,8652,8618,8682,8724,8682,8724,8710,106,92,20,1742040,100
1450,y1303,20121218,8724,8710,8730,8730,8722,8722,8728,12,18,26,2269320,94
1451,y1303,20121219,8722,8728,8670,8684,8622,8656,8652,-72,-76,16,1384360,88
1452,y1303,20121220,8656,8652,8540,8540,8526,8536,8532,-116,-120,10,853320,92
1453,y1303,20121221,8536,8532,8494,8628,8494,8628,8568,96,36,36,3084920,84
1454,y1303,20121224,8628,8568,8660,8660,8626,8626,8636,58,68,16,1381920,76
1455,y1303,20121225,8626,8636,8564,8628,8532,8586,8574,-50,-62,20,1715080,74
1456,y1303,20121226,8586,8574,8576,8576,8544,8544,8558,-30,-16,24,2054240,76
1457,y1303,20121227,8544,8558,8532,8596,8532,8570,8578,12,20,26,2230400,74
1458,y1303,20121228,8570,8578,8638,8638,8590,8590,8620,12,42,36,3103360,74
1459,y1303,20121231,8590,8620,8630,8670,8630,8662,8648,42,28,14,1210920,70
1460,y1305,20120517,9260,9352,9352,9380,9300,9352,9346,0,-6,5746,537059560,13530
1461,y1305,20120518,9352,9346,9330,9330,9190,9230,9246,-116,-100,4766,440700840,14752
1462,y1305,20120521,9230,9246,9288,9328,9254,9266,9262,20,16,22220,2058260480,31976
1463,y1305,20120522,9266,9262,9266,9298,9258,9280,9282,18,20,8050,747233200,36522
1464,y1305,20120523,9280,9282,9180,9180,9042,9060,9120,-222,-162,5808,529741520,38712
1465,y1305,20120524,9060,9120,9070,9106,8998,9102,9062,-18,-58,8044,729069960,41026
1466,y1305,20120525,9102,9062,9090,9106,9044,9096,9088,34,26,6068,551496080,42866
1467,y1305,20120528,9096,9088,9160,9210,9132,9204,9168,116,80,8262,757610920,45512
1468,y1305,20120529,9204,9168,9188,9238,9154,9228,9200,60,32,17784,1636479480,54574
1469,y1305,20120530,9228,9200,9200,9206,9132,9150,9168,-50,-32,13734,1259255400,60764
1470,y1305,20120531,9150,9168,9100,9130,9072,9096,9104,-72,-64,20416,1858813560,70102
1471,y1305,20120601,9096,9104,9040,9066,8976,8986,9020,-118,-84,31058,2801910120,85780
1472,y1305,20120604,8986,9020,8980,8980,8764,8802,8860,-218,-160,28060,2486660160,94370
1473,y1305,20120605,8802,8860,8860,8922,8838,8882,8878,22,18,12170,1080469880,96736
1474,y1305,20120606,8882,8878,8900,8988,8892,8946,8956,68,78,13690,1226314520,99148
1475,y1305,20120607,8946,8956,9010,9054,8976,9002,9020,46,64,15038,1356472560,97362
1476,y1305,20120608,9002,9020,9020,9070,8982,9030,9028,10,8,19128,1726924200,96236
1477,y1305,20120611,9030,9028,9096,9180,9058,9170,9140,142,112,28048,2564042360,105640
1478,y1305,20120612,9170,9140,9100,9140,9084,9140,9108,0,-32,17992,1639028360,109932
1479,y1305,20120613,9140,9108,9138,9140,9106,9114,9122,6,14,14248,1299968440,109328
1480,y1305,20120614,9114,9122,9060,9068,8948,8948,8996,-174,-126,16712,1503486080,108690
1481,y1305,20120615,8948,8996,8916,9000,8916,8982,8976,-14,-20,16324,1465298680,111540
1482,y1305,20120618,8982,8976,9064,9088,9014,9082,9054,106,78,17208,1558126000,111558
1483,y1305,20120619,9082,9054,9118,9196,9100,9162,9156,108,102,19752,1808771840,112612
1484,y1305,20120620,9162,9156,9246,9370,9240,9358,9312,202,156,29352,2733262640,117746
1485,y1305,20120621,9358,9312,9300,9326,9256,9290,9288,-22,-24,41250,3831657600,130712
1486,y1305,20120625,9290,9288,9310,9456,9310,9376,9420,88,132,72732,6851625160,146646
1487,y1305,20120626,9376,9420,9440,9440,9320,9352,9366,-68,-54,38954,3648496840,146874
1488,y1305,20120627,9352,9366,9358,9376,9298,9358,9332,-8,-34,51786,4832873400,152804
1489,y1305,20120628,9358,9332,9356,9396,9306,9314,9334,-18,2,46396,4331430120,162516
1490,y1305,20120629,9314,9334,9330,9378,9286,9378,9332,44,-2,42234,3941596600,174632
1491,y1305,20120702,9378,9332,9538,9560,9442,9444,9472,112,140,55434,5251233040,172664
1492,y1305,20120703,9444,9472,9460,9534,9450,9532,9496,60,24,44512,4227061880,173670
1493,y1305,20120704,9532,9496,9576,9616,9526,9562,9580,66,84,56138,5378943200,174480
1494,y1305,20120705,9562,9580,9560,9644,9536,9616,9596,36,16,63182,6063814320,176920
1495,y1305,20120706,9616,9596,9630,9680,9568,9580,9636,-16,40,61530,5929140640,175968
1496,y1305,20120709,9580,9636,9602,9746,9538,9708,9660,72,24,93834,9064702360,179636
1497,y1305,20120710,9708,9660,9670,9690,9598,9598,9646,-62,-14,57916,5587173000,177312
1498,y1305,20120711,9598,9646,9596,9686,9506,9558,9600,-88,-46,66032,6340315480,173648
1499,y1305,20120712,9558,9600,9528,9528,9410,9412,9452,-188,-148,44070,4166008200,173210
1500,y1305,20120713,9412,9452,9440,9486,9416,9482,9456,30,4,41748,3947713040,168442
1501,y1305,20120716,9482,9456,9560,9734,9560,9710,9686,254,230,54102,5241107520,170220
1502,y1305,20120717,9710,9686,9750,9760,9588,9648,9666,-38,-20,61944,5987942640,162768
1503,y1305,20120718,9648,9666,9668,9678,9542,9580,9626,-86,-40,48078,4628352920,156276
1504,y1305,20120719,9580,9626,9650,9668,9598,9658,9644,32,18,84084,8109899560,166576
1505,y1305,20120720,9658,9644,9660,9746,9634,9668,9684,24,40,84306,8164550880,178304
1506,y1305,20120723,9668,9684,9580,9598,9470,9474,9520,-210,-164,75064,7146098880,180144
1507,y1305,20120724,9474,9520,9140,9312,9140,9232,9242,-288,-278,59614,5510279800,181552
1508,y1305,20120725,9232,9242,9158,9256,9110,9182,9190,-60,-52,65088,5982645120,179918
1509,y1305,20120726,9182,9190,9188,9244,9180,9200,9210,10,20,41262,3800401560,178336
1510,y1305,20120727,9200,9210,9180,9262,9180,9256,9224,46,14,37076,3419914040,183234
1511,y1305,20120730,9256,9224,9330,9592,9330,9398,9404,174,180,70678,6647094800,180130
1512,y1305,20120731,9398,9404,9380,9400,9350,9392,9372,-12,-32,41010,3843776040,178494
1513,y1305,20120801,9392,9372,9416,9496,9406,9438,9454,66,82,57086,5397418400,181350
1514,y1305,20120802,9438,9454,9388,9398,9340,9398,9368,-56,-86,40750,3817931200,180676
1515,y1305,20120803,9398,9368,9352,9406,9320,9382,9372,14,4,38996,3654886160,185220
1516,y1305,20120806,9382,9372,9300,9464,9300,9438,9416,66,44,54954,5175221800,194822
1517,y1305,20120807,9438,9416,9432,9548,9430,9548,9514,132,98,90154,8578346360,202432
1518,y1305,20120808,9548,9514,9542,9554,9490,9520,9526,6,12,113422,10804703600,220018
1519,y1305,20120809,9520,9526,9574,9666,9552,9652,9624,126,98,130180,12528996920,229500
1520,y1305,20120810,9652,9624,9660,9702,9602,9616,9646,-8,22,99668,9614047240,233164
1521,y1305,20120813,9616,9646,9700,9726,9644,9650,9688,4,42,119016,11531175520,232366
1522,y1305,20120814,9650,9688,9620,9656,9534,9608,9602,-80,-86,104690,10053660760,237166
1523,y1305,20120815,9608,9602,9606,9610,9546,9594,9576,-8,-26,103684,9930158920,246582
1524,y1305,20120816,9594,9576,9606,9618,9552,9556,9574,-20,-2,60666,5808846760,247964
1525,y1305,20120817,9556,9574,9556,9616,9556,9592,9590,18,16,63308,6071716160,238664
1526,y1305,20120820,9592,9590,9612,9640,9612,9626,9626,36,36,51962,5002447720,243684
1527,y1305,20120821,9626,9626,9660,9698,9640,9680,9674,54,48,63428,6136519400,239388
1528,y1305,20120822,9680,9674,9810,9858,9764,9832,9816,158,142,63296,6213378320,241054
1529,y1305,20120823,9832,9816,9888,9914,9826,9844,9866,28,50,77872,7684268560,241922
1530,y1305,20120824,9844,9866,9782,9958,9782,9954,9884,88,18,85134,8415947080,243576
1531,y1305,20120827,9954,9884,10004,10050,9972,10000,10002,116,118,90340,9036560960,246076
1532,y1305,20120828,10000,10002,9940,9958,9858,9864,9910,-138,-92,73578,7291952320,245156
1533,y1305,20120829,9864,9910,9870,9902,9784,9844,9840,-66,-70,91704,9024542800,251444
1534,y1305,20120830,9844,9840,9880,9970,9866,9960,9910,120,70,70732,7009569040,252414
1535,y1305,20120831,9960,9910,9942,9948,9848,9854,9890,-56,-20,73906,7309932800,250108
1536,y1305,20120903,9854,9890,9850,10130,9850,10102,10036,212,146,103300,10367534640,250230
1537,y1305,20120904,10102,10036,10096,10186,10082,10178,10146,142,110,173156,17568517760,276940
1538,y1305,20120905,10178,10146,10150,10210,10114,10158,10168,12,22,245248,24941570280,306364
1539,y1305,20120906,10158,10168,10090,10110,9990,10038,10044,-130,-124,189052,18989162360,300710
1540,y1305,20120907,10038,10044,10060,10100,9966,9966,10044,-78,0,173906,17469649360,300738
1541,y1305,20120910,9966,10044,9932,10040,9932,10012,9996,-32,-48,111764,11172851480,299352
1542,y1305,20120911,10012,9996,9980,10070,9860,9894,9958,-102,-38,242712,24170645480,299310
1543,y1305,20120912,9894,9958,9870,9930,9862,9922,9898,-36,-60,131802,13047643440,300638
1544,y1305,20120913,9922,9898,9978,10018,9922,9928,9982,30,84,139888,13966061200,309114
1545,y1305,20120914,9928,9982,10030,10094,9996,10060,10050,78,68,141970,14268486560,308734
1546,y1305,20120917,10060,10050,10048,10058,9802,9810,9950,-240,-100,161676,16088212080,308874
1547,y1305,20120918,9810,9950,9678,9750,9598,9642,9670,-308,-280,188386,18220023080,306688
1548,y1305,20120919,9642,9670,9696,9736,9680,9698,9706,28,36,130414,12659340600,307026
1549,y1305,20120920,9698,9706,9756,9766,9646,9666,9696,-40,-10,150336,14579222640,311868
1550,y1305,20120921,9666,9696,9630,9650,9570,9586,9608,-110,-88,142070,13650641760,311124
1551,y1305,20120924,9586,9608,9508,9528,9262,9338,9360,-270,-248,249258,23332112120,316290
1552,y1305,20120925,9338,9360,9360,9422,9300,9352,9358,-8,-2,161156,15084161200,316106
1553,y1305,20120926,9352,9358,9300,9334,9210,9224,9266,-134,-92,158240,14664784960,312626
1554,y1305,20120927,9224,9266,9200,9212,9140,9142,9170,-124,-96,123434,11319853280,305868
1555,y1305,20120928,9142,9170,9200,9218,9160,9178,9186,8,16,93978,8634497520,307656
1556,y1305,20121008,9178,9186,9100,9110,9004,9046,9050,-140,-136,137520,12446884040,324510
1557,y1305,20121009,9046,9050,9100,9190,9082,9174,9138,124,88,183656,16785024400,345840
1558,y1305,20121010,9174,9138,9100,9196,9088,9184,9132,46,-6,184210,16822958400,361710
1559,y1305,20121011,9184,9132,9130,9240,9120,9190,9186,58,54,262014,24073143640,384030
1560,y1305,20121012,9190,9186,9228,9240,9092,9100,9168,-86,-18,311050,28517356400,385460
1561,y1305,20121015,9100,9168,9010,9066,8946,9036,9026,-132,-142,267902,24183909560,407006
1562,y1305,20121016,9036,9026,9086,9226,9070,9216,9168,190,142,486566,44609412320,451754
1563,y1305,20121017,9216,9168,9196,9284,9144,9188,9204,20,36,750246,69057713640,471990
1564,y1305,20121018,9188,9204,9248,9284,9226,9250,9258,46,54,487786,45162853560,472642
1565,y1305,20121019,9250,9258,9300,9320,9250,9260,9278,2,20,409802,38029142240,478924
1566,y1305,20121022,9260,9278,9252,9318,9182,9318,9276,40,-2,442986,41091507640,478770
1567,y1305,20121023,9318,9276,9300,9336,9216,9224,9278,-52,2,494888,45921856800,485346
1568,y1305,20121024,9224,9278,9260,9296,9242,9284,9270,6,-8,437228,40531756560,494332
1569,y1305,20121025,9284,9270,9286,9300,9228,9232,9264,-38,-6,415794,38523440840,499756
1570,y1305,20121026,9232,9264,9210,9210,9068,9098,9134,-166,-130,755736,69035428800,560280
1571,y1305,20121029,9098,9134,9062,9076,9002,9010,9038,-124,-96,428860,38762104720,554530
1572,y1305,20121030,9010,9038,9000,9032,8972,9012,9004,-26,-34,499330,44961263560,549006
1573,y1305,20121031,9012,9004,9008,9082,8980,9070,9030,66,26,562136,50766337840,546206
1574,y1305,20121101,9070,9030,9050,9142,9050,9118,9102,88,72,459344,41815902760,544628
1575,y1305,20121102,9118,9102,9100,9110,8872,8880,8962,-222,-140,1066320,95576160160,652666
1576,y1305,20121105,8880,8962,8800,8840,8656,8694,8750,-268,-212,924432,80902209960,645990
1577,y1305,20121106,8694,8750,8718,8808,8712,8762,8766,12,16,586256,51393087200,625950
1578,y1305,20121107,8762,8766,8780,8802,8670,8764,8750,-2,-16,728534,63759663920,613928
1579,y1305,20121108,8764,8750,8722,8796,8690,8750,8760,0,10,652164,57136135160,625886
1580,y1305,20121109,8750,8760,8750,8758,8604,8614,8690,-146,-70,923734,80279203760,696082
1581,y1305,20121112,8614,8690,8502,8518,8344,8348,8388,-342,-302,1031644,86545715800,707158
1582,y1305,20121113,8348,8388,8412,8442,8374,8400,8410,12,22,629646,52961436400,679026
1583,y1305,20121114,8400,8410,8410,8464,8322,8448,8394,38,-16,964362,80951946440,705086
1584,y1305,20121115,8448,8394,8434,8580,8406,8416,8506,22,112,1055922,89827340840,665954
1585,y1305,20121116,8416,8506,8430,8466,8348,8370,8404,-136,-102,986618,82919618120,704030
1586,y1305,20121119,8370,8404,8406,8470,8396,8450,8438,46,34,743280,62719363200,667158
1587,y1305,20121120,8450,8438,8494,8508,8428,8496,8474,58,36,813062,68902120720,632480
1588,y1305,20121121,8496,8474,8528,8548,8484,8538,8516,64,42,644404,54880800400,635540
1589,y1305,20121122,8538,8516,8550,8562,8510,8534,8534,18,18,452160,38591419360,630684
1590,y1305,20121123,8534,8534,8520,8550,8474,8548,8510,14,-24,511628,43542606760,612460
1591,y1305,20121126,8548,8510,8600,8626,8578,8602,8600,92,90,519198,44660538040,618176
1592,y1305,20121127,8602,8600,8626,8650,8560,8568,8608,-32,8,535904,46135166120,633934
1593,y1305,20121128,8568,8608,8630,8664,8550,8576,8610,-32,2,719364,61937820640,641360
1594,y1305,20121129,8576,8610,8610,8614,8524,8590,8570,-20,-40,699060,59913200480,645088
1595,y1305,20121130,8590,8570,8580,8608,8520,8590,8566,20,-4,683694,58576499120,626098
1596,y1305,20121203,8590,8566,8610,8700,8600,8684,8664,118,98,548740,47547915440,623934
1597,y1305,20121204,8684,8664,8660,8678,8612,8676,8648,12,-16,469212,40583072600,621808
1598,y1305,20121205,8676,8648,8674,8728,8668,8710,8698,62,50,478530,41622872200,613212
1599,y1305,20121206,8710,8698,8772,8810,8726,8738,8770,40,72,502082,44035216640,604906
1600,y1305,20121207,8738,8770,8750,8774,8708,8774,8750,4,-20,372106,32560975080,602444
1601,y1305,20121210,8774,8750,8728,8788,8722,8752,8752,2,2,379386,33210938880,591126
1602,y1305,20121211,8752,8752,8750,8834,8740,8740,8784,-12,32,547628,48112754240,586308
1603,y1305,20121212,8740,8784,8690,8708,8612,8622,8660,-162,-124,532042,46083216800,584150
1604,y1305,20121213,8622,8660,8590,8638,8586,8610,8614,-50,-46,445940,38419037240,575642
1605,y1305,20121214,8610,8614,8586,8738,8586,8732,8666,118,52,609228,52805593480,553770
1606,y1305,20121217,8732,8666,8756,8824,8748,8792,8788,126,122,552002,48511033080,529654
1607,y1305,20121218,8792,8788,8782,8840,8766,8792,8800,4,12,505078,44449928280,539424
1608,y1305,20121219,8792,8800,8736,8754,8672,8724,8718,-76,-82,484828,42268597200,545380
1609,y1305,20121220,8724,8718,8626,8642,8534,8584,8580,-134,-138,712196,61110567320,576416
1610,y1305,20121221,8584,8580,8550,8658,8550,8630,8606,50,26,666688,57379193520,570290
1611,y1305,20121224,8630,8606,8656,8700,8616,8618,8662,12,56,428390,37115112040,558134
1612,y1305,20121225,8618,8662,8640,8668,8562,8602,8608,-60,-54,518272,44621848320,534636
1613,y1305,20121226,8602,8608,8606,8650,8542,8572,8594,-36,-14,552382,47478339440,547060
1614,y1305,20121227,8572,8594,8562,8636,8524,8634,8582,40,-12,692036,59402525200,537370
1615,y1305,20121228,8634,8582,8620,8674,8610,8642,8642,60,60,507182,43834393000,507428
1616,y1305,20121231,8642,8642,8672,8740,8608,8612,8680,-30,38,449196,38998449560,500834
1617,y1307,20120717,9452,9452,0,0,0,9452,9452,0,0,0,0,0
1618,y1307,20120718,9452,9452,0,0,0,9452,9452,0,0,0,0,0
1619,y1307,20120719,9452,9452,0,0,0,9452,9452,0,0,0,0,0
1620,y1307,20120720,9452,9452,9520,9728,9520,9674,9640,222,188,30,2892120,0
1621,y1307,20120723,9674,9640,0,0,0,9640,9640,0,0,0,0,0
1622,y1307,20120724,9640,9640,9288,9288,9288,9288,9288,-352,-352,4,371520,4
1623,y1307,20120725,9288,9288,0,0,0,9288,9288,0,0,0,0,4
1624,y1307,20120726,9288,9288,0,0,0,9288,9288,0,0,0,0,4
1625,y1307,20120727,9288,9288,0,0,0,9288,9288,0,0,0,0,4
1626,y1307,20120730,9288,9288,9400,9400,9400,9400,9400,112,112,4,376000,4
1627,y1307,20120731,9400,9400,0,0,0,9400,9400,0,0,0,0,4
1628,y1307,20120801,9400,9400,0,0,0,9400,9400,0,0,0,0,4
1629,y1307,20120802,9400,9400,0,0,0,9400,9400,0,0,0,0,4
1630,y1307,20120803,9400,9400,0,0,0,9400,9400,0,0,0,0,4
1631,y1307,20120806,9400,9400,0,0,0,9400,9400,0,0,0,0,4
1632,y1307,20120807,9400,9400,9262,9562,9262,9562,9412,162,12,8,752960,4
1633,y1307,20120808,9562,9412,0,0,0,9412,9412,0,0,0,0,4
1634,y1307,20120809,9412,9412,0,0,0,9412,9412,0,0,0,0,4
1635,y1307,20120810,9412,9412,0,0,0,9412,9412,0,0,0,0,4
1636,y1307,20120813,9412,9412,0,0,0,9412,9412,0,0,0,0,4
1637,y1307,20120814,9412,9412,0,0,0,9412,9412,0,0,0,0,4
1638,y1307,20120815,9412,9412,9630,9630,9592,9592,9610,180,198,4,384440,2
1639,y1307,20120816,9592,9610,0,0,0,9610,9610,0,0,0,0,2
1640,y1307,20120817,9610,9610,0,0,0,9610,9610,0,0,0,0,2
1641,y1307,20120820,9610,9610,0,0,0,9610,9610,0,0,0,0,2
1642,y1307,20120821,9610,9610,0,0,0,9610,9610,0,0,0,0,2
1643,y1307,20120822,9610,9610,9822,9832,9820,9824,9824,214,214,22,2161520,8
1644,y1307,20120823,9824,9824,10050,10050,9880,9900,9918,76,94,16,1587040,14
1645,y1307,20120824,9900,9918,9910,9930,9902,9930,9914,12,-4,12,1189840,8
1646,y1307,20120827,9930,9914,10056,10056,10056,10056,10056,142,142,2,201120,8
1647,y1307,20120828,10056,10056,0,0,0,10056,10056,0,0,0,0,8
1648,y1307,20120829,10056,10056,0,0,0,10056,10056,0,0,0,0,8
1649,y1307,20120830,10056,10056,0,0,0,10056,10056,0,0,0,0,8
1650,y1307,20120831,10056,10056,0,0,0,10056,10056,0,0,0,0,8
1651,y1307,20120903,10056,10056,10080,10080,10080,10080,10080,24,24,2,201600,6
1652,y1307,20120904,10080,10080,0,0,0,10080,10080,0,0,0,0,6
1653,y1307,20120905,10080,10080,10180,10180,10150,10150,10164,70,84,4,406600,6
1654,y1307,20120906,10150,10164,10114,10114,10012,10030,10052,-134,-112,6,603120,4
1655,y1307,20120907,10030,10052,0,0,0,10052,10052,0,0,0,0,4
1656,y1307,20120910,10052,10052,0,0,0,10052,10052,0,0,0,0,4
1657,y1307,20120911,10052,10052,10020,10038,9940,9940,9998,-112,-54,6,599960,2
1658,y1307,20120912,9940,9998,0,0,0,9998,9998,0,0,0,0,2
1659,y1307,20120913,9998,9998,10050,10050,9956,9956,10002,-42,4,4,400120,4
1660,y1307,20120914,9956,10002,10050,10050,10050,10050,10050,48,48,2,201000,4
1661,y1307,20120917,10050,10050,9990,9990,9990,9990,9990,-60,-60,2,199800,4
1662,y1307,20120918,9990,9990,9800,9800,9800,9800,9800,-190,-190,2,196000,4
1663,y1307,20120919,9800,9800,0,0,0,9800,9800,0,0,0,0,4
1664,y1307,20120920,9800,9800,0,0,0,9800,9800,0,0,0,0,4
1665,y1307,20120921,9800,9800,9818,9818,9528,9644,9658,-156,-142,14,1352200,6
1666,y1307,20120924,9644,9658,9310,9470,9310,9390,9414,-268,-244,14,1318200,6
1667,y1307,20120925,9390,9414,0,0,0,9414,9414,0,0,0,0,6
1668,y1307,20120926,9414,9414,9306,9306,9306,9306,9306,-108,-108,2,186120,4
1669,y1307,20120927,9306,9306,0,0,0,9306,9306,0,0,0,0,4
1670,y1307,20120928,9306,9306,0,0,0,9306,9306,0,0,0,0,4
1671,y1307,20121008,9306,9306,9000,9030,8998,9030,9008,-276,-298,6,540560,8
1672,y1307,20121009,9030,9008,9070,9122,9070,9090,9094,82,86,6,545640,10
1673,y1307,20121010,9090,9094,9120,9154,9118,9154,9136,60,42,16,1461800,12
1674,y1307,20121011,9154,9136,9230,9230,9038,9210,9176,74,40,22,2018840,14
1675,y1307,20121012,9210,9176,9182,9182,9182,9182,9182,6,6,2,183640,12
1676,y1307,20121015,9182,9182,0,0,0,9182,9182,0,0,0,0,12
1677,y1307,20121016,9182,9182,9160,9162,9136,9162,9146,-20,-36,10,914600,8
1678,y1307,20121017,9162,9146,9242,9242,9242,9242,9242,96,96,2,184840,8
1679,y1307,20121018,9242,9242,9264,9264,9264,9264,9264,22,22,2,185280,6
1680,y1307,20121019,9264,9264,9290,9308,9284,9284,9294,20,30,6,557640,4
1681,y1307,20121022,9284,9294,0,0,0,9294,9294,0,0,0,0,4
1682,y1307,20121023,9294,9294,0,0,0,9294,9294,0,0,0,0,4
1683,y1307,20121024,9294,9294,0,0,0,9294,9294,0,0,0,0,4
1684,y1307,20121025,9294,9294,0,0,0,9294,9294,0,0,0,0,4
1685,y1307,20121026,9294,9294,9170,9230,9170,9230,9200,-64,-94,4,368000,4
1686,y1307,20121029,9230,9200,0,0,0,9200,9200,0,0,0,0,4
1687,y1307,20121030,9200,9200,9004,9016,8988,8996,9000,-204,-200,8,720080,4
1688,y1307,20121031,8996,9000,9052,9072,9050,9056,9060,56,60,30,2718240,8
1689,y1307,20121101,9056,9060,0,0,0,9060,9060,0,0,0,0,8
1690,y1307,20121102,9060,9060,9066,9066,8964,8964,9014,-96,-46,4,360600,8
1691,y1307,20121105,8964,9014,0,0,0,9014,9014,0,0,0,0,8
1692,y1307,20121106,9014,9014,0,0,0,9014,9014,0,0,0,0,8
1693,y1307,20121107,9014,9014,0,0,0,9014,9014,0,0,0,0,8
1694,y1307,20121108,9014,9014,8786,8850,8780,8844,8802,-170,-212,36,3168760,20
1695,y1307,20121109,8844,8802,8764,8764,8606,8606,8722,-196,-80,10,872240,26
1696,y1307,20121112,8606,8722,8526,8550,8376,8398,8420,-324,-302,28,2357960,12
1697,y1307,20121113,8398,8420,8440,8440,8440,8440,8440,20,20,2,168800,12
1698,y1307,20121114,8440,8440,8482,8482,8452,8452,8464,12,24,6,507880,10
1699,y1307,20121115,8452,8464,8550,8570,8468,8518,8512,54,48,20,1702760,10
1700,y1307,20121116,8518,8512,8470,8512,8366,8422,8392,-90,-120,60,5035360,42
1701,y1307,20121119,8422,8392,8378,8496,8378,8488,8442,96,50,50,4221480,56
1702,y1307,20121120,8488,8442,8478,8556,8472,8556,8516,114,74,16,1362680,60
1703,y1307,20121121,8556,8516,8572,8586,8560,8586,8574,70,58,10,857520,52
1704,y1307,20121122,8586,8574,8706,8706,8592,8592,8648,18,74,4,345960,52
1705,y1307,20121123,8592,8648,0,0,0,8648,8648,0,0,0,0,52
1706,y1307,20121126,8648,8648,8642,8670,8598,8670,8644,22,-4,44,3803800,62
1707,y1307,20121127,8670,8644,8626,8646,8618,8630,8634,-14,-10,28,2417960,54
1708,y1307,20121128,8630,8634,0,0,0,8634,8634,0,0,0,0,54
1709,y1307,20121129,8634,8634,8580,8628,8550,8628,8594,-6,-40,12,1031280,60
1710,y1307,20121130,8628,8594,8628,8628,8628,8628,8628,34,34,2,172560,60
1711,y1307,20121203,8628,8628,8674,8838,8674,8788,8772,160,144,58,5088840,56
1712,y1307,20121204,8788,8772,8738,8748,8716,8716,8726,-56,-46,14,1221760,56
1713,y1307,20121205,8716,8726,8756,8780,8740,8772,8756,46,30,28,2452160,56
1714,y1307,20121206,8772,8756,8868,8868,8814,8814,8852,58,96,26,2301640,50
1715,y1307,20121207,8814,8852,8824,8844,8824,8844,8836,-8,-16,6,530200,50
1716,y1307,20121210,8844,8836,0,0,0,8836,8836,0,0,0,0,50
1717,y1307,20121211,8836,8836,8862,8862,8862,8862,8862,26,26,2,177240,48
1718,y1307,20121212,8862,8862,8758,8758,8710,8710,8734,-152,-128,4,349360,48
1719,y1307,20121213,8710,8734,8668,8670,8668,8670,8668,-64,-66,4,346760,50
1720,y1307,20121214,8670,8668,8716,8744,8716,8738,8732,70,64,14,1222720,52
1721,y1307,20121217,8738,8732,8760,8842,8760,8842,8814,110,82,6,528880,52
1722,y1307,20121218,8842,8814,0,0,0,8814,8814,0,0,0,0,52
1723,y1307,20121219,8814,8814,8750,8750,8744,8744,8746,-70,-68,4,349880,52
1724,y1307,20121220,8744,8746,8618,8664,8614,8632,8634,-114,-112,12,1036200,48
1725,y1307,20121221,8632,8634,8636,8700,8636,8700,8686,66,52,14,1216080,48
1726,y1307,20121224,8700,8686,8676,8676,8676,8676,8676,-10,-10,2,173520,48
1727,y1307,20121225,8676,8676,8670,8670,8670,8670,8670,-6,-6,2,173400,48
1728,y1307,20121226,8670,8670,8652,8684,8646,8646,8660,-24,-10,6,519640,46
1729,y1307,20121227,8646,8660,8678,8678,8632,8632,8656,-28,-4,8,692520,48
1730,y1307,20121228,8632,8656,8660,8660,8660,8660,8660,4,4,2,173200,50
1731,y1307,20121231,8660,8660,0,0,0,8660,8660,0,0,0,0,50
1732,y1308,20120816,9688,9688,0,0,0,9688,9688,0,0,0,0,0
1733,y1308,20120817,9688,9688,0,0,0,9688,9688,0,0,0,0,0
1734,y1308,20120820,9688,9688,0,0,0,9688,9688,0,0,0,0,0
1735,y1308,20120821,9688,9688,0,0,0,9688,9688,0,0,0,0,0
1736,y1308,20120822,9688,9688,0,0,0,9688,9688,0,0,0,0,0
1737,y1308,20120823,9688,9688,0,0,0,9688,9688,0,0,0,0,0
1738,y1308,20120824,9688,9688,0,0,0,9688,9688,0,0,0,0,0
1739,y1308,20120827,9688,9688,9950,10040,9950,10040,9994,352,306,4,399800,0
1740,y1308,20120828,10040,9994,0,0,0,9994,9994,0,0,0,0,0
1741,y1308,20120829,9994,9994,9938,9938,9830,9856,9898,-138,-96,84,8315240,2
1742,y1308,20120830,9856,9898,9948,9948,9948,9948,9948,50,50,2,198960,2
1743,y1308,20120831,9948,9948,0,0,0,9948,9948,0,0,0,0,2
1744,y1308,20120903,9948,9948,9984,9984,9984,9984,9984,36,36,12,1198080,14
1745,y1308,20120904,9984,9984,10070,10070,10068,10068,10068,84,84,4,402760,12
1746,y1308,20120905,10068,10068,10244,10244,10070,10070,10120,2,52,8,809720,12
1747,y1308,20120906,10070,10120,0,0,0,10120,10120,0,0,0,0,12
1748,y1308,20120907,10120,10120,9996,10068,9996,10056,10028,-64,-92,16,1604520,6
1749,y1308,20120910,10056,10028,0,0,0,10028,10028,0,0,0,0,6
1750,y1308,20120911,10028,10028,9948,9948,9902,9902,9916,-126,-112,6,595040,6
1751,y1308,20120912,9902,9916,9938,9938,9924,9924,9930,8,14,4,397240,4
1752,y1308,20120913,9924,9930,0,0,0,9930,9930,0,0,0,0,4
1753,y1308,20120914,9930,9930,10076,10076,10050,10050,10062,120,132,4,402520,2
1754,y1308,20120917,10050,10062,9900,9900,9900,9900,9900,-162,-162,10,990000,12
1755,y1308,20120918,9900,9900,9818,9818,9818,9818,9818,-82,-82,2,196360,12
1756,y1308,20120919,9818,9818,0,0,0,9818,9818,0,0,0,0,12
1757,y1308,20120920,9818,9818,0,0,0,9818,9818,0,0,0,0,12
1758,y1308,20120921,9818,9818,0,0,0,9818,9818,0,0,0,0,12
1759,y1308,20120924,9818,9818,0,0,0,9818,9818,0,0,0,0,12
1760,y1308,20120925,9818,9818,0,0,0,9818,9818,0,0,0,0,12
1761,y1308,20120926,9818,9818,0,0,0,9818,9818,0,0,0,0,12
1762,y1308,20120927,9818,9818,0,0,0,9818,9818,0,0,0,0,12
1763,y1308,20120928,9818,9818,0,0,0,9818,9818,0,0,0,0,12
1764,y1308,20121008,9818,9818,9132,9132,9132,9132,9132,-686,-686,2,182640,12
1765,y1308,20121009,9132,9132,0,0,0,9132,9132,0,0,0,0,12
1766,y1308,20121010,9132,9132,0,0,0,9132,9132,0,0,0,0,12
1767,y1308,20121011,9132,9132,0,0,0,9132,9132,0,0,0,0,12
1768,y1308,20121012,9132,9132,0,0,0,9132,9132,0,0,0,0,12
1769,y1308,20121015,9132,9132,0,0,0,9132,9132,0,0,0,0,12
1770,y1308,20121016,9132,9132,9228,9236,9228,9236,9232,104,100,6,554000,14
1771,y1308,20121017,9236,9232,9238,9238,9238,9238,9238,6,6,2,184760,14
1772,y1308,20121018,9238,9238,0,0,0,9238,9238,0,0,0,0,14
1773,y1308,20121019,9238,9238,9320,9320,9320,9320,9320,82,82,2,186400,14
1774,y1308,20121022,9320,9320,0,0,0,9320,9320,0,0,0,0,14
1775,y1308,20121023,9320,9320,0,0,0,9320,9320,0,0,0,0,14
1776,y1308,20121024,9320,9320,0,0,0,9320,9320,0,0,0,0,14
1777,y1308,20121025,9320,9320,0,0,0,9320,9320,0,0,0,0,14
1778,y1308,20121026,9320,9320,0,0,0,9320,9320,0,0,0,0,14
1779,y1308,20121029,9320,9320,9320,9690,9108,9110,9378,-210,58,16,1500600,24
1780,y1308,20121030,9110,9378,0,0,0,9378,9378,0,0,0,0,24
1781,y1308,20121031,9378,9378,0,0,0,9378,9378,0,0,0,0,24
1782,y1308,20121101,9378,9378,0,0,0,9378,9378,0,0,0,0,24
1783,y1308,20121102,9378,9378,9034,9034,9004,9008,9008,-370,-370,18,1621600,36
1784,y1308,20121105,9008,9008,8898,8940,8848,8856,8884,-152,-124,42,3731280,62
1785,y1308,20121106,8856,8884,8864,8914,8860,8892,8878,8,-6,20,1775920,58
1786,y1308,20121107,8892,8878,8858,8878,8800,8874,8822,-4,-56,20,1764400,58
1787,y1308,20121108,8874,8822,0,0,0,8822,8822,0,0,0,0,58
1788,y1308,20121109,8822,8822,8800,8800,8712,8712,8758,-110,-64,64,5605400,72
1789,y1308,20121112,8712,8758,8458,8520,8410,8456,8456,-302,-302,136,11501320,66
1790,y1308,20121113,8456,8456,8528,8528,8452,8460,8486,4,30,88,7468880,28
1791,y1308,20121114,8460,8486,8432,8508,8426,8490,8462,4,-24,24,2030920,20
1792,y1308,20121115,8490,8462,8490,8628,8490,8490,8544,28,82,26,2221520,26
1793,y1308,20121116,8490,8544,8506,8510,8442,8442,8478,-102,-66,8,678320,22
1794,y1308,20121119,8442,8478,8518,8522,8518,8522,8520,44,42,4,340800,22
1795,y1308,20121120,8522,8520,8570,8570,8570,8570,8570,50,50,2,171400,22
1796,y1308,20121121,8570,8570,8622,8622,8590,8590,8606,20,36,68,5853200,30
1797,y1308,20121122,8590,8606,8606,8624,8606,8624,8612,18,6,10,861320,32
1798,y1308,20121123,8624,8612,8572,8572,8572,8572,8572,-40,-40,4,342880,32
1799,y1308,20121126,8572,8572,8692,8692,8658,8658,8664,86,92,10,866520,26
1800,y1308,20121127,8658,8664,8664,8664,8664,8664,8664,0,0,2,173280,26
1801,y1308,20121128,8664,8664,8640,8640,8640,8640,8640,-24,-24,2,172800,24
1802,y1308,20121129,8640,8640,8612,8654,8612,8654,8640,14,0,6,518400,24
1803,y1308,20121130,8654,8640,0,0,0,8640,8640,0,0,0,0,24
1804,y1308,20121203,8640,8640,8698,8758,8698,8758,8720,118,80,6,523200,22
1805,y1308,20121204,8758,8720,0,0,0,8720,8720,0,0,0,0,22
1806,y1308,20121205,8720,8720,8764,8766,8740,8740,8752,20,32,26,2275920,24
1807,y1308,20121206,8740,8752,0,0,0,8752,8752,0,0,0,0,24
1808,y1308,20121207,8752,8752,8788,8820,8788,8820,8806,68,54,14,1233040,18
1809,y1308,20121210,8820,8806,0,0,0,8806,8806,0,0,0,0,18
1810,y1308,20121211,8806,8806,8810,8882,8810,8848,8852,42,46,12,1062440,18
1811,y1308,20121212,8848,8852,8758,8758,8710,8710,8724,-142,-128,12,1047040,18
1812,y1308,20121213,8710,8724,8682,8682,8682,8682,8682,-42,-42,2,173640,18
1813,y1308,20121214,8682,8682,8576,8720,8576,8718,8670,36,-12,20,1734080,24
1814,y1308,20121217,8718,8670,8832,8832,8832,8832,8832,162,162,2,176640,22
1815,y1308,20121218,8832,8832,8816,8850,8752,8752,8804,-80,-28,12,1056480,14
1816,y1308,20121219,8752,8804,8752,8764,8700,8740,8734,-64,-70,26,2271160,22
1817,y1308,20121220,8740,8734,8638,8638,8588,8632,8618,-102,-116,12,1034360,26
1818,y1308,20121221,8632,8618,8644,8710,8610,8708,8670,90,52,20,1734040,22
1819,y1308,20121224,8708,8670,8718,8816,8666,8816,8736,146,66,10,873640,20
1820,y1308,20121225,8816,8736,8646,8646,8646,8646,8646,-90,-90,4,345840,16
1821,y1308,20121226,8646,8646,8608,8718,8608,8638,8646,-8,0,34,2940280,22
1822,y1308,20121227,8638,8646,8616,8648,8602,8632,8624,-14,-22,8,689960,22
1823,y1308,20121228,8632,8624,8682,8682,8682,8682,8682,58,58,2,173640,24
1824,y1308,20121231,8682,8682,8736,8736,8650,8684,8688,2,6,10,868840,18
1825,y1309,20120918,9900,9988,9900,9900,9720,9776,9774,-212,-214,224,21897000,224
1826,y1309,20120919,9776,9774,9862,9862,9800,9800,9830,26,56,114,11207720,252
1827,y1309,20120920,9800,9830,9808,9816,9740,9752,9788,-78,-42,304,29761280,424
1828,y1309,20120921,9752,9788,9714,9766,9678,9678,9710,-110,-78,228,22141200,580
1829,y1309,20120924,9678,9710,9600,9600,9400,9468,9518,-242,-192,484,46070600,778
1830,y1309,20120925,9468,9518,9482,9528,9454,9492,9504,-26,-14,350,33266240,978
1831,y1309,20120926,9492,9504,9488,9488,9354,9356,9424,-148,-80,244,22998520,1014
1832,y1309,20120927,9356,9424,9346,9346,9272,9276,9328,-148,-96,464,43290400,1028
1833,y1309,20120928,9276,9328,9300,9318,9264,9268,9286,-60,-42,396,36774440,1200
1834,y1309,20121008,9268,9286,9268,9268,9092,9128,9136,-158,-150,308,28139200,1304
1835,y1309,20121009,9128,9136,9184,9250,9184,9230,9210,94,74,1536,141486320,2516
1836,y1309,20121010,9230,9210,9168,9240,9160,9240,9200,30,-10,422,38828800,2594
1837,y1309,20121011,9240,9200,9240,9286,9206,9234,9222,34,22,1064,98124920,3218
1838,y1309,20121012,9234,9222,9270,9274,9150,9158,9216,-64,-6,1356,124983080,3148
1839,y1309,20121015,9158,9216,9052,9100,9020,9088,9122,-128,-94,1306,119146600,3868
1840,y1309,20121016,9088,9122,9102,9262,9102,9260,9210,138,88,1634,150495240,4680
1841,y1309,20121017,9260,9210,9234,9302,9200,9236,9256,26,46,4652,430596760,7946
1842,y1309,20121018,9236,9256,9294,9330,9278,9300,9306,44,50,808,75192520,8052
1843,y1309,20121019,9300,9306,9348,9362,9310,9312,9332,6,26,674,62905480,8230
1844,y1309,20121022,9312,9332,9304,9340,9224,9336,9314,4,-18,6424,598343560,14196
1845,y1309,20121023,9336,9314,9342,9356,9248,9250,9300,-64,-14,898,83529200,14200
1846,y1309,20121024,9250,9300,9286,9320,9272,9306,9300,6,0,1622,150853400,14618
1847,y1309,20121025,9306,9300,9310,9326,9260,9260,9288,-40,-12,1930,179295560,14726
1848,y1309,20121026,9260,9288,9280,9280,9102,9120,9162,-168,-126,3592,329112160,15276
1849,y1309,20121029,9120,9162,9086,9098,9036,9044,9070,-118,-92,2172,197022520,15324
1850,y1309,20121030,9044,9070,9036,9066,9012,9064,9050,-6,-20,7380,667962640,20340
1851,y1309,20121031,9064,9050,9080,9116,9038,9104,9064,54,14,8778,795785080,25210
1852,y1309,20121101,9104,9064,9088,9186,9088,9162,9122,98,58,6970,635871600,28458
1853,y1309,20121102,9162,9122,9160,9160,8930,8934,9024,-188,-98,9602,866494280,29394
1854,y1309,20121105,8934,9024,8918,8918,8714,8744,8840,-280,-184,30482,2694633400,43690
1855,y1309,20121106,8744,8840,8760,8860,8760,8820,8816,-20,-24,12920,1139069080,46714
1856,y1309,20121107,8820,8816,8830,8858,8728,8820,8806,4,-10,8186,720923240,46816
1857,y1309,20121108,8820,8806,8750,8844,8748,8802,8812,-4,6,7958,701270640,49032
1858,y1309,20121109,8802,8812,8740,8800,8670,8676,8738,-136,-74,14146,1236193640,52218
1859,y1309,20121112,8676,8738,8550,8574,8390,8390,8430,-348,-308,51746,4362955760,75922
1860,y1309,20121113,8390,8430,8430,8470,8412,8438,8442,8,12,27860,2352347560,80170
1861,y1309,20121114,8438,8442,8390,8484,8354,8474,8422,32,-20,53218,4482825960,100220
1862,y1309,20121115,8474,8422,8448,8610,8436,8446,8540,24,118,57226,4887974960,105480
1863,y1309,20121116,8446,8540,8450,8500,8380,8394,8436,-146,-104,55442,4677799760,107350
1864,y1309,20121119,8394,8436,8456,8528,8436,8518,8490,82,54,80170,6807895120,97842
1865,y1309,20121120,8518,8490,8550,8570,8492,8556,8530,66,40,61212,5221701240,111550
1866,y1309,20121121,8556,8530,8600,8604,8538,8596,8574,66,44,58430,5010480520,116638
1867,y1309,20121122,8596,8574,8596,8618,8568,8584,8590,10,16,49434,4247360200,123860
1868,y1309,20121123,8584,8590,8560,8610,8540,8608,8570,18,-20,51664,4427974160,124940
1869,y1309,20121126,8608,8570,8672,8692,8644,8666,8664,96,94,64756,5611277480,132472
1870,y1309,20121127,8666,8664,8694,8712,8626,8630,8678,-34,14,49268,4275582520,135510
1871,y1309,20121128,8630,8678,8702,8734,8616,8640,8672,-38,-6,87056,7549738880,136200
1872,y1309,20121129,8640,8672,8670,8684,8588,8656,8634,-16,-38,85468,7380819560,133752
1873,y1309,20121130,8656,8634,8622,8666,8588,8640,8624,6,-10,91278,7873611640,145612
1874,y1309,20121203,8640,8624,8638,8746,8638,8728,8706,104,82,68914,5999983400,150226
1875,y1309,20121204,8728,8706,8716,8720,8660,8720,8696,14,-10,55742,4847331120,149736
1876,y1309,20121205,8720,8696,8722,8764,8710,8756,8736,60,40,47540,4153382240,155954
1877,y1309,20121206,8756,8736,8802,8850,8776,8792,8808,56,72,62218,5481011840,159346
1878,y1309,20121207,8792,8808,8810,8822,8766,8820,8800,12,-8,42494,3739991280,159606
1879,y1309,20121210,8820,8800,8760,8820,8760,8798,8800,-2,0,56120,4938629240,164114
1880,y1309,20121211,8798,8800,8792,8870,8786,8786,8820,-14,20,69740,6152078320,170308
1881,y1309,20121212,8786,8820,8720,8748,8650,8656,8700,-164,-120,76174,6627494720,181508
1882,y1309,20121213,8656,8700,8660,8670,8610,8628,8642,-72,-58,83704,7235123480,191242
1883,y1309,20121214,8628,8642,8624,8704,8604,8700,8664,58,22,118234,10244158040,205286
1884,y1309,20121217,8700,8664,8748,8806,8732,8784,8776,120,112,97478,8555365720,190816
1885,y1309,20121218,8784,8776,8762,8822,8762,8774,8790,-2,14,86754,7626840960,181832
1886,y1309,20121219,8774,8790,8720,8740,8666,8728,8710,-62,-80,87586,7629467840,179364
1887,y1309,20121220,8728,8710,8628,8646,8538,8592,8582,-118,-128,126266,10836895240,194454
1888,y1309,20121221,8592,8582,8530,8668,8530,8644,8608,62,26,152078,13091637880,199122
1889,y1309,20121224,8644,8608,8668,8704,8622,8628,8666,20,58,112684,9766940120,212278
1890,y1309,20121225,8628,8666,8640,8672,8576,8610,8622,-56,-44,122114,10529492880,217648
1891,y1309,20121226,8610,8622,8602,8652,8562,8586,8610,-36,-12,104258,8976673400,214490
1892,y1309,20121227,8586,8610,8562,8622,8528,8620,8574,10,-36,249508,21394248840,235752
1893,y1309,20121228,8620,8574,8616,8656,8602,8626,8630,52,56,155462,13419210800,243020
1894,y1309,20121231,8626,8630,8640,8702,8600,8604,8658,-26,28,124268,10759880200,240630
1895,y1311,20121116,8442,8442,0,0,0,8442,8442,0,0,0,0,0
1896,y1311,20121119,8442,8442,0,0,0,8442,8442,0,0,0,0,0
1897,y1311,20121120,8442,8442,0,0,0,8442,8442,0,0,0,0,0
1898,y1311,20121121,8442,8442,0,0,0,8442,8442,0,0,0,0,0
1899,y1311,20121122,8442,8442,0,0,0,8442,8442,0,0,0,0,0
1900,y1311,20121123,8442,8442,0,0,0,8442,8442,0,0,0,0,0
1901,y1311,20121126,8442,8442,8600,8700,8600,8692,8656,250,214,26,2250800,2
1902,y1311,20121127,8692,8656,0,0,0,8656,8656,0,0,0,0,2
1903,y1311,20121128,8656,8656,0,0,0,8656,8656,0,0,0,0,2
1904,y1311,20121129,8656,8656,0,0,0,8656,8656,0,0,0,0,2
1905,y1311,20121130,8656,8656,0,0,0,8656,8656,0,0,0,0,2
1906,y1311,20121203,8656,8656,8702,8702,8702,8702,8702,46,46,2,174040,0
1907,y1311,20121204,8702,8702,0,0,0,8702,8702,0,0,0,0,0
1908,y1311,20121205,8702,8702,0,0,0,8702,8702,0,0,0,0,0
1909,y1311,20121206,8702,8702,8820,8820,8820,8820,8820,118,118,2,176400,2
1910,y1311,20121207,8820,8820,0,0,0,8820,8820,0,0,0,0,2
1911,y1311,20121210,8820,8820,0,0,0,8820,8820,0,0,0,0,2
1912,y1311,20121211,8820,8820,0,0,0,8820,8820,0,0,0,0,2
1913,y1311,20121212,8820,8820,8802,8802,8800,8800,8800,-20,-20,4,352040,4
1914,y1311,20121213,8800,8800,8688,8688,8688,8688,8688,-112,-112,2,173760,4
1915,y1311,20121214,8688,8688,0,0,0,8688,8688,0,0,0,0,4
1916,y1311,20121217,8688,8688,0,0,0,8688,8688,0,0,0,0,4
1917,y1311,20121218,8688,8688,0,0,0,8688,8688,0,0,0,0,4
1918,y1311,20121219,8688,8688,0,0,0,8688,8688,0,0,0,0,4
1919,y1311,20121220,8688,8688,8648,8648,8648,8648,8648,-40,-40,2,172960,4
1920,y1311,20121221,8648,8648,0,0,0,8648,8648,0,0,0,0,4
1921,y1311,20121224,8648,8648,8630,8630,8630,8630,8630,-18,-18,4,345200,6
1922,y1311,20121225,8630,8630,8678,8720,8678,8710,8700,80,70,14,1218240,8
1923,y1311,20121226,8710,8700,8684,8684,8684,8684,8684,-16,-16,2,173680,8
1924,y1311,20121227,8684,8684,0,0,0,8684,8684,0,0,0,0,8
1925,y1311,20121228,8684,8684,0,0,0,8684,8684,0,0,0,0,8
1926,y1311,20121231,8684,8684,0,0,0,8684,8684,0,0,0,0,8
1927,y1312,20121218,8642,8642,0,0,0,8642,8642,0,0,0,0,0
1928,y1312,20121219,8642,8642,8642,8642,8642,8642,8642,0,0,2,172840,2
1929,y1312,20121220,8642,8642,0,0,0,8642,8642,0,0,0,0,2
1930,y1312,20121221,8642,8642,8562,8660,8562,8660,8626,18,-16,6,517640,6
1931,y1312,20121224,8660,8626,0,0,0,8626,8626,0,0,0,0,6
1932,y1312,20121225,8626,8626,8668,8668,8668,8668,8668,42,42,2,173360,6
1933,y1312,20121226,8668,8668,0,0,0,8668,8668,0,0,0,0,6
1934,y1312,20121227,8668,8668,0,0,0,8668,8668,0,0,0,0,6
1935,y1312,20121228,8668,8668,8668,8668,8668,8668,8668,0,0,2,173360,4
1936,y1312,20121231,8668,8668,8650,8650,8650,8650,8650,-18,-18,2,173000,4