   ,合约,日期,前收盘价,前结算价,开盘价,最高价,最低价,收盘价,结算价,涨跌1,涨跌2,成交量,成交金额,持仓量
1,y1301,20130104,8560,8576,9090,9090,9090,9090,9090,514,514,8,727200,1058
2,y1301,20130107,9090,9090,8980,8980,8980,8980,8980,-110,-110,4,359200,1054
3,y1301,20130108,8980,8980,8760,8760,8750,8750,8754,-230,-226,4,350200,1050
4,y1301,20130109,8750,8754,0,0,0,8754,8754,0,0,0,0,1050
5,y1301,20130110,8754,8754,8230,8230,8230,8230,8230,-524,-524,2,164600,796
6,y1301,20130111,8230,8230,0,0,0,8230,8230,0,0,0,0,796
7,y1301,20130114,8230,8230,0,0,0,8230,8230,0,0,0,0,796
8,y1301,20130115,8230,8230,8500,8500,8410,8410,8456,180,226,44,3721000,750
9,y1301,20130116,8410,8456,8500,8500,8500,8500,8500,44,44,188,15980000,562
10,y1301,20130117,8500,8500,0,0,0,8500,8520,0,20,0,0,0
11,y1303,20130104,8662,8648,0,0,0,8648,8648,0,0,0,0,70
12,y1303,20130107,8648,8648,8668,8668,8566,8566,8640,-82,-8,34,2937640,72
13,y1303,20130108,8566,8640,8670,8670,8582,8614,8634,-26,-6,8,690720,72
14,y1303,20130109,8614,8634,8596,8596,8596,8596,8596,-38,-38,2,171920,74
15,y1303,20130110,8596,8596,8568,8568,8568,8568,8568,-28,-28,2,171360,74
16,y1303,20130111,8568,8568,8560,8560,8472,8480,8510,-88,-58,12,1021360,72
17,y1303,20130114,8480,8510,8528,8528,8484,8484,8506,-26,-4,4,340240,72
18,y1303,20130115,8484,8506,8576,8598,8576,8598,8586,92,80,4,343480,70
19,y1303,20130116,8598,8586,8620,8620,8588,8616,8602,30,16,10,860360,70
20,y1303,20130117,8616,8602,8678,8678,8592,8598,8636,-4,34,10,863600,72
21,y1303,20130118,8598,8636,8578,8580,8578,8580,8578,-56,-58,8,686320,76
22,y1303,20130121,8580,8578,8670,8670,8670,8670,8670,92,92,2,173400,74
23,y1303,20130122,8670,8670,8700,8700,8700,8700,8700,30,30,2,174000,72
24,y1303,20130123,8700,8700,0,0,0,8700,8700,0,0,0,0,72
25,y1303,20130124,8700,8700,8556,8646,8556,8586,8602,-114,-98,18,1548640,60
26,y1303,20130125,8586,8602,0,0,0,8602,8602,0,0,0,0,60
27,y1303,20130128,8602,8602,0,0,0,8602,8602,0,0,0,0,60
28,y1303,20130129,8602,8602,8550,8550,8550,8550,8550,-52,-52,2,171000,60
29,y1303,20130130,8550,8550,8588,8588,8588,8588,8588,38,38,8,687040,52
30,y1303,20130131,8588,8588,0,0,0,8588,8588,0,0,0,0,52
31,y1303,20130201,8588,8588,8680,8698,8680,8698,8686,110,98,12,1042400,42
32,y1303,20130204,8698,8686,0,0,0,8686,8686,0,0,0,0,42
33,y1303,20130205,8686,8686,8654,8694,8654,8694,8686,8,0,12,1042480,40
34,y1303,20130206,8694,8686,8686,8686,8686,8686,8686,0,0,2,173720,38
35,y1303,20130207,8686,8686,8564,8676,8564,8676,8620,-10,-66,12,1034400,40
36,y1303,20130208,8676,8620,8620,8620,8620,8620,8620,0,0,2,172400,38
37,y1303,20130218,8620,8620,0,0,0,8620,8620,0,0,0,0,38
38,y1303,20130219,8620,8620,8590,8590,8590,8590,8590,-30,-30,6,515400,34
39,y1303,20130220,8590,8590,8650,8650,8626,8626,8638,36,48,4,345520,30
40,y1303,20130221,8626,8638,8590,8590,8436,8436,8512,-202,-126,4,340520,26
41,y1303,20130222,8436,8512,8588,8642,8502,8642,8584,130,72,8,686840,22
42,y1303,20130225,8642,8584,8704,8704,8346,8346,8524,-238,-60,40,3410000,22
43,y1303,20130226,8346,8524,8354,8388,8354,8388,8366,-136,-158,6,502000,16
44,y1303,20130227,8388,8366,8368,8388,8368,8388,8374,22,8,10,837520,6
45,y1303,20130228,8388,8374,0,0,0,8374,8374,0,0,0,0,6
46,y1303,20130301,8374,8374,7872,7872,7872,7872,7872,-502,-502,6,472320,0
47,y1303,20130304,7872,7872,0,0,0,7872,7872,0,0,0,0,0
48,y1303,20130305,7872,7872,0,0,0,7872,7872,0,0,0,0,0
49,y1303,20130306,7872,7872,0,0,0,7872,7872,0,0,0,0,0
50,y1303,20130307,7872,7872,0,0,0,7872,7872,0,0,0,0,0
51,y1303,20130308,7872,7872,0,0,0,7872,7872,0,0,0,0,0
52,y1303,20130311,7872,7872,0,0,0,7872,7872,0,0,0,0,0
53,y1303,20130312,7872,7872,0,0,0,7872,7872,0,0,0,0,0
54,y1303,20130313,7872,7872,0,0,0,7872,7872,0,0,0,0,0
55,y1303,20130314,7872,7872,0,0,0,7872,7872,0,0,0,0,0
56,y1305,20130104,8612,8680,8698,8790,8642,8768,8722,88,42,491458,42871240920,474660
57,y1305,20130107,8768,8722,8702,8756,8676,8688,8710,-34,-12,534014,46522097440,508554
58,y1305,20130108,8688,8710,8710,8726,8634,8660,8680,-50,-30,490834,42604933520,457604
59,y1305,20130109,8660,8680,8662,8662,8590,8600,8618,-80,-62,353340,30451024960,463632
60,y1305,20130110,8600,8618,8612,8666,8556,8562,8622,-56,4,366328,31591046560,482564
61,y1305,20130111,8562,8622,8588,8594,8482,8488,8542,-134,-80,441100,37686632760,501760
62,y1305,20130114,8488,8542,8530,8572,8514,8530,8550,-12,8,330722,28277304920,487406
63,y1305,20130115,8530,8550,8604,8658,8584,8594,8620,44,70,306024,26379731880,457752
64,y1305,20130116,8594,8620,8650,8678,8610,8642,8646,22,26,257748,22287730840,442376
65,y1305,20130117,8642,8646,8690,8690,8612,8628,8652,-18,6,208194,18015472560,436198
66,y1305,20130118,8628,8652,8652,8686,8594,8678,8638,26,-14,248730,21487136760,420256
67,y1305,20130121,8678,8638,8688,8732,8678,8714,8706,76,68,163866,14268277160,403696
68,y1305,20130122,8714,8706,8720,8754,8714,8750,8736,44,30,159270,13914155480,374348
69,y1305,20130123,8750,8736,8772,8772,8732,8758,8748,22,12,104394,9133088960,361452
70,y1305,20130124,8758,8748,8728,8728,8612,8624,8658,-124,-90,112708,9759490680,356444
71,y1305,20130125,8624,8658,8662,8676,8636,8650,8654,-8,-4,61452,5318415280,350508
72,y1305,20130128,8650,8654,8662,8682,8616,8660,8646,6,-8,56336,4871074240,348396
73,y1305,20130129,8660,8646,8650,8652,8600,8618,8622,-28,-24,61262,5282769000,345390
74,y1305,20130130,8618,8622,8618,8658,8598,8654,8636,32,14,63174,5456522440,337420
75,y1305,20130131,8654,8636,8736,8748,8690,8720,8720,84,84,71496,6234793240,318060
76,y1305,20130201,8720,8720,8720,8752,8696,8746,8728,26,8,59750,5216120720,311010
77,y1305,20130204,8746,8728,8752,8798,8740,8768,8776,40,48,58222,5109778560,298544
78,y1305,20130205,8768,8776,8742,8762,8722,8734,8742,-42,-34,43862,3834857080,293598
79,y1305,20130206,8734,8742,8746,8760,8710,8728,8738,-14,-4,36574,3196416160,289152
80,y1305,20130207,8728,8738,8728,8728,8650,8686,8680,-52,-58,36186,3141052600,283176
81,y1305,20130208,8686,8680,8680,8712,8640,8640,8680,-40,0,25056,2175120800,276732
82,y1305,20130218,8640,8680,8580,8622,8548,8596,8594,-84,-86,26044,2238347160,274486
83,y1305,20130219,8596,8594,8580,8646,8580,8628,8624,34,30,31674,2731831800,266532
84,y1305,20130220,8628,8624,8680,8692,8658,8678,8674,54,50,26010,2256211440,264226
85,y1305,20130221,8678,8674,8630,8638,8564,8582,8598,-92,-76,48860,4201215520,256788
86,y1305,20130222,8582,8598,8580,8682,8568,8642,8624,44,26,39686,3423061800,248680
87,y1305,20130225,8642,8624,8512,8534,8336,8390,8414,-234,-210,60068,5054898560,245920
88,y1305,20130226,8390,8414,8376,8408,8276,8276,8350,-138,-64,43298,3616214320,247654
89,y1305,20130227,8276,8350,8298,8308,8244,8290,8280,-60,-70,38120,3156717360,242392
90,y1305,20130228,8290,8280,8302,8330,8232,8252,8282,-28,2,39422,3265167520,235782
91,y1305,20130301,8252,8282,8212,8250,8198,8218,8222,-64,-60,26016,2139143880,229646
92,y1305,20130304,8218,8222,8276,8306,8236,8288,8278,66,56,34758,2877458720,221904
93,y1305,20130305,8288,8278,8320,8350,8272,8294,8306,16,28,27392,2275448120,217600
94,y1305,20130306,8294,8306,8300,8326,8258,8316,8304,10,-2,25792,2142278320,208634
95,y1305,20130307,8316,8304,8300,8304,8224,8236,8260,-68,-44,19392,1601839400,205606
96,y1305,20130308,8236,8260,8300,8314,8268,8308,8296,48,36,15828,1313251600,203394
97,y1305,20130311,8308,8296,8304,8304,8196,8198,8244,-98,-52,27368,2256507640,200686
98,y1305,20130312,8198,8244,8216,8218,8124,8130,8176,-114,-68,22760,1861104960,194600
99,y1305,20130313,8130,8176,8140,8140,7992,8000,8040,-176,-136,25068,2015879400,188958
100,y1305,20130314,8000,8040,7750,8036,7750,7944,7972,-96,-68,26504,2113249240,178236
101,y1305,20130315,7944,7972,7970,8060,7948,8050,8010,78,38,19928,1596251800,168994
102,y1305,20130318,8050,8010,8012,8012,7934,7970,7976,-40,-34,10562,842536040,165454
103,y1305,20130319,7970,7976,7986,8034,7986,8014,8016,38,40,12182,976670400,161734
104,y1305,20130320,8014,8016,8000,8020,7960,8008,7996,-8,-20,12486,998384280,155026
105,y1305,20130321,8008,7996,8060,8102,8042,8060,8070,64,74,10760,868439320,149424
106,y1305,20130322,8060,8070,8072,8078,8014,8014,8038,-56,-32,11880,955070920,144522
107,y1305,20130325,8014,8038,8030,8064,8012,8016,8040,-22,2,8010,644090480,139822
108,y1305,20130326,8016,8040,8016,8044,8000,8006,8018,-34,-22,3686,295547320,138284
109,y1305,20130327,8006,8018,8048,8060,8004,8058,8036,40,18,6148,494173880,134378
110,y1305,20130328,8058,8036,8062,8062,7962,7982,8008,-54,-28,5074,406330400,132488
111,y1305,20130329,7982,8008,7884,7912,7786,7872,7872,-136,-136,8486,668029920,127404
112,y1305,20130401,7872,7872,7856,7868,7730,7732,7794,-140,-78,9228,719288400,122620
113,y1305,20130402,7732,7794,7766,7808,7742,7806,7776,12,-18,11434,889220880,114198
114,y1305,20130403,7806,7776,7776,7830,7736,7772,7784,-4,8,12606,981367560,105650
115,y1305,20130408,7772,7784,7746,7834,7722,7818,7804,34,20,11514,898668760,97710
116,y1305,20130409,7818,7804,7832,7880,7828,7838,7860,34,56,13956,1097092560,89546
117,y1305,20130410,7838,7860,7866,7900,7830,7862,7868,2,8,25838,2033240280,69852
118,y1305,20130411,7862,7868,7848,7866,7716,7718,7790,-150,-78,19162,1493062280,62448
119,y1305,20130412,7718,7790,7718,7732,7640,7642,7682,-148,-108,17828,1369629080,58492
120,y1305,20130415,7642,7682,7596,7600,7480,7516,7534,-166,-148,21266,1602293600,47384
121,y1305,20130416,7516,7534,7300,7466,7300,7462,7382,-72,-152,14994,1107091840,39970
122,y1305,20130417,7462,7382,7492,7524,7424,7450,7484,68,102,7108,532022280,38572
123,y1305,20130418,7450,7484,7442,7452,7368,7402,7408,-82,-76,8216,608792440,33556
124,y1305,20130419,7402,7408,7426,7464,7414,7422,7438,14,30,4468,332345520,30028
125,y1305,20130422,7422,7438,7350,7362,7202,7208,7270,-230,-168,6756,491287960,26932
126,y1305,20130423,7208,7270,7172,7238,7152,7190,7204,-80,-66,7782,560663160,21944
127,y1305,20130424,7190,7204,7156,7218,7074,7080,7144,-124,-60,7352,525360760,19320
128,y1305,20130425,7080,7144,7084,7158,7076,7108,7122,-36,-22,7640,544239160,16174
129,y1305,20130426,7108,7122,7166,7166,7060,7096,7114,-26,-8,6866,488527920,12140
130,y1305,20130502,7096,7114,6998,7000,6954,6962,6986,-152,-128,116,8105080,11086
131,y1305,20130503,6962,6986,6996,7046,6996,7046,7014,60,28,282,19780040,10860
132,y1305,20130506,7046,7014,7080,7136,7080,7136,7090,122,76,250,17729360,8072
133,y1305,20130507,7136,7090,7100,7186,7100,7186,7108,96,18,60,4265000,8066
134,y1305,20130508,7186,7108,7196,7212,7166,7204,7192,96,84,612,44024000,7474
135,y1305,20130509,7204,7192,0,0,0,7192,7192,0,0,0,0,5420
136,y1305,20130510,7192,7192,7188,7364,7188,7364,7292,172,100,38,2771280,5394
137,y1305,20130513,7364,7292,0,0,0,7292,7292,0,0,0,0,1302
138,y1305,20130514,7292,7292,7386,7386,7256,7256,7334,-36,42,20,1467000,1300
139,y1305,20130515,7256,7334,7098,7098,7098,7098,7120,-236,-214,8,567840,0
140,y1307,20130104,8660,8660,8738,8788,8738,8788,8756,128,96,6,525400,44
141,y1307,20130107,8788,8756,0,0,0,8756,8756,0,0,0,0,44
142,y1307,20130108,8756,8756,8766,8766,8692,8692,8726,-64,-30,12,1047120,48
143,y1307,20130109,8692,8726,8726,8726,8726,8726,8726,0,0,4,349040,48
144,y1307,20130110,8726,8726,8628,8628,8628,8628,8628,-98,-98,2,172560,46
145,y1307,20130111,8628,8628,8628,8628,8628,8628,8628,0,0,4,345120,50
146,y1307,20130114,8628,8628,8610,8610,8610,8610,8610,-18,-18,2,172200,52
147,y1307,20130115,8610,8610,8610,8690,8610,8690,8636,80,26,6,518200,48
148,y1307,20130116,8690,8636,8584,8762,8584,8692,8676,56,40,10,867640,50
149,y1307,20130117,8692,8676,8692,8728,8674,8674,8706,-2,30,14,1218920,50
150,y1307,20130118,8674,8706,8670,8702,8670,8702,8684,-4,-22,14,1215800,64
151,y1307,20130121,8702,8684,0,0,0,8684,8684,0,0,0,0,64
152,y1307,20130122,8684,8684,8790,8794,8790,8794,8790,110,106,14,1230840,56
153,y1307,20130123,8794,8790,8790,8790,8790,8790,8790,0,0,2,175800,54
154,y1307,20130124,8790,8790,8688,8726,8668,8680,8684,-110,-106,34,2952960,56
155,y1307,20130125,8680,8684,8710,8710,8710,8710,8710,26,26,2,174200,54
156,y1307,20130128,8710,8710,0,0,0,8710,8710,0,0,0,0,54
157,y1307,20130129,8710,8710,8712,8712,8686,8686,8694,-24,-16,6,521680,54
158,y1307,20130130,8686,8694,8660,8714,8660,8712,8698,18,4,8,695960,50
159,y1307,20130131,8712,8698,8778,8782,8778,8782,8778,84,80,12,1053480,48
160,y1307,20130201,8782,8778,8792,8792,8790,8790,8790,12,12,14,1230640,36
161,y1307,20130204,8790,8790,8838,8838,8778,8778,8808,-12,18,4,352320,34
162,y1307,20130205,8778,8808,8770,8806,8770,8806,8788,-2,-20,4,351520,34
163,y1307,20130206,8806,8788,0,0,0,8788,8788,0,0,0,0,34
164,y1307,20130207,8788,8788,8736,8736,8690,8690,8714,-98,-74,20,1743160,30
165,y1307,20130208,8690,8714,0,0,0,8714,8714,0,0,0,0,30
166,y1307,20130218,8714,8714,8606,8606,8606,8606,8606,-108,-108,4,344240,30
167,y1307,20130219,8606,8606,0,0,0,8606,8606,0,0,0,0,30
168,y1307,20130220,8606,8606,0,0,0,8606,8606,0,0,0,0,30
169,y1307,20130221,8606,8606,8612,8612,8612,8612,8612,6,6,4,344480,30
170,y1307,20130222,8612,8612,8616,8616,8616,8616,8616,4,4,2,172320,30
171,y1307,20130225,8616,8616,8388,8498,8378,8388,8426,-228,-190,14,1179640,28
172,y1307,20130226,8388,8426,8354,8354,8354,8354,8354,-72,-72,2,167080,28
173,y1307,20130227,8354,8354,0,0,0,8354,8354,0,0,0,0,28
174,y1307,20130228,8354,8354,8264,8336,8264,8290,8298,-64,-56,10,829960,24
175,y1307,20130301,8290,8298,0,0,0,8298,8298,0,0,0,0,24
176,y1307,20130304,8298,8298,8384,8384,8312,8312,8348,14,50,8,667840,22
177,y1307,20130305,8312,8348,0,0,0,8348,8348,0,0,0,0,22
178,y1307,20130306,8348,8348,0,0,0,8348,8348,0,0,0,0,22
179,y1307,20130307,8348,8348,0,0,0,8348,8348,0,0,0,0,22
180,y1307,20130308,8348,8348,0,0,0,8348,8348,0,0,0,0,22
181,y1307,20130311,8348,8348,8224,8224,8224,8224,8224,-124,-124,2,164480,22
182,y1307,20130312,8224,8224,0,0,0,8224,8224,0,0,0,0,22
183,y1307,20130313,8224,8224,0,0,0,8224,8224,0,0,0,0,22
184,y1307,20130314,8224,8224,8004,8004,8004,8004,8004,-220,-220,2,160080,20
185,y1307,20130315,8004,8004,0,0,0,8004,8004,0,0,0,0,20
186,y1307,20130318,8004,8004,0,0,0,8004,8004,0,0,0,0,20
187,y1307,20130319,8004,8004,0,0,0,8004,8004,0,0,0,0,20
188,y1307,20130320,8004,8004,0,0,0,8004,8004,0,0,0,0,20
189,y1307,20130321,8004,8004,0,0,0,8004,8004,0,0,0,0,20
190,y1307,20130322,8004,8004,0,0,0,8004,8004,0,0,0,0,20
191,y1307,20130325,8004,8004,0,0,0,8004,8004,0,0,0,0,20
192,y1307,20130326,8004,8004,0,0,0,8004,8004,0,0,0,0,20
193,y1307,20130327,8004,8004,0,0,0,8004,8004,0,0,0,0,20
194,y1307,20130328,8004,8004,0,0,0,8004,8004,0,0,0,0,20
195,y1307,20130329,8004,8004,0,0,0,8004,8004,0,0,0,0,20
196,y1307,20130401,8004,8004,0,0,0,8004,8004,0,0,0,0,20
197,y1307,20130402,8004,8004,0,0,0,8004,8004,0,0,0,0,20
198,y1307,20130403,8004,8004,0,0,0,8004,8004,0,0,0,0,20
199,y1307,20130408,8004,8004,7868,7892,7868,7892,7874,-112,-130,8,629920,14
200,y1307,20130409,7892,7874,7932,7932,7932,7932,7932,58,58,2,158640,12
201,y1307,20130410,7932,7932,0,0,0,7932,7932,0,0,0,0,12
202,y1307,20130411,7932,7932,0,0,0,7932,7932,0,0,0,0,12
203,y1307,20130412,7932,7932,7768,7838,7768,7788,7794,-144,-138,8,623640,12
204,y1307,20130415,7788,7794,0,0,0,7644,7644,-150,-150,0,0,12
205,y1307,20130416,7644,7644,7516,7538,7516,7538,7522,-106,-122,6,451400,12
206,y1307,20130417,7538,7522,7580,7606,7518,7574,7554,52,32,130,9820760,10
207,y1307,20130418,7574,7554,0,0,0,7554,7554,0,0,0,0,10
208,y1307,20130419,7554,7554,0,0,0,7552,7552,-2,-2,0,0,10
209,y1307,20130422,7552,7552,0,0,0,7502,7502,-50,-50,0,0,10
210,y1307,20130423,7502,7502,0,0,0,7472,7472,-30,-30,0,0,10
211,y1307,20130424,7472,7472,7472,7472,7288,7290,7344,-182,-128,34,2497440,26
212,y1307,20130425,7290,7344,7280,7280,7260,7274,7270,-70,-74,18,1308840,30
213,y1307,20130426,7274,7270,7290,7290,7240,7240,7258,-30,-12,8,580760,30
214,y1307,20130502,7240,7258,7100,7100,7068,7068,7084,-190,-174,4,283360,30
215,y1307,20130503,7068,7084,7086,7100,7084,7084,7086,0,2,14,992160,30
216,y1307,20130506,7084,7086,7112,7178,7100,7178,7128,92,42,20,1425960,32
217,y1307,20130507,7178,7128,7194,7276,7194,7248,7246,120,118,10,724720,30
218,y1307,20130508,7248,7246,7276,7278,7276,7278,7276,32,30,8,582160,26
219,y1307,20130509,7278,7276,0,0,0,7276,7276,0,0,0,0,26
220,y1307,20130510,7276,7276,0,0,0,7376,7376,100,100,0,0,26
221,y1307,20130513,7376,7376,0,0,0,7376,7376,0,0,0,0,26
222,y1307,20130514,7376,7376,7498,7498,7374,7374,7436,-2,60,4,297440,26
223,y1307,20130515,7374,7436,0,0,0,7288,7288,-148,-148,0,0,26
224,y1307,20130516,7288,7288,0,0,0,7288,7288,0,0,0,0,26
225,y1307,20130517,7288,7288,0,0,0,7288,7288,0,0,0,0,26
226,y1307,20130520,7288,7288,0,0,0,7288,7288,0,0,0,0,26
227,y1307,20130521,7288,7288,0,0,0,7288,7288,0,0,0,0,26
228,y1307,20130522,7288,7288,0,0,0,7288,7288,0,0,0,0,26
229,y1307,20130523,7288,7288,0,0,0,7288,7288,0,0,0,0,26
230,y1307,20130524,7288,7288,0,0,0,7324,7324,36,36,0,0,26
231,y1307,20130527,7324,7324,7314,7428,7314,7428,7370,104,46,4,294840,28
232,y1307,20130528,7428,7370,0,0,0,7370,7370,0,0,0,0,28
233,y1307,20130529,7370,7370,0,0,0,7370,7370,0,0,0,0,28
234,y1307,20130530,7370,7370,7292,7292,7292,7292,7292,-78,-78,2,145840,26
235,y1307,20130531,7292,7292,0,0,0,7292,7292,0,0,0,0,26
236,y1307,20130603,7292,7292,0,0,0,7292,7292,0,0,0,0,26
237,y1307,20130604,7292,7292,7174,7436,7174,7436,7304,144,12,4,292200,24
238,y1307,20130605,7436,7304,0,0,0,7304,7304,0,0,0,0,24
239,y1307,20130606,7304,7304,0,0,0,7304,7304,0,0,0,0,24
240,y1307,20130607,7304,7304,7408,7408,7252,7252,7330,-52,26,4,293200,24
241,y1307,20130613,7252,7330,0,0,0,7330,7330,0,0,0,0,24
242,y1307,20130614,7330,7330,0,0,0,7330,7330,0,0,0,0,24
243,y1307,20130617,7330,7330,0,0,0,7330,7330,0,0,0,0,24
244,y1307,20130618,7330,7330,0,0,0,7330,7330,0,0,0,0,24
245,y1307,20130619,7330,7330,7290,7290,7290,7290,7290,-40,-40,2,145800,22
246,y1307,20130620,7290,7290,0,0,0,7290,7290,0,0,0,0,22
247,y1307,20130621,7290,7290,0,0,0,7290,7290,0,0,0,0,22
248,y1307,20130624,7290,7290,0,0,0,7290,7290,0,0,0,0,22
249,y1307,20130625,7290,7290,0,0,0,7290,7290,0,0,0,0,22
250,y1307,20130626,7290,7290,0,0,0,7290,7290,0,0,0,0,22
251,y1307,20130627,7290,7290,0,0,0,7290,7290,0,0,0,0,22
252,y1307,20130628,7290,7290,7000,7580,7000,7580,7290,290,0,10,729000,18
253,y1307,20130701,7580,7290,0,0,0,7290,7290,0,0,0,0,18
254,y1307,20130702,7290,7290,0,0,0,7290,7290,0,0,0,0,18
255,y1307,20130703,7290,7290,0,0,0,7290,7290,0,0,0,0,18
256,y1307,20130704,7290,7290,7178,7178,7178,7178,7178,-112,-112,2,143560,16
257,y1307,20130705,7178,7178,6748,6750,6748,6750,6748,-428,-430,14,944960,2
258,y1307,20130708,6750,6748,0,0,0,6748,6748,0,0,0,0,2
259,y1307,20130709,6748,6748,0,0,0,6748,6748,0,0,0,0,2
260,y1307,20130710,6748,6748,0,0,0,6748,6748,0,0,0,0,2
261,y1307,20130711,6748,6748,0,0,0,6748,6748,0,0,0,0,2
262,y1307,20130712,6748,6748,0,0,0,6802,6802,54,54,0,0,0
263,y1308,20130104,8684,8688,8766,8766,8766,8766,8766,78,78,2,175320,16
264,y1308,20130107,8766,8766,8754,8770,8730,8770,8750,4,-16,6,525080,16
265,y1308,20130108,8770,8750,8796,8816,8762,8762,8780,12,30,24,2107480,24
266,y1308,20130109,8762,8780,0,0,0,8780,8780,0,0,0,0,24
267,y1308,20130110,8780,8780,8688,8688,8636,8636,8652,-144,-128,12,1038320,20
268,y1308,20130111,8636,8652,8598,8748,8506,8506,8534,-146,-118,24,2048480,32
269,y1308,20130114,8506,8534,8600,8612,8600,8612,8604,78,70,20,1720880,24
270,y1308,20130115,8612,8604,8694,8700,8694,8700,8696,96,92,4,347880,20
271,y1308,20130116,8700,8696,8696,8722,8680,8722,8702,26,6,26,2262640,18
272,y1308,20130117,8722,8702,8750,8750,8700,8708,8712,6,10,52,4531120,30
273,y1308,20130118,8708,8712,8798,8800,8798,8800,8798,88,86,4,351960,30
274,y1308,20130121,8800,8798,8844,8854,8784,8828,8830,30,32,18,1589600,30
275,y1308,20130122,8828,8830,8826,8850,8826,8830,8834,0,4,6,530120,32
276,y1308,20130123,8830,8834,8844,8950,8836,8836,8876,2,42,14,1242760,36
277,y1308,20130124,8836,8876,8790,8790,8722,8722,8746,-154,-130,34,2973760,30
278,y1308,20130125,8722,8746,8750,8750,8728,8728,8746,-18,0,12,1049560,30
279,y1308,20130128,8728,8746,8732,8732,8718,8718,8718,-28,-28,16,1395160,30
280,y1308,20130129,8718,8718,0,0,0,8718,8718,0,0,0,0,30
281,y1308,20130130,8718,8718,0,0,0,8718,8718,0,0,0,0,30
282,y1308,20130131,8718,8718,0,0,0,8718,8718,0,0,0,0,30
283,y1308,20130201,8718,8718,8836,8840,8836,8836,8836,118,118,10,883760,32
284,y1308,20130204,8836,8836,8910,8910,8878,8878,8902,42,66,8,712160,32
285,y1308,20130205,8878,8902,0,0,0,8902,8902,0,0,0,0,32
286,y1308,20130206,8902,8902,8858,8858,8838,8838,8848,-64,-54,4,353920,32
287,y1308,20130207,8838,8848,8762,8762,8762,8762,8762,-86,-86,2,175240,30
288,y1308,20130208,8762,8762,0,0,0,8762,8762,0,0,0,0,30
289,y1308,20130218,8762,8762,8680,8680,8680,8680,8680,-82,-82,6,520800,30
290,y1308,20130219,8680,8680,8702,8718,8702,8718,8710,38,30,4,348400,30
291,y1308,20130220,8718,8710,8776,8776,8776,8776,8776,66,66,2,175520,30
292,y1308,20130221,8776,8776,0,0,0,8776,8776,0,0,0,0,30
293,y1308,20130222,8776,8776,0,0,0,8776,8776,0,0,0,0,30
294,y1308,20130225,8776,8776,8604,8604,8470,8572,8566,-204,-210,18,1542120,30
295,y1308,20130226,8572,8566,8506,8506,8378,8388,8418,-178,-148,20,1683600,32
296,y1308,20130227,8388,8418,8362,8362,8362,8362,8362,-56,-56,4,334480,32
297,y1308,20130228,8362,8362,8428,8428,8278,8372,8326,10,-36,70,5828440,32
298,y1308,20130301,8372,8326,8308,8318,8308,8318,8312,-8,-14,4,332520,30
299,y1308,20130304,8318,8312,0,0,0,8312,8312,0,0,0,0,30
300,y1308,20130305,8312,8312,0,0,0,8312,8312,0,0,0,0,30
301,y1308,20130306,8312,8312,8442,8442,8390,8390,8410,78,98,24,2018800,30
302,y1308,20130307,8390,8410,8364,8364,8364,8364,8364,-46,-46,2,167280,28
303,y1308,20130308,8364,8364,8362,8362,8362,8362,8362,-2,-2,2,167240,26
304,y1308,20130311,8362,8362,8328,8328,8272,8272,8302,-90,-60,26,2158640,36
305,y1308,20130312,8272,8302,8222,8290,8222,8242,8238,-60,-64,18,1483080,24
306,y1308,20130313,8242,8238,8100,8124,8062,8062,8096,-176,-142,8,647760,24
307,y1308,20130314,8062,8096,8016,8054,8016,8054,8042,-42,-54,12,965120,22
308,y1308,20130315,8054,8042,8086,8160,8086,8160,8122,118,80,4,324920,22
309,y1308,20130318,8160,8122,0,0,0,8122,8122,0,0,0,0,22
310,y1308,20130319,8122,8122,8082,8158,8080,8158,8118,36,-4,20,1623800,22
311,y1308,20130320,8158,8118,0,0,0,8118,8118,0,0,0,0,22
312,y1308,20130321,8118,8118,0,0,0,8118,8118,0,0,0,0,22
313,y1308,20130322,8118,8118,8144,8168,8108,8108,8140,-10,22,8,651280,18
314,y1308,20130325,8108,8140,8138,8244,8110,8244,8156,104,16,14,1141960,20
315,y1308,20130326,8244,8156,8140,8140,8112,8112,8130,-44,-26,6,487840,20
316,y1308,20130327,8112,8130,0,0,0,8130,8130,0,0,0,0,20
317,y1308,20130328,8130,8130,8070,8070,8070,8070,8070,-60,-60,2,161400,18
318,y1308,20130329,8070,8070,7978,7978,7924,7924,7950,-146,-120,4,318040,18
319,y1308,20130401,7924,7950,7928,7928,7928,7928,7928,-22,-22,2,158560,18
320,y1308,20130402,7928,7928,0,0,0,7928,7928,0,0,0,0,18
321,y1308,20130403,7928,7928,0,0,0,7928,7928,0,0,0,0,18
322,y1308,20130408,7928,7928,7876,7876,7876,7876,7876,-52,-52,2,157520,18
323,y1308,20130409,7876,7876,0,0,0,7876,7876,0,0,0,0,18
324,y1308,20130410,7876,7876,0,0,0,7876,7876,0,0,0,0,18
325,y1308,20130411,7876,7876,0,0,0,7876,7876,0,0,0,0,18
326,y1308,20130412,7876,7876,7834,7898,7834,7898,7866,22,-10,4,314640,16
327,y1308,20130415,7898,7866,7784,7816,7784,7816,7800,-50,-66,4,312000,16
328,y1308,20130416,7816,7800,7566,7566,7566,7566,7566,-234,-234,2,151320,18
329,y1308,20130417,7566,7566,7684,7684,7684,7684,7684,118,118,2,153680,18
330,y1308,20130418,7684,7684,0,0,0,7606,7606,-78,-78,0,0,18
331,y1308,20130419,7606,7606,7644,7644,7644,7644,7644,38,38,2,152880,20
332,y1308,20130422,7644,7644,7582,7582,7576,7576,7580,-68,-64,6,454800,22
333,y1308,20130423,7576,7580,7366,7366,7366,7366,7366,-214,-214,2,147320,20
334,y1308,20130424,7366,7366,0,0,0,7366,7366,0,0,0,0,20
335,y1308,20130425,7366,7366,7486,7486,7288,7288,7378,-78,12,30,2213560,18
336,y1308,20130426,7288,7378,7378,7378,7244,7292,7300,-86,-78,50,3650600,18
337,y1308,20130502,7292,7300,7248,7248,7166,7166,7212,-134,-88,86,6202800,24
338,y1308,20130503,7166,7212,7220,7254,7182,7238,7222,26,10,18,1300240,26
339,y1308,20130506,7238,7222,7274,7330,7210,7270,7248,48,26,20,1449960,34
340,y1308,20130507,7270,7248,7322,7428,7240,7328,7352,80,104,46,3382160,34
341,y1308,20130508,7328,7352,0,0,0,7352,7352,0,0,0,0,34
342,y1308,20130509,7352,7352,0,0,0,7330,7330,-22,-22,0,0,34
343,y1308,20130510,7330,7330,7326,7456,7304,7456,7334,126,4,16,1173440,32
344,y1308,20130513,7456,7334,7440,7452,7366,7418,7410,84,76,14,1037640,30
345,y1308,20130514,7418,7410,7492,7492,7468,7468,7480,58,70,4,299200,32
346,y1308,20130515,7468,7480,7432,7432,7292,7322,7322,-158,-158,18,1318040,32
347,y1308,20130516,7322,7322,7290,7348,7290,7348,7320,26,-2,6,439280,32
348,y1308,20130517,7348,7320,0,0,0,7320,7320,0,0,0,0,32
349,y1308,20130520,7320,7320,7502,7502,7402,7402,7452,82,132,4,298080,32
350,y1308,20130521,7402,7452,0,0,0,7452,7452,0,0,0,0,32
351,y1308,20130522,7452,7452,7440,7466,7404,7466,7438,14,-14,10,743960,32
352,y1308,20130523,7466,7438,7418,7418,7392,7410,7408,-28,-30,40,2963720,36
353,y1308,20130524,7410,7408,7538,7556,7412,7486,7504,78,96,132,9905280,50
354,y1308,20130527,7486,7504,0,0,0,7456,7456,-48,-48,0,0,50
355,y1308,20130528,7456,7456,7456,7456,7406,7450,7440,-6,-16,8,595200,52
356,y1308,20130529,7450,7440,7440,7440,7440,7440,7440,0,0,4,297600,48
357,y1308,20130530,7440,7440,7460,7474,7388,7474,7438,34,-2,10,743840,54
358,y1308,20130531,7474,7438,7416,7416,7416,7416,7416,-22,-22,6,444960,52
359,y1308,20130603,7416,7416,7408,7456,7408,7456,7432,40,16,8,594560,52
360,y1308,20130604,7456,7432,7456,7466,7350,7396,7454,-36,22,114,8498280,152
361,y1308,20130605,7396,7454,0,0,0,7400,7400,-54,-54,0,0,152
362,y1308,20130606,7400,7400,7392,7392,7352,7358,7366,-42,-34,28,2062720,136
363,y1308,20130607,7358,7366,0,0,0,7366,7366,0,0,0,0,136
364,y1308,20130613,7366,7366,7382,7382,7382,7382,7382,16,16,4,295280,132
365,y1308,20130614,7382,7382,0,0,0,7382,7382,0,0,0,0,132
366,y1308,20130617,7382,7382,7368,7368,7368,7368,7368,-14,-14,2,147360,132
367,y1308,20130618,7368,7368,7372,7420,7372,7420,7410,52,42,114,8449160,124
368,y1308,20130619,7420,7410,0,0,0,7410,7410,0,0,0,0,124
369,y1308,20130620,7410,7410,7410,7468,7392,7408,7420,-2,10,44,3265360,118
370,y1308,20130621,7408,7420,7298,7298,7298,7298,7298,-122,-122,8,583840,124
371,y1308,20130624,7298,7298,7284,7284,7054,7236,7198,-62,-100,30,2159800,136
372,y1308,20130625,7236,7198,7260,7260,7064,7064,7222,-134,24,54,3900440,98
373,y1308,20130626,7064,7222,0,0,0,7222,7222,0,0,0,0,98
374,y1308,20130627,7222,7222,0,0,0,7222,7222,0,0,0,0,98
375,y1308,20130628,7222,7222,0,0,0,7222,7222,0,0,0,0,98
376,y1308,20130701,7222,7222,0,0,0,7222,7222,0,0,0,0,98
377,y1308,20130702,7222,7222,0,0,0,7222,7222,0,0,0,0,98
378,y1308,20130703,7222,7222,0,0,0,7222,7222,0,0,0,0,98
379,y1308,20130704,7222,7222,7176,7176,7176,7176,7176,-46,-46,2,143520,96
380,y1308,20130705,7176,7176,0,0,0,7176,7176,0,0,0,0,96
381,y1308,20130708,7176,7176,0,0,0,7176,7176,0,0,0,0,96
382,y1308,20130709,7176,7176,7122,7260,7050,7108,7120,-68,-56,24,1708920,80
383,y1308,20130710,7108,7120,0,0,0,7120,7120,0,0,0,0,80
384,y1308,20130711,7120,7120,0,0,0,7120,7120,0,0,0,0,80
385,y1308,20130712,7120,7120,0,0,0,7120,7120,0,0,0,0,80
386,y1308,20130715,7120,7120,7052,7052,7042,7042,7044,-78,-76,10,704400,70
387,y1308,20130716,7042,7044,0,0,0,7160,7160,116,116,0,0,70
388,y1308,20130717,7160,7160,0,0,0,7160,7160,0,0,0,0,70
389,y1308,20130718,7160,7160,0,0,0,7160,7160,0,0,0,0,70
390,y1308,20130719,7160,7160,6884,7238,6884,7238,7060,78,-100,4,282440,70
391,y1308,20130722,7238,7060,0,0,0,7060,7060,0,0,0,0,70
392,y1308,20130723,7060,7060,7158,7220,7158,7220,7198,160,138,10,719880,60
393,y1308,20130724,7220,7198,0,0,0,7198,7198,0,0,0,0,60
394,y1308,20130725,7198,7198,7000,7000,7000,7000,7000,-198,-198,18,1260000,44
395,y1308,20130726,7000,7000,7206,7206,6868,7004,7014,4,14,10,701560,46
396,y1308,20130729,7004,7014,7010,7010,6840,6848,6898,-166,-116,6,413960,40
397,y1308,20130730,6848,6898,0,0,0,6898,6898,0,0,0,0,40
398,y1308,20130731,6898,6898,6624,6680,6624,6680,6668,-218,-230,10,666880,40
399,y1308,20130801,6680,6668,0,0,0,6668,6668,0,0,0,0,14
400,y1308,20130802,6668,6668,6268,6268,6268,6268,6268,-400,-400,2,125360,0
401,y1308,20130805,6268,6268,0,0,0,6268,6268,0,0,0,0,0
402,y1308,20130806,6268,6268,0,0,0,6268,6268,0,0,0,0,0
403,y1308,20130807,6268,6268,0,0,0,6268,6268,0,0,0,0,0
404,y1308,20130808,6268,6268,0,0,0,6268,6268,0,0,0,0,0
405,y1308,20130809,6268,6268,0,0,0,6268,6268,0,0,0,0,0
406,y1308,20130812,6268,6268,0,0,0,6268,6268,0,0,0,0,0
407,y1308,20130813,6268,6268,0,0,0,6268,6268,0,0,0,0,0
408,y1308,20130814,6268,6268,0,0,0,6268,6268,0,0,0,0,0
409,y1309,20130104,8604,8658,8680,8812,8632,8782,8732,124,74,242602,21185193120,261180
410,y1309,20130107,8782,8732,8700,8776,8690,8724,8734,-8,2,309146,27001001760,290088
411,y1309,20130108,8724,8734,8750,8768,8654,8668,8702,-66,-32,416642,36260891880,372072
412,y1309,20130109,8668,8702,8630,8674,8606,8608,8636,-94,-66,273548,23624823280,369794
413,y1309,20130110,8608,8636,8638,8678,8554,8556,8626,-80,-10,289066,24937963800,391038
414,y1309,20130111,8556,8626,8586,8590,8470,8472,8536,-154,-90,340506,29068177640,393160
415,y1309,20130114,8472,8536,8530,8558,8504,8528,8534,-8,-2,323898,27646190000,390474
416,y1309,20130115,8528,8534,8628,8666,8596,8610,8634,76,100,353148,30496177720,360208
417,y1309,20130116,8610,8634,8650,8694,8630,8666,8664,32,30,337540,29250812640,365388
418,y1309,20130117,8666,8664,8704,8730,8664,8676,8700,12,36,368604,32073984640,350170
419,y1309,20130118,8676,8700,8706,8790,8650,8782,8728,82,28,490308,42803779480,383072
420,y1309,20130121,8782,8728,8788,8866,8782,8846,8828,118,100,491974,43436226200,403956
421,y1309,20130122,8846,8828,8870,8886,8820,8848,8850,20,22,410644,36346945360,412824
422,y1309,20130123,8848,8850,8876,8876,8814,8848,8842,-2,-8,331530,29319296200,419824
423,y1309,20130124,8848,8842,8810,8810,8672,8688,8726,-154,-116,503812,43968223000,423170
424,y1309,20130125,8688,8726,8746,8760,8716,8736,8738,10,12,362954,31718365440,430328
425,y1309,20130128,8736,8738,8762,8774,8682,8746,8724,8,-14,421764,36800486600,447090
426,y1309,20130129,8746,8724,8720,8734,8660,8684,8694,-40,-30,515556,44829965960,473152
427,y1309,20130130,8684,8694,8676,8748,8664,8734,8716,40,22,435582,37969149400,470062
428,y1309,20130131,8734,8716,8802,8838,8786,8820,8810,104,94,412996,36385854000,453078
429,y1309,20130201,8820,8810,8854,8858,8794,8852,8830,42,20,393036,34712119280,438126
430,y1309,20130204,8852,8830,8866,8932,8842,8896,8898,66,68,424220,37748918400,452062
431,y1309,20130205,8896,8898,8864,8884,8808,8822,8850,-76,-48,390744,34583245880,435994
432,y1309,20130206,8822,8850,8836,8858,8782,8810,8824,-40,-26,357202,31526587640,432556
433,y1309,20130207,8810,8824,8776,8806,8718,8764,8756,-60,-68,307848,26957368240,419784
434,y1309,20130208,8764,8756,8760,8788,8712,8714,8752,-42,-4,218624,19136320960,409774
435,y1309,20130218,8714,8752,8640,8678,8624,8646,8652,-106,-100,247702,21432763360,415070
436,y1309,20130219,8646,8652,8652,8724,8650,8710,8696,58,44,351732,30589094000,442114
437,y1309,20130220,8710,8696,8750,8770,8728,8754,8754,58,58,293204,25670453840,446920
438,y1309,20130221,8754,8754,8700,8700,8610,8630,8650,-124,-104,478316,41381029200,449564
439,y1309,20130222,8630,8650,8616,8766,8616,8702,8698,52,48,665132,57854436480,462140
440,y1309,20130225,8702,8698,8580,8580,8370,8422,8442,-276,-256,903508,76289917400,518478
441,y1309,20130226,8422,8442,8412,8448,8306,8312,8382,-130,-60,820498,68777602960,540154
442,y1309,20130227,8312,8382,8340,8344,8280,8324,8316,-58,-66,597700,49705870080,561352
443,y1309,20130228,8324,8316,8356,8368,8264,8288,8310,-28,-6,730114,60681175320,592954
444,y1309,20130301,8288,8310,8246,8284,8224,8252,8250,-58,-60,574276,47386904760,606338
445,y1309,20130304,8252,8250,8270,8346,8266,8326,8316,76,66,644718,53627633600,570938
446,y1309,20130305,8326,8316,8374,8390,8304,8322,8340,6,24,536938,44785546240,577614
447,y1309,20130306,8322,8340,8316,8364,8280,8346,8338,6,-2,539744,45008388200,544876
448,y1309,20130307,8346,8338,8330,8336,8246,8258,8284,-80,-54,621474,51484032720,590478
449,y1309,20130308,8258,8284,8312,8346,8294,8324,8322,40,38,473160,39377122200,564294
450,y1309,20130311,8324,8322,8312,8322,8194,8200,8248,-122,-74,860342,70973970480,731740
451,y1309,20130312,8200,8248,8220,8232,8146,8154,8190,-94,-58,747488,61228813120,678468
452,y1309,20130313,8154,8190,8140,8158,8012,8042,8062,-148,-128,989642,79795797880,706368
453,y1309,20130314,8042,8062,8040,8078,7976,8008,8022,-54,-40,835972,67075375960,698814
454,y1309,20130315,8008,8022,8030,8144,8010,8136,8080,114,58,908346,73401061520,641758
455,y1309,20130318,8136,8080,8072,8084,8006,8050,8048,-30,-32,599994,48294054960,629432
456,y1309,20130319,8050,8048,8100,8130,8082,8108,8106,60,58,530154,42976087680,618992
457,y1309,20130320,8108,8106,8080,8118,8052,8100,8084,-6,-22,498966,40345624080,635748
458,y1309,20130321,8100,8084,8146,8192,8126,8146,8160,62,76,533392,43534972040,639150
459,y1309,20130322,8146,8160,8164,8172,8080,8082,8112,-78,-48,584072,47384623720,667092
460,y1309,20130325,8082,8112,8120,8144,8084,8100,8110,-12,-2,444946,36091245240,662408
461,y1309,20130326,8100,8110,8096,8126,8066,8076,8090,-34,-20,516522,41793554880,642058
462,y1309,20130327,8076,8090,8102,8140,8070,8136,8102,46,12,488200,39557465920,660178
463,y1309,20130328,8136,8102,8138,8144,8020,8036,8070,-66,-32,633428,51129869520,667294
464,y1309,20130329,8036,8070,7922,7976,7822,7932,7918,-138,-152,685892,54316026040,631184
465,y1309,20130401,7932,7918,7920,7944,7808,7808,7860,-110,-58,542680,42665150120,660806
466,y1309,20130402,7808,7860,7840,7880,7810,7876,7846,16,-14,630634,49481594840,628206
467,y1309,20130403,7876,7846,7816,7914,7802,7858,7860,12,14,708660,55704959440,596962
468,y1309,20130408,7858,7860,7824,7926,7790,7918,7890,58,30,554164,43733715000,598280
469,y1309,20130409,7918,7890,7928,7982,7918,7930,7952,40,62,480824,38243679320,595484
470,y1309,20130410,7930,7952,7980,7994,7930,7972,7964,20,12,554200,44145026440,616736
471,y1309,20130411,7972,7964,7948,7976,7850,7850,7898,-114,-66,736408,58170709440,678884
472,y1309,20130412,7850,7898,7870,7878,7818,7842,7848,-56,-50,611780,48021613840,687896
473,y1309,20130415,7842,7848,7798,7798,7654,7678,7706,-170,-142,785948,60577463080,742770
474,y1309,20130416,7678,7706,7576,7664,7522,7660,7600,-46,-106,776838,59051865440,704784
475,y1309,20130417,7660,7600,7686,7726,7608,7644,7660,44,60,697386,53428178320,723438
476,y1309,20130418,7644,7660,7600,7642,7542,7584,7596,-76,-64,786110,59727295440,742818
477,y1309,20130419,7584,7596,7620,7666,7608,7620,7634,24,38,618424,47212875320,727686
478,y1309,20130422,7620,7634,7576,7578,7412,7416,7484,-218,-150,1026448,76827545920,784942
479,y1309,20130423,7416,7484,7406,7444,7376,7412,7412,-72,-72,873788,64772130160,766118
480,y1309,20130424,7412,7412,7378,7436,7310,7316,7360,-96,-52,1009684,74320309680,831808
481,y1309,20130425,7316,7360,7370,7386,7310,7314,7350,-46,-10,837772,61590282440,791030
482,y1309,20130426,7314,7350,7360,7374,7302,7306,7340,-44,-10,841628,61789040320,782972
483,y1309,20130502,7306,7340,7204,7250,7170,7184,7202,-156,-138,644308,46411901400,813800
484,y1309,20130503,7184,7202,7192,7272,7184,7270,7236,68,34,709028,51313397520,808980
485,y1309,20130506,7270,7236,7342,7380,7276,7374,7318,138,82,720208,52715857800,768630
486,y1309,20130507,7374,7318,7338,7432,7322,7362,7388,44,70,1259046,93025902440,772502
487,y1309,20130508,7362,7388,7384,7426,7350,7410,7396,22,8,904162,66885395280,758514
488,y1309,20130509,7410,7396,7398,7412,7356,7366,7374,-30,-22,719732,53080642720,785642
489,y1309,20130510,7366,7374,7404,7538,7376,7530,7456,156,82,1188546,88621866840,755554
490,y1309,20130513,7530,7456,7500,7546,7464,7482,7504,26,48,912344,68480228000,729614
491,y1309,20130514,7482,7504,7540,7572,7482,7494,7524,-10,20,838286,63086387960,703580
492,y1309,20130515,7494,7524,7498,7508,7320,7334,7406,-190,-118,1062826,78717359360,768554
493,y1309,20130516,7334,7406,7346,7454,7310,7410,7384,4,-22,1013730,74872213640,688378
494,y1309,20130517,7410,7384,7440,7508,7422,7488,7466,104,82,862098,64373641600,664584
495,y1309,20130520,7488,7466,7498,7524,7444,7480,7482,14,16,794380,59437514280,647598
496,y1309,20130521,7480,7482,7488,7490,7394,7442,7444,-40,-38,774942,57693723560,653524
497,y1309,20130522,7442,7444,7462,7568,7458,7536,7522,92,78,993418,74725560640,685006
498,y1309,20130523,7536,7522,7550,7582,7456,7464,7500,-58,-22,842904,63230158640,639314
499,y1309,20130524,7464,7500,7476,7574,7472,7530,7538,30,38,828388,62458734880,653548
500,y1309,20130527,7530,7538,7480,7522,7460,7516,7502,-22,-36,533384,40019153520,655946
501,y1309,20130528,7516,7502,7520,7552,7466,7498,7500,-4,-2,701996,52661736640,658432
502,y1309,20130529,7498,7500,7520,7620,7508,7540,7560,40,60,954998,72208492000,600320
503,y1309,20130530,7540,7560,7460,7498,7450,7484,7472,-76,-88,743690,55573785880,584202
504,y1309,20130531,7484,7472,7480,7530,7468,7480,7500,8,28,474020,35552770720,573306
505,y1309,20130603,7480,7500,7500,7560,7498,7522,7530,22,30,493640,37176853520,580326
506,y1309,20130604,7522,7530,7530,7540,7380,7414,7428,-116,-102,1004222,74599095880,653894
507,y1309,20130605,7414,7428,7428,7452,7386,7408,7412,-20,-16,647776,48021781600,623138
508,y1309,20130606,7408,7412,7376,7436,7346,7410,7402,-2,-10,581864,43072715240,571158
509,y1309,20130607,7410,7402,7410,7508,7356,7496,7438,94,36,788414,58655647080,518132
510,y1309,20130613,7496,7438,7450,7486,7414,7422,7444,-16,6,358720,26703710640,503658
511,y1309,20130614,7422,7444,7404,7418,7350,7408,7380,-36,-64,393866,29072878880,487672
512,y1309,20130617,7408,7380,7360,7458,7360,7446,7422,66,42,244142,18124941120,467584
513,y1309,20130618,7446,7422,7470,7544,7470,7486,7504,64,82,211504,15871284600,465636
514,y1309,20130619,7486,7504,7470,7484,7446,7474,7466,-30,-38,128204,9573878160,457898
515,y1309,20130620,7474,7466,7530,7538,7462,7488,7502,22,36,224728,16862599480,427494
516,y1309,20130621,7488,7502,7400,7430,7312,7334,7374,-168,-128,272388,20087675640,393492
517,y1309,20130624,7334,7374,7308,7328,7220,7238,7278,-136,-96,203578,14817581320,358438
518,y1309,20130625,7238,7278,7260,7296,7216,7284,7252,6,-26,163928,11889001920,350910
519,y1309,20130626,7284,7252,7270,7276,7144,7186,7200,-66,-52,174110,12538613280,350582
520,y1309,20130627,7186,7200,7152,7180,7106,7150,7140,-50,-60,124768,8909061400,330564
521,y1309,20130628,7150,7140,7120,7190,7112,7152,7164,12,24,97838,7009272080,318796
522,y1309,20130701,7152,7164,7130,7246,7122,7218,7200,54,36,92646,6671289800,306808
523,y1309,20130702,7218,7200,7230,7262,7170,7196,7216,-4,16,80920,5840211920,301658
524,y1309,20130703,7196,7216,7200,7220,7168,7176,7188,-40,-28,52832,3798342120,297136
525,y1309,20130704,7176,7188,7188,7224,7182,7194,7206,6,18,47392,3415318000,291576
526,y1309,20130705,7194,7206,7190,7204,7144,7176,7164,-30,-42,42634,3055086440,291554
527,y1309,20130708,7176,7164,7192,7218,7098,7128,7144,-36,-20,66904,4780091880,288010
528,y1309,20130709,7128,7144,7162,7170,7132,7154,7154,10,10,43744,3129793800,275140
529,y1309,20130710,7154,7154,7160,7200,7126,7174,7160,20,6,44972,3220194040,271536
530,y1309,20130711,7174,7160,7196,7270,7178,7230,7222,70,62,54100,3908041240,258272
531,y1309,20130712,7230,7222,7202,7208,7160,7168,7174,-54,-48,39860,2860130840,256302
532,y1309,20130715,7168,7174,7128,7160,7070,7070,7102,-104,-72,50024,3552896240,250748
533,y1309,20130716,7070,7102,7100,7116,7054,7096,7086,-6,-16,32894,2331434200,245816
534,y1309,20130717,7096,7086,7104,7202,7090,7146,7150,60,64,66900,4783976720,225170
535,y1309,20130718,7146,7150,7122,7172,7098,7162,7136,12,-14,35832,2557135480,217268
536,y1309,20130719,7162,7136,7156,7170,7112,7122,7140,-14,4,18724,1337167600,212728
537,y1309,20130722,7122,7140,7130,7172,7092,7148,7146,8,6,29898,2136669480,199676
538,y1309,20130723,7148,7146,7154,7190,7136,7180,7160,34,14,45422,3252218680,183308
539,y1309,20130724,7180,7160,7140,7140,7090,7116,7116,-44,-44,24744,1760875160,172236
540,y1309,20130725,7116,7116,7078,7080,7026,7038,7042,-78,-74,24104,1697667560,161720
541,y1309,20130726,7038,7042,7008,7016,6874,6898,6936,-144,-106,44054,3055928040,138730
542,y1309,20130729,6898,6936,6920,6924,6866,6870,6888,-66,-48,14526,1000808520,132676
543,y1309,20130730,6870,6888,6822,6862,6788,6848,6816,-40,-72,30814,2100627680,121336
544,y1309,20130731,6848,6816,6800,6922,6760,6878,6874,62,58,28696,1972909440,112750
545,y1309,20130801,6878,6874,6862,6906,6852,6866,6874,-8,0,10622,730266000,107358
546,y1309,20130802,6866,6874,6874,6920,6860,6896,6888,22,14,14576,1004240680,101880
547,y1309,20130805,6896,6888,6872,6896,6844,6862,6868,-26,-20,7740,531672120,97614
548,y1309,20130806,6862,6868,6896,6902,6858,6868,6874,0,6,8074,555158360,92230
549,y1309,20130807,6868,6874,6852,6852,6768,6770,6806,-104,-68,9400,639919720,86942
550,y1309,20130808,6770,6806,6788,6810,6768,6774,6792,-32,-14,8466,575113520,80858
551,y1309,20130809,6774,6792,6776,6850,6776,6806,6824,14,32,10636,726007960,75492
552,y1309,20130812,6806,6824,6898,6898,6782,6854,6822,30,-2,15738,1073917200,68064
553,y1309,20130813,6854,6822,6862,7012,6862,7006,6982,184,160,34724,2425079280,50276
554,y1309,20130814,7006,6982,6982,7002,6930,6934,6972,-48,-10,11032,769260320,43016
555,y1309,20130815,6934,6972,6952,6974,6940,6958,6964,-14,-8,9442,657561480,36724
556,y1309,20130816,6958,6964,7006,7098,7006,7012,7054,48,90,7234,510374040,33146
557,y1309,20130819,7012,7054,7054,7086,7038,7056,7060,2,6,4764,336425320,30124
558,y1309,20130820,7056,7060,7096,7098,6984,7008,7032,-52,-28,5124,360347760,26754
559,y1309,20130821,7008,7032,6984,7032,6984,7022,7018,-10,-14,3890,273073480,24200
560,y1309,20130822,7022,7018,7010,7038,6982,7038,7016,20,-2,4806,337222360,20356
561,y1309,20130823,7038,7016,7016,7022,6992,7018,7008,2,-8,846,59290680,19728
562,y1309,20130826,7018,7008,7072,7288,7072,7288,7210,280,202,4330,312217600,17494
563,y1309,20130827,7288,7210,7332,7356,7180,7248,7222,38,12,5358,386956400,13836
564,y1309,20130828,7248,7222,7202,7254,7156,7162,7216,-60,-6,2690,194111280,12222
565,y1309,20130829,7162,7216,7210,7210,7024,7044,7118,-172,-98,3318,236232360,10064
566,y1309,20130830,7044,7118,6976,7028,6912,6940,6974,-178,-144,4230,295036160,7946
567,y1309,20130902,6940,6974,6884,7088,6884,7088,7002,114,28,544,38095240,6728
568,y1309,20130903,7088,7002,7178,7180,7050,7050,7052,48,50,416,29338920,6324
569,y1309,20130904,7050,7052,6910,7030,6910,6980,7016,-72,-36,216,15157920,6040
570,y1309,20130905,6980,7016,6994,6994,6994,6994,6994,-22,-22,2000,139880000,3716
571,y1309,20130906,6994,6994,7038,7132,7038,7132,7126,138,132,216,15396000,3506
572,y1309,20130909,7132,7126,7136,7138,7100,7138,7128,12,2,8,570240,3502
573,y1309,20130910,7138,7128,6904,6990,6904,6988,6982,-140,-146,140,9775440,3378
574,y1309,20130911,6988,6982,6982,6982,6982,6982,6982,0,0,8,558560,3374
575,y1309,20130912,6982,6982,7390,7390,6980,6980,7252,-2,270,12,870400,3064
576,y1309,20130913,6980,7252,7300,7300,7300,7300,7012,48,-240,8,584000,0
577,y1311,20130104,8684,8684,8834,8834,8834,8834,8834,150,150,2,176680,6
578,y1311,20130107,8834,8834,8736,8736,8736,8736,8736,-98,-98,6,524160,10
579,y1311,20130108,8736,8736,0,0,0,8736,8736,0,0,0,0,10
580,y1311,20130109,8736,8736,0,0,0,8736,8736,0,0,0,0,10
581,y1311,20130110,8736,8736,0,0,0,8736,8736,0,0,0,0,10
582,y1311,20130111,8736,8736,0,0,0,8736,8736,0,0,0,0,10
583,y1311,20130114,8736,8736,0,0,0,8736,8736,0,0,0,0,10
584,y1311,20130115,8736,8736,0,0,0,8736,8736,0,0,0,0,10
585,y1311,20130116,8736,8736,0,0,0,8736,8736,0,0,0,0,10
586,y1311,20130117,8736,8736,0,0,0,8736,8736,0,0,0,0,10
587,y1311,20130118,8736,8736,0,0,0,8736,8736,0,0,0,0,10
588,y1311,20130121,8736,8736,8918,8918,8900,8900,8908,164,172,4,356360,12
589,y1311,20130122,8900,8908,0,0,0,8908,8908,0,0,0,0,12
590,y1311,20130123,8908,8908,0,0,0,8908,8908,0,0,0,0,12
591,y1311,20130124,8908,8908,8584,8584,8584,8584,8584,-324,-324,2,171680,12
592,y1311,20130125,8584,8584,8754,8754,8754,8754,8754,170,170,2,175080,10
593,y1311,20130128,8754,8754,8764,8764,8764,8764,8764,10,10,2,175280,8
594,y1311,20130129,8764,8764,0,0,0,8764,8764,0,0,0,0,8
595,y1311,20130130,8764,8764,0,0,0,8764,8764,0,0,0,0,8
596,y1311,20130131,8764,8764,0,0,0,8764,8764,0,0,0,0,8
597,y1311,20130201,8764,8764,0,0,0,8764,8764,0,0,0,0,8
598,y1311,20130204,8764,8764,8922,8940,8912,8912,8924,148,160,6,535480,6
599,y1311,20130205,8912,8924,0,0,0,8924,8924,0,0,0,0,6
600,y1311,20130206,8924,8924,0,0,0,8924,8924,0,0,0,0,6
601,y1311,20130207,8924,8924,0,0,0,8924,8924,0,0,0,0,6
602,y1311,20130208,8924,8924,0,0,0,8924,8924,0,0,0,0,6
603,y1311,20130218,8924,8924,8588,8688,8588,8688,8650,-236,-274,12,1038080,8
604,y1311,20130219,8688,8650,0,0,0,8650,8650,0,0,0,0,8
605,y1311,20130220,8650,8650,0,0,0,8650,8650,0,0,0,0,8
606,y1311,20130221,8650,8650,0,0,0,8650,8650,0,0,0,0,8
607,y1311,20130222,8650,8650,0,0,0,8650,8650,0,0,0,0,8
608,y1311,20130225,8650,8650,0,0,0,8650,8650,0,0,0,0,8
609,y1311,20130226,8650,8650,0,0,0,8650,8650,0,0,0,0,8
610,y1311,20130227,8650,8650,0,0,0,8650,8650,0,0,0,0,8
611,y1311,20130228,8650,8650,8318,8356,8318,8318,8330,-332,-320,6,499840,6
612,y1311,20130301,8318,8330,8318,8318,8318,8318,8318,-12,-12,2,166360,8
613,y1311,20130304,8318,8318,8322,8368,8294,8346,8314,28,-4,50,4157120,30
614,y1311,20130305,8346,8314,8376,8380,8366,8380,8378,66,64,36,3016360,10
615,y1311,20130306,8380,8378,8356,8374,8356,8374,8362,-4,-16,10,836280,8
616,y1311,20130307,8374,8362,8332,8340,8332,8338,8336,-24,-26,6,500200,8
617,y1311,20130308,8338,8336,0,0,0,8336,8336,0,0,0,0,8
618,y1311,20130311,8336,8336,8314,8344,8314,8344,8328,8,-8,4,333160,8
619,y1311,20130312,8344,8328,0,0,0,8328,8328,0,0,0,0,8
620,y1311,20130313,8328,8328,8080,8198,8080,8132,8110,-196,-218,24,1946600,14
621,y1311,20130314,8132,8110,8066,8114,8022,8054,8050,-56,-60,246,19805080,46
622,y1311,20130315,8054,8050,8090,8100,8090,8100,8092,50,42,38,3075000,16
623,y1311,20130318,8100,8092,8134,8134,8044,8050,8050,-42,-42,128,10304520,124
624,y1311,20130319,8050,8050,8064,8072,8064,8072,8068,22,18,4,322720,124
625,y1311,20130320,8072,8068,8080,8184,8066,8100,8094,32,26,1240,100375880,284
626,y1311,20130321,8100,8094,8168,8230,8164,8182,8192,88,98,58,4752000,278
627,y1311,20130322,8182,8192,8176,8176,8134,8134,8152,-58,-40,62,5055320,234
628,y1311,20130325,8134,8152,8112,8158,8112,8128,8138,-24,-14,14,1139320,238
629,y1311,20130326,8128,8138,8110,8186,8068,8120,8166,-18,28,160,13067000,122
630,y1311,20130327,8120,8166,8122,8122,8120,8120,8120,-46,-46,32,2598600,94
631,y1311,20130328,8120,8120,8100,8100,8058,8058,8070,-62,-50,32,2583000,92
632,y1311,20130329,8058,8070,7976,7980,7906,7964,7966,-106,-104,340,27087240,56
633,y1311,20130401,7964,7966,7868,7898,7838,7898,7862,-68,-104,12,943560,54
634,y1311,20130402,7898,7862,7886,7976,7886,7976,7908,114,46,14,1107240,60
635,y1311,20130403,7976,7908,0,0,0,7908,7908,0,0,0,0,60
636,y1311,20130408,7908,7908,8026,8026,7950,7950,7984,42,76,12,958280,58
637,y1311,20130409,7950,7984,8050,8050,7996,7996,8022,12,38,4,320920,56
638,y1311,20130410,7996,8022,8002,8092,8000,8034,8026,12,4,10,802600,52
639,y1311,20130411,8034,8026,0,0,0,8026,8026,0,0,0,0,52
640,y1311,20130412,8026,8026,0,0,0,8026,8026,0,0,0,0,52
641,y1311,20130415,8026,8026,7712,7712,7712,7712,7712,-314,-314,2,154240,54
642,y1311,20130416,7712,7712,7678,7724,7614,7704,7668,-8,-44,26,1994040,52
643,y1311,20130417,7704,7668,7732,7732,7732,7732,7732,64,64,2,154640,52
644,y1311,20130418,7732,7732,7628,7720,7628,7636,7654,-96,-78,8,612320,54
645,y1311,20130419,7636,7654,7702,7746,7672,7746,7724,92,70,36,2781160,56
646,y1311,20130422,7746,7724,7574,7606,7484,7484,7550,-240,-174,8,604120,58
647,y1311,20130423,7484,7550,7492,7508,7306,7476,7442,-74,-108,14,1041960,54
648,y1311,20130424,7476,7442,7586,7594,7414,7490,7490,48,48,64,4794360,54
649,y1311,20130425,7490,7490,0,0,0,7490,7490,0,0,0,0,54
650,y1311,20130426,7490,7490,7548,7548,7496,7496,7522,6,32,20,1504400,54
651,y1311,20130502,7496,7522,7348,7396,7302,7304,7328,-218,-194,70,5130320,68
652,y1311,20130503,7304,7328,7300,7398,7300,7342,7350,14,22,12,882040,64
653,y1311,20130506,7342,7350,7450,7462,7424,7462,7440,112,90,8,595280,66
654,y1311,20130507,7462,7440,7470,7538,7470,7538,7516,98,76,14,1052360,70
655,y1311,20130508,7538,7516,7558,7558,7558,7558,7558,42,42,2,151160,70
656,y1311,20130509,7558,7558,7528,7530,7528,7530,7528,-28,-30,8,602360,72
657,y1311,20130510,7530,7528,7524,7524,7524,7524,7524,-4,-4,2,150480,70
658,y1311,20130513,7524,7524,7648,7698,7604,7624,7662,100,138,72,5516920,90
659,y1311,20130514,7624,7662,7676,7676,7620,7644,7648,-18,-14,34,2600920,90
660,y1311,20130515,7644,7648,7538,7538,7412,7516,7490,-132,-158,60,4494880,98
661,y1311,20130516,7516,7490,7496,7496,7468,7468,7482,-22,-8,8,598600,98
662,y1311,20130517,7468,7482,7572,7638,7572,7638,7606,156,124,46,3499400,98
663,y1311,20130520,7638,7606,7616,7616,7616,7616,7616,10,10,6,456960,92
664,y1311,20130521,7616,7616,7624,7644,7540,7540,7590,-76,-26,46,3492080,92
665,y1311,20130522,7540,7590,7634,7710,7634,7690,7680,100,90,52,3993840,104
666,y1311,20130523,7690,7680,7668,7668,7668,7668,7668,-12,-12,2,153360,104
667,y1311,20130524,7668,7668,0,0,0,7668,7668,0,0,0,0,104
668,y1311,20130527,7668,7668,0,0,0,7668,7668,0,0,0,0,104
669,y1311,20130528,7668,7668,0,0,0,7668,7668,0,0,0,0,104
670,y1311,20130529,7668,7668,7652,7750,7652,7696,7704,28,36,18,1387040,116
671,y1311,20130530,7696,7704,7612,7612,7612,7612,7612,-92,-92,2,152240,116
672,y1311,20130531,7612,7612,0,0,0,7612,7612,0,0,0,0,116
673,y1311,20130603,7612,7612,0,0,0,7612,7612,0,0,0,0,116
674,y1311,20130604,7612,7612,7472,7564,7436,7532,7504,-80,-108,38,2851560,104
675,y1311,20130605,7532,7504,7662,7662,7542,7560,7586,56,82,10,758680,104
676,y1311,20130606,7560,7586,7552,7552,7552,7552,7552,-34,-34,2,151040,104
677,y1311,20130607,7552,7552,7552,7552,7552,7552,7552,0,0,4,302080,104
678,y1311,20130613,7552,7552,0,0,0,7552,7552,0,0,0,0,104
679,y1311,20130614,7552,7552,7500,7510,7500,7502,7502,-50,-50,12,900240,104
680,y1311,20130617,7502,7502,7530,7576,7530,7572,7566,70,64,32,2421280,114
681,y1311,20130618,7572,7566,0,0,0,7600,7600,34,34,0,0,114
682,y1311,20130619,7600,7600,0,0,0,7600,7600,0,0,0,0,114
683,y1311,20130620,7600,7600,7600,7632,7572,7576,7596,-24,-4,64,4862000,90
684,y1311,20130621,7576,7596,7518,7580,7422,7448,7502,-148,-94,94,7052760,110
685,y1311,20130624,7448,7502,7430,7430,7256,7330,7344,-172,-158,64,4700480,78
686,y1311,20130625,7330,7344,7284,7320,7284,7320,7312,-24,-32,12,877600,70
687,y1311,20130626,7320,7312,0,0,0,7260,7260,-52,-52,0,0,70
688,y1311,20130627,7260,7260,7240,7240,7222,7222,7230,-38,-30,4,289240,68
689,y1311,20130628,7222,7230,0,0,0,7230,7230,0,0,0,0,68
690,y1311,20130701,7230,7230,7198,7300,7198,7298,7268,68,38,8,581440,66
691,y1311,20130702,7298,7268,7284,7352,7220,7292,7262,24,-6,30,2178880,66
692,y1311,20130703,7292,7262,7252,7274,7252,7274,7262,12,0,4,290520,64
693,y1311,20130704,7274,7262,0,0,0,7262,7262,0,0,0,0,64
694,y1311,20130705,7262,7262,0,0,0,7262,7262,0,0,0,0,64
695,y1311,20130708,7262,7262,0,0,0,7262,7262,0,0,0,0,64
696,y1311,20130709,7262,7262,7250,7278,7250,7278,7274,16,12,20,1455040,62
697,y1311,20130710,7278,7274,0,0,0,7274,7274,0,0,0,0,62
698,y1311,20130711,7274,7274,7284,7380,7284,7318,7326,44,52,6,439640,60
699,y1311,20130712,7318,7326,0,0,0,7314,7314,-12,-12,0,0,60
700,y1311,20130715,7314,7314,7094,7242,7094,7242,7190,-72,-124,8,575200,60
701,y1311,20130716,7242,7190,7182,7182,7182,7182,7182,-8,-8,6,430920,60
702,y1311,20130717,7182,7182,7188,7260,7188,7260,7210,78,28,16,1153760,60
703,y1311,20130718,7260,7210,0,0,0,7210,7210,0,0,0,0,60
704,y1311,20130719,7210,7210,0,0,0,7210,7210,0,0,0,0,60
705,y1311,20130722,7210,7210,7270,7270,7206,7206,7238,-4,28,12,868560,60
706,y1311,20130723,7206,7238,7280,7284,7280,7284,7282,46,44,4,291280,60
707,y1311,20130724,7284,7282,0,0,0,7270,7270,-12,-12,0,0,60
708,y1311,20130725,7270,7270,7198,7198,7166,7166,7186,-104,-84,24,1724880,60
709,y1311,20130726,7166,7186,6968,7064,6968,7004,7000,-182,-186,70,4900240,70
710,y1311,20130729,7004,7000,7036,7036,6988,6988,7008,-12,8,44,3083560,62
711,y1311,20130730,6988,7008,7000,7000,6962,6962,6996,-46,-12,24,1679240,60
712,y1311,20130731,6962,6996,7028,7044,7014,7014,7028,18,32,24,1687000,66
713,y1311,20130801,7014,7028,0,0,0,7028,7028,0,0,0,0,66
714,y1311,20130802,7028,7028,7020,7020,7020,7020,7020,-8,-8,2,140400,68
715,y1311,20130805,7020,7020,0,0,0,7020,7020,0,0,0,0,68
716,y1311,20130806,7020,7020,0,0,0,7020,7020,0,0,0,0,68
717,y1311,20130807,7020,7020,6848,6896,6848,6896,6856,-124,-164,48,3290880,58
718,y1311,20130808,6896,6856,6882,6890,6878,6884,6884,28,28,12,826160,46
719,y1311,20130809,6884,6884,6910,6910,6906,6906,6908,22,24,8,552640,38
720,y1311,20130812,6906,6908,6944,6972,6870,6870,6928,-38,20,24,1663080,38
721,y1311,20130813,6870,6928,6998,7126,6998,7078,7058,150,130,24,1694200,28
722,y1311,20130814,7078,7058,0,0,0,7058,7058,0,0,0,0,28
723,y1311,20130815,7058,7058,7050,7050,7050,7050,7050,-8,-8,2,141000,26
724,y1311,20130816,7050,7050,0,0,0,7140,7140,90,90,0,0,26
725,y1311,20130819,7140,7140,0,0,0,7140,7140,0,0,0,0,26
726,y1311,20130820,7140,7140,7178,7178,7100,7100,7118,-40,-22,8,569560,28
727,y1311,20130821,7100,7118,0,0,0,7104,7104,-14,-14,0,0,28
728,y1311,20130822,7104,7104,0,0,0,7102,7102,-2,-2,0,0,28
729,y1311,20130823,7102,7102,0,0,0,7102,7102,0,0,0,0,28
730,y1311,20130826,7102,7102,7300,7300,7300,7300,7300,198,198,4,292000,26
731,y1311,20130827,7300,7300,7320,7320,7320,7320,7320,20,20,2,146400,24
732,y1311,20130828,7320,7320,7358,7360,7358,7360,7358,40,38,6,441520,26
733,y1311,20130829,7360,7358,0,0,0,7260,7260,-98,-98,0,0,26
734,y1311,20130830,7260,7260,7094,7184,7094,7184,7124,-76,-136,6,427440,26
735,y1311,20130902,7184,7124,7216,7250,7132,7230,7222,106,98,74,5344880,62
736,y1311,20130903,7230,7222,7286,7286,7208,7208,7248,-14,26,28,2029800,62
737,y1311,20130904,7208,7248,0,0,0,7248,7248,0,0,0,0,62
738,y1311,20130905,7248,7248,0,0,0,7248,7248,0,0,0,0,62
739,y1311,20130906,7248,7248,7114,7114,7114,7114,7114,-134,-134,10,711400,54
740,y1311,20130909,7114,7114,0,0,0,7218,7218,104,104,0,0,54
741,y1311,20130910,7218,7218,7154,7166,7154,7166,7160,-52,-58,4,286400,52
742,y1311,20130911,7166,7160,0,0,0,7160,7160,0,0,0,0,52
743,y1311,20130912,7160,7160,0,0,0,7436,7436,276,276,0,0,52
744,y1311,20130913,7436,7436,0,0,0,7190,7190,-246,-246,0,0,52
745,y1311,20130916,7190,7190,0,0,0,7190,7190,0,0,0,0,52
746,y1311,20130917,7190,7190,7158,7158,6998,7104,7086,-86,-104,12,850400,52
747,y1311,20130918,7104,7086,0,0,0,7086,7086,0,0,0,0,52
748,y1311,20130923,7086,7086,6918,7086,6916,7086,7018,0,-68,26,1825080,56
749,y1311,20130924,7086,7018,7138,7138,7010,7050,7066,32,48,28,1978800,54
750,y1311,20130925,7050,7066,0,0,0,7066,7066,0,0,0,0,54
751,y1311,20130926,7066,7066,0,0,0,7066,7066,0,0,0,0,54
752,y1311,20130927,7066,7066,0,0,0,7066,7066,0,0,0,0,54
753,y1311,20130930,7066,7066,6882,6882,6882,6882,6882,-184,-184,6,412920,52
754,y1311,20131008,6882,6882,0,0,0,6918,6918,36,36,0,0,52
755,y1311,20131009,6918,6918,0,0,0,6990,6990,72,72,0,0,52
756,y1311,20131010,6990,6990,0,0,0,7000,7000,10,10,0,0,52
757,y1311,20131011,7000,7000,7050,7050,7050,7050,7050,50,50,2,141000,50
758,y1311,20131014,7050,7050,0,0,0,7050,7050,0,0,0,0,50
759,y1311,20131015,7050,7050,0,0,0,7050,7050,0,0,0,0,50
760,y1311,20131016,7050,7050,0,0,0,7050,7050,0,0,0,0,50
761,y1311,20131017,7050,7050,7108,7140,7108,7110,7116,60,66,8,569360,42
762,y1311,20131018,7110,7116,0,0,0,7116,7116,0,0,0,0,42
763,y1311,20131021,7116,7116,7134,7134,7134,7134,7134,18,18,2,142680,40
764,y1311,20131022,7134,7134,7418,7418,7136,7136,7322,2,188,6,439400,38
765,y1311,20131023,7136,7322,7298,7298,7080,7170,7138,-152,-184,24,1713520,34
766,y1311,20131024,7170,7138,7186,7186,7100,7100,7152,-38,14,18,1287400,32
767,y1311,20131025,7100,7152,7042,7048,7040,7040,7042,-112,-110,20,1408480,24
768,y1311,20131028,7040,7042,7008,7008,6850,6850,6904,-192,-138,12,828640,20
769,y1311,20131029,6850,6904,6970,6970,6700,6700,6764,-204,-140,14,947200,16
770,y1311,20131030,6700,6764,6764,6790,6650,6650,6718,-114,-46,14,940760,10
771,y1311,20131031,6650,6718,6450,6750,6450,6526,6626,-192,-92,18,1192920,10
772,y1311,20131101,6526,6626,0,0,0,6626,6626,0,0,0,0,10
773,y1311,20131104,6626,6626,0,0,0,6626,6626,0,0,0,0,10
774,y1311,20131105,6626,6626,0,0,0,6626,6626,0,0,0,0,10
775,y1311,20131106,6626,6626,0,0,0,6626,6626,0,0,0,0,10
776,y1311,20131107,6626,6626,0,0,0,6626,6626,0,0,0,0,10
777,y1311,20131108,6626,6626,0,0,0,6626,6626,0,0,0,0,10
778,y1311,20131111,6626,6626,0,0,0,6626,6626,0,0,0,0,10
779,y1311,20131112,6626,6626,0,0,0,6626,6626,0,0,0,0,10
780,y1311,20131113,6626,6626,0,0,0,6626,6626,0,0,0,0,10
781,y1311,20131114,6626,6626,0,0,0,6626,6626,0,0,0,0,0
782,y1312,20130104,8650,8650,8720,8750,8720,8750,8748,100,98,44,3849400,44
783,y1312,20130107,8750,8748,8722,8750,8722,8750,8736,2,-12,4,349440,44
784,y1312,20130108,8750,8736,0,0,0,8736,8736,0,0,0,0,44
785,y1312,20130109,8736,8736,0,0,0,8736,8736,0,0,0,0,44
786,y1312,20130110,8736,8736,8620,8620,8600,8600,8610,-136,-126,4,344400,46
787,y1312,20130111,8600,8610,0,0,0,8610,8610,0,0,0,0,46
788,y1312,20130114,8610,8610,8600,8600,8580,8580,8590,-30,-20,4,343600,46
789,y1312,20130115,8580,8590,8640,8640,8640,8640,8640,50,50,2,172800,48
790,y1312,20130116,8640,8640,0,0,0,8640,8640,0,0,0,0,48
791,y1312,20130117,8640,8640,0,0,0,8640,8640,0,0,0,0,48
792,y1312,20130118,8640,8640,0,0,0,8640,8640,0,0,0,0,48
793,y1312,20130121,8640,8640,0,0,0,8640,8640,0,0,0,0,48
794,y1312,20130122,8640,8640,8826,8946,8826,8946,8886,306,246,4,355440,48
795,y1312,20130123,8946,8886,8828,8944,8828,8856,8880,-30,-6,26,2308880,46
796,y1312,20130124,8856,8880,8744,8744,8744,8744,8744,-136,-136,2,174880,44
797,y1312,20130125,8744,8744,0,0,0,8744,8744,0,0,0,0,44
798,y1312,20130128,8744,8744,0,0,0,8744,8744,0,0,0,0,44
799,y1312,20130129,8744,8744,8702,8702,8702,8702,8702,-42,-42,2,174040,46
800,y1312,20130130,8702,8702,8736,8736,8736,8736,8736,34,34,2,174720,44
801,y1312,20130131,8736,8736,8838,8856,8810,8838,8830,102,94,46,4062320,58
802,y1312,20130201,8838,8830,8846,8882,8788,8882,8842,52,12,16,1414920,44
803,y1312,20130204,8882,8842,8992,8992,8932,8932,8956,90,114,10,895600,44
804,y1312,20130205,8932,8956,8832,8832,8832,8832,8832,-124,-124,2,176640,44
805,y1312,20130206,8832,8832,0,0,0,8832,8832,0,0,0,0,44
806,y1312,20130207,8832,8832,8752,8752,8752,8752,8752,-80,-80,2,175040,44
807,y1312,20130208,8752,8752,8742,8742,8742,8742,8742,-10,-10,2,174840,44
808,y1312,20130218,8742,8742,8620,8650,8620,8650,8630,-92,-112,6,517800,44
809,y1312,20130219,8650,8630,0,0,0,8630,8630,0,0,0,0,44
810,y1312,20130220,8630,8630,0,0,0,8630,8630,0,0,0,0,44
811,y1312,20130221,8630,8630,0,0,0,8630,8630,0,0,0,0,44
812,y1312,20130222,8630,8630,8722,8722,8722,8722,8722,92,92,2,174440,44
813,y1312,20130225,8722,8722,8448,8484,8440,8450,8448,-272,-274,28,2365880,34
814,y1312,20130226,8450,8448,0,0,0,8448,8448,0,0,0,0,34
815,y1312,20130227,8448,8448,0,0,0,8448,8448,0,0,0,0,34
816,y1312,20130228,8448,8448,0,0,0,8448,8448,0,0,0,0,34
817,y1312,20130301,8448,8448,0,0,0,8448,8448,0,0,0,0,34
818,y1312,20130304,8448,8448,0,0,0,8448,8448,0,0,0,0,34
819,y1312,20130305,8448,8448,0,0,0,8448,8448,0,0,0,0,34
820,y1312,20130306,8448,8448,0,0,0,8448,8448,0,0,0,0,34
821,y1312,20130307,8448,8448,0,0,0,8448,8448,0,0,0,0,34
822,y1312,20130308,8448,8448,0,0,0,8448,8448,0,0,0,0,34
823,y1312,20130311,8448,8448,0,0,0,8448,8448,0,0,0,0,34
824,y1312,20130312,8448,8448,8268,8268,8160,8214,8236,-234,-212,34,2800280,46
825,y1312,20130313,8214,8236,8044,8044,8044,8044,8044,-192,-192,2,160880,46
826,y1312,20130314,8044,8044,8090,8090,8032,8032,8036,-12,-8,22,1768200,34
827,y1312,20130315,8032,8036,0,0,0,8036,8036,0,0,0,0,34
828,y1312,20130318,8036,8036,0,0,0,8036,8036,0,0,0,0,34
829,y1312,20130319,8036,8036,8142,8142,8142,8142,8142,106,106,4,325680,38
830,y1312,20130320,8142,8142,8088,8088,8088,8088,8088,-54,-54,2,161760,36
831,y1312,20130321,8088,8088,8194,8198,8194,8198,8196,110,108,12,983600,32
832,y1312,20130322,8198,8196,0,0,0,8196,8196,0,0,0,0,32
833,y1312,20130325,8196,8196,0,0,0,8196,8196,0,0,0,0,32
834,y1312,20130326,8196,8196,0,0,0,8196,8196,0,0,0,0,32
835,y1312,20130327,8196,8196,8166,8166,8166,8166,8166,-30,-30,2,163320,32
836,y1312,20130328,8166,8166,8134,8134,8132,8132,8132,-34,-34,6,488000,32
837,y1312,20130329,8132,8132,7964,8020,7960,7960,7976,-172,-156,8,638200,32
838,y1312,20130401,7960,7976,8016,8018,8016,8018,8016,42,40,30,2405280,20
839,y1312,20130402,8018,8016,7930,7930,7930,7930,7930,-86,-86,2,158600,20
840,y1312,20130403,7930,7930,0,0,0,7930,7930,0,0,0,0,20
841,y1312,20130408,7930,7930,0,0,0,7930,7930,0,0,0,0,20
842,y1312,20130409,7930,7930,0,0,0,7930,7930,0,0,0,0,20
843,y1312,20130410,7930,7930,8086,8088,8024,8024,8078,94,148,16,1292640,18
844,y1312,20130411,8024,8078,0,0,0,8078,8078,0,0,0,0,18
845,y1312,20130412,8078,8078,7942,7968,7930,7968,7948,-110,-130,20,1589600,18
846,y1312,20130415,7968,7948,0,0,0,7908,7908,-40,-40,0,0,18
847,y1312,20130416,7908,7908,7790,7790,7790,7790,7790,-118,-118,4,311600,18
848,y1312,20130417,7790,7790,7780,7780,7780,7780,7780,-10,-10,2,155600,18
849,y1312,20130418,7780,7780,0,0,0,7780,7780,0,0,0,0,18
850,y1312,20130419,7780,7780,7884,7884,7884,7884,7884,104,104,2,157680,20
851,y1312,20130422,7884,7884,7700,7700,7644,7644,7666,-240,-218,6,460040,20
852,y1312,20130423,7644,7666,7544,7544,7544,7544,7544,-122,-122,4,301760,16
853,y1312,20130424,7544,7544,0,0,0,7544,7544,0,0,0,0,16
854,y1312,20130425,7544,7544,7524,7524,7524,7524,7524,-20,-20,2,150480,16
855,y1312,20130426,7524,7524,7490,7490,7490,7490,7490,-34,-34,2,149800,14
856,y1312,20130502,7490,7490,0,0,0,7490,7490,0,0,0,0,14
857,y1312,20130503,7490,7490,7464,7464,7464,7464,7464,-26,-26,2,149280,16
858,y1312,20130506,7464,7464,7496,7496,7496,7496,7496,32,32,2,149920,14
859,y1312,20130507,7496,7496,0,0,0,7572,7572,76,76,0,0,14
860,y1312,20130508,7572,7572,7650,7650,7526,7526,7558,-46,-14,14,1058320,12
861,y1312,20130509,7526,7558,0,0,0,7558,7558,0,0,0,0,12
862,y1312,20130510,7558,7558,7662,7698,7662,7698,7672,140,114,8,613760,12
863,y1312,20130513,7698,7672,0,0,0,7812,7812,140,140,0,0,12
864,y1312,20130514,7812,7812,7698,7698,7698,7698,7698,-114,-114,2,153960,12
865,y1312,20130515,7698,7698,7638,7640,7638,7640,7638,-58,-60,6,458320,16
866,y1312,20130516,7640,7638,7624,7636,7590,7590,7612,-48,-26,174,13246000,18
867,y1312,20130517,7590,7612,7644,7696,7644,7696,7670,84,58,4,306800,20
868,y1312,20130520,7696,7670,0,0,0,7670,7670,0,0,0,0,20
869,y1312,20130521,7670,7670,0,0,0,7670,7670,0,0,0,0,20
870,y1312,20130522,7670,7670,7710,7710,7710,7710,7710,40,40,2,154200,18
871,y1312,20130523,7710,7710,7750,7750,7668,7710,7702,0,-8,14,1078320,16
872,y1312,20130524,7710,7702,7690,7752,7690,7752,7720,50,18,4,308840,18
873,y1312,20130527,7752,7720,0,0,0,7684,7684,-36,-36,0,0,18
874,y1312,20130528,7684,7684,0,0,0,7682,7682,-2,-2,0,0,18
875,y1312,20130529,7682,7682,7816,7834,7734,7734,7776,52,94,40,3110600,26
876,y1312,20130530,7734,7776,7658,7658,7638,7656,7654,-120,-122,36,2755480,28
877,y1312,20130531,7656,7654,7632,7708,7630,7708,7640,54,-14,16,1222400,30
878,y1312,20130603,7708,7640,7710,7710,7702,7702,7704,62,64,6,462280,24
879,y1312,20130604,7702,7704,7670,7670,7572,7572,7630,-132,-74,16,1220840,26
880,y1312,20130605,7572,7630,7620,7620,7576,7590,7594,-40,-36,28,2126400,28
881,y1312,20130606,7590,7594,7530,7596,7526,7568,7556,-26,-38,16,1209040,14
882,y1312,20130607,7568,7556,7444,7686,7444,7572,7570,16,14,20,1514240,14
883,y1312,20130613,7572,7570,0,0,0,7576,7576,6,6,0,0,14
884,y1312,20130614,7576,7576,7508,7508,7508,7508,7508,-68,-68,2,150160,14
885,y1312,20130617,7508,7508,7510,7648,7510,7648,7564,140,56,6,453880,16
886,y1312,20130618,7648,7564,7618,7618,7618,7618,7618,54,54,2,152360,14
887,y1312,20130619,7618,7618,0,0,0,7618,7618,0,0,0,0,14
888,y1312,20130620,7618,7618,0,0,0,7618,7618,0,0,0,0,14
889,y1312,20130621,7618,7618,7506,7526,7432,7432,7488,-186,-130,6,449280,14
890,y1312,20130624,7432,7488,7356,7362,7356,7362,7358,-126,-130,4,294360,10
891,y1312,20130625,7362,7358,7304,7356,7304,7356,7330,-2,-28,4,293200,10
892,y1312,20130626,7356,7330,0,0,0,7278,7278,-52,-52,0,0,10
893,y1312,20130627,7278,7278,0,0,0,7278,7278,0,0,0,0,10
894,y1312,20130628,7278,7278,7268,7312,7268,7312,7290,34,12,4,291600,10
895,y1312,20130701,7312,7290,0,0,0,7328,7328,38,38,0,0,10
896,y1312,20130702,7328,7328,0,0,0,7328,7328,0,0,0,0,10
897,y1312,20130703,7328,7328,0,0,0,7328,7328,0,0,0,0,10
898,y1312,20130704,7328,7328,0,0,0,7328,7328,0,0,0,0,10
899,y1312,20130705,7328,7328,0,0,0,7328,7328,0,0,0,0,10
900,y1312,20130708,7328,7328,7350,7350,7052,7210,7248,-118,-80,36,2609720,10
901,y1312,20130709,7210,7248,0,0,0,7248,7248,0,0,0,0,10
902,y1312,20130710,7248,7248,7230,7344,6972,7288,7212,40,-36,30,2163600,10
903,y1312,20130711,7288,7212,7422,7426,7290,7290,7368,78,156,56,4126800,14
904,y1312,20130712,7290,7368,7290,7298,7236,7270,7262,-98,-106,30,2178800,14
905,y1312,20130715,7270,7262,7248,7248,7178,7178,7212,-84,-50,4,288520,14
906,y1312,20130716,7178,7212,0,0,0,7212,7212,0,0,0,0,14
907,y1312,20130717,7212,7212,0,0,0,7212,7212,0,0,0,0,14
908,y1312,20130718,7212,7212,7250,7250,7234,7234,7242,22,30,4,289680,12
909,y1312,20130719,7234,7242,7230,7238,7230,7238,7234,-4,-8,4,289360,12
910,y1312,20130722,7238,7234,0,0,0,7234,7234,0,0,0,0,12
911,y1312,20130723,7234,7234,0,0,0,7260,7260,26,26,0,0,12
912,y1312,20130724,7260,7260,7288,7288,7204,7204,7254,-56,-6,20,1450960,8
913,y1312,20130725,7204,7254,7204,7204,7142,7182,7178,-72,-76,14,1005000,8
914,y1312,20130726,7182,7178,0,0,0,7044,7044,-134,-134,0,0,8
915,y1312,20130729,7044,7044,0,0,0,7032,7032,-12,-12,0,0,8
916,y1312,20130730,7032,7032,0,0,0,7032,7032,0,0,0,0,8
917,y1312,20130731,7032,7032,0,0,0,7032,7032,0,0,0,0,8
918,y1312,20130801,7032,7032,0,0,0,7032,7032,0,0,0,0,8
919,y1312,20130802,7032,7032,0,0,0,7032,7032,0,0,0,0,8
920,y1312,20130805,7032,7032,0,0,0,7032,7032,0,0,0,0,8
921,y1312,20130806,7032,7032,6986,6986,6986,6986,6986,-46,-46,2,139720,6
922,y1312,20130807,6986,6986,6872,6938,6872,6938,6904,-48,-82,20,1381000,8
923,y1312,20130808,6938,6904,6920,6968,6902,6938,6934,34,30,18,1248120,6
924,y1312,20130809,6938,6934,6990,6992,6916,6920,6954,-14,20,202,14049600,74
925,y1312,20130812,6920,6954,6960,6978,6898,6950,6926,-4,-28,50,3463080,56
926,y1312,20130813,6950,6926,0,0,0,7054,7054,128,128,0,0,56
927,y1312,20130814,7054,7054,7130,7130,7024,7024,7090,-30,36,28,1985520,54
928,y1312,20130815,7024,7090,0,0,0,7082,7082,-8,-8,0,0,54
929,y1312,20130816,7082,7082,7242,7242,7170,7170,7208,88,126,18,1297720,54
930,y1312,20130819,7170,7208,0,0,0,7208,7208,0,0,0,0,54
931,y1312,20130820,7208,7208,7126,7126,7072,7072,7098,-136,-110,4,283960,54
932,y1312,20130821,7072,7098,7130,7130,7072,7086,7088,-12,-10,24,1701520,56
933,y1312,20130822,7086,7088,7038,7038,7038,7038,7038,-50,-50,4,281520,56
934,y1312,20130823,7038,7038,0,0,0,7038,7038,0,0,0,0,56
935,y1312,20130826,7038,7038,7308,7318,7172,7318,7270,280,232,92,6690000,62
936,y1312,20130827,7318,7270,7332,7340,7324,7324,7332,54,62,30,2199880,52
937,y1312,20130828,7324,7332,7338,7358,7338,7358,7352,26,20,26,1911520,46
938,y1312,20130829,7358,7352,7270,7278,7206,7278,7240,-74,-112,22,1593000,56
939,y1312,20130830,7278,7240,7222,7222,7214,7214,7218,-26,-22,14,1010600,56
940,y1312,20130902,7214,7218,7314,7328,7156,7292,7308,74,90,46,3361720,62
941,y1312,20130903,7292,7308,7364,7366,7298,7298,7352,-10,44,118,8676760,96
942,y1312,20130904,7298,7352,7230,7274,7214,7214,7232,-138,-120,16,1157160,96
943,y1312,20130905,7214,7232,7202,7260,7202,7224,7228,-8,-4,18,1301120,92
944,y1312,20130906,7224,7228,7212,7302,7212,7282,7272,54,44,66,4799800,42
945,y1312,20130909,7282,7272,7266,7292,7260,7292,7266,20,-6,12,871960,34
946,y1312,20130910,7292,7266,7150,7298,7148,7298,7198,32,-68,6,431920,36
947,y1312,20130911,7298,7198,7136,7188,7136,7188,7162,-10,-36,4,286480,34
948,y1312,20130912,7188,7162,7210,7214,7140,7206,7196,44,34,10,719600,38
949,y1312,20130913,7206,7196,7154,7156,7154,7156,7154,-40,-42,6,429280,38
950,y1312,20130916,7156,7154,7066,7066,7066,7066,7066,-88,-88,2,141320,38
951,y1312,20130917,7066,7066,7044,7044,7044,7044,7044,-22,-22,2,140880,36
952,y1312,20130918,7044,7044,0,0,0,7044,7044,0,0,0,0,36
953,y1312,20130923,7044,7044,7002,7068,7002,7068,7024,24,-20,10,702480,44
954,y1312,20130924,7068,7024,7150,7150,7046,7046,7106,22,82,50,3553560,38
955,y1312,20130925,7046,7106,7064,7064,7064,7064,7064,-42,-42,2,141280,38
956,y1312,20130926,7064,7064,0,0,0,7064,7064,0,0,0,0,38
957,y1312,20130927,7064,7064,7046,7046,6966,6966,7006,-98,-58,16,1121040,36
958,y1312,20130930,6966,7006,6924,6924,6924,6924,6924,-82,-82,2,138480,34
959,y1312,20131008,6924,6924,0,0,0,6924,6924,0,0,0,0,34
960,y1312,20131009,6924,6924,0,0,0,7000,7000,76,76,0,0,34
961,y1312,20131010,7000,7000,0,0,0,7020,7020,20,20,0,0,34
962,y1312,20131011,7020,7020,6980,7050,6970,7000,7010,-20,-10,10,701000,32
963,y1312,20131014,7000,7010,7044,7050,7044,7050,7046,40,36,20,1409560,42
964,y1312,20131015,7050,7046,7042,7042,7042,7042,7042,-4,-4,2,140840,40
965,y1312,20131016,7042,7042,7082,7104,7062,7104,7092,62,50,60,4256240,40
966,y1312,20131017,7104,7092,7106,7106,7106,7106,7106,14,14,14,994840,34
967,y1312,20131018,7106,7106,7180,7180,7180,7180,7180,74,74,2,143600,36
968,y1312,20131021,7180,7180,7182,7192,7182,7192,7186,12,6,4,287480,32
969,y1312,20131022,7192,7186,0,0,0,7186,7186,0,0,0,0,32
970,y1312,20131023,7186,7186,0,0,0,7006,7006,-180,-180,0,0,32
971,y1312,20131024,7006,7006,7068,7068,7068,7068,7068,62,62,8,565440,32
972,y1312,20131025,7068,7068,7014,7014,7014,7014,7014,-54,-54,2,140280,32
973,y1312,20131028,7014,7014,6900,7016,6900,7016,6956,2,-58,52,3617200,32
974,y1312,20131029,7016,6956,0,0,0,6930,6930,-26,-26,0,0,32
975,y1312,20131030,6930,6930,0,0,0,6930,6930,0,0,0,0,32
976,y1312,20131031,6930,6930,6932,6940,6808,6830,6876,-100,-54,32,2200360,44
977,y1312,20131101,6830,6876,6816,7150,6816,7150,6996,274,120,166,11613680,148
978,y1312,20131104,7150,6996,7126,7126,7126,7126,7126,130,130,2,142520,148
979,y1312,20131105,7126,7126,7262,7262,7130,7130,7140,4,14,48,3427840,108
980,y1312,20131106,7130,7140,7146,7160,7144,7160,7148,20,8,16,1143760,96
981,y1312,20131107,7160,7148,0,0,0,7148,7148,0,0,0,0,96
982,y1312,20131108,7148,7148,0,0,0,7148,7148,0,0,0,0,96
983,y1312,20131111,7148,7148,7124,7130,7124,7130,7126,-18,-22,4,285080,96
984,y1312,20131112,7130,7126,7250,7250,7060,7092,7118,-34,-8,32,2277960,88
985,y1312,20131113,7092,7118,7032,7176,7032,7164,7104,46,-14,14,994560,88
986,y1312,20131114,7164,7104,7198,7198,7198,7198,7198,94,94,2,143960,86
987,y1312,20131115,7198,7198,0,0,0,7198,7198,0,0,0,0,86
988,y1312,20131118,7198,7198,0,0,0,7198,7198,0,0,0,0,86
989,y1312,20131119,7198,7198,7198,7452,7136,7200,7218,2,20,14,1010640,90
990,y1312,20131120,7200,7218,7200,7200,7200,7200,7200,-18,-18,22,1584000,88
991,y1312,20131121,7200,7200,7150,7320,7144,7320,7196,120,-4,44,3166880,48
992,y1312,20131122,7320,7196,7162,7162,7162,7162,7162,-34,-34,2,143240,46
993,y1312,20131125,7162,7162,0,0,0,7166,7166,4,4,0,0,46
994,y1312,20131126,7166,7166,0,0,0,7166,7166,0,0,0,0,46
995,y1312,20131127,7166,7166,7180,7180,7180,7180,7180,14,14,2,143600,46
996,y1312,20131128,7180,7180,6914,7100,6914,7100,6970,-80,-210,22,1533800,44
997,y1312,20131129,7100,6970,6728,7150,6728,7150,6938,180,-32,4,277560,44
998,y1312,20131202,7150,6938,0,0,0,6938,6938,0,0,0,0,34
999,y1312,20131203,6938,6938,0,0,0,7080,7080,142,142,0,0,34
1000,y1312,20131204,7080,7080,0,0,0,7080,7080,0,0,0,0,34
1001,y1312,20131205,7080,7080,0,0,0,7080,7080,0,0,0,0,34
1002,y1312,20131206,7080,7080,0,0,0,7080,7080,0,0,0,0,34
1003,y1312,20131209,7080,7080,0,0,0,7080,7080,0,0,0,0,34
1004,y1312,20131210,7080,7080,0,0,0,7080,7080,0,0,0,0,34
1005,y1312,20131211,7080,7080,0,0,0,7080,7080,0,0,0,0,34
1006,y1312,20131212,7080,7080,0,0,0,7080,7080,0,0,0,0,34
1007,y1312,20131213,7080,7080,0,0,0,7080,7080,0,0,0,0,0
1008,y1401,20130121,8838,8788,8860,8922,8858,8904,8884,116,96,1104,98082520,3580
1009,y1401,20130122,8904,8884,8938,8944,8884,8906,8902,22,18,7524,669790840,7946
1010,y1401,20130123,8906,8902,8926,8926,8884,8912,8900,10,-2,494,43968400,7880
1011,y1401,20130124,8912,8900,8868,8868,8742,8746,8786,-154,-114,1094,96127280,7778
1012,y1401,20130125,8746,8786,8782,8816,8782,8804,8796,18,10,734,64568960,7898
1013,y1401,20130128,8804,8796,8798,8818,8748,8814,8778,18,-18,732,64263040,8140
1014,y1401,20130129,8814,8778,8796,8796,8746,8758,8768,-20,-10,1444,126622640,7716
1015,y1401,20130130,8758,8768,8736,8808,8736,8802,8792,34,24,990,87046360,8248
1016,y1401,20130131,8802,8792,8846,8900,8846,8886,8876,94,84,1136,100852920,8400
1017,y1401,20130201,8886,8876,8904,8926,8866,8916,8894,40,18,910,80937400,8842
1018,y1401,20130204,8916,8894,8930,8998,8914,8962,8972,68,78,1930,173178920,9854
1019,y1401,20130205,8962,8972,8980,8980,8886,8886,8920,-86,-52,1474,131481200,10052
1020,y1401,20130206,8886,8920,8886,8928,8850,8862,8892,-58,-28,1530,136074640,10830
1021,y1401,20130207,8862,8892,8850,8852,8790,8834,8826,-58,-66,1740,153589800,11646
1022,y1401,20130208,8834,8826,8832,8852,8786,8790,8820,-36,-6,1310,115546200,12264
1023,y1401,20130218,8790,8820,8770,8770,8708,8710,8724,-110,-96,1774,154765320,12846
1024,y1401,20130219,8710,8724,8724,8760,8708,8750,8732,26,8,21870,1910012680,31160
1025,y1401,20130220,8750,8732,8780,8806,8768,8790,8790,58,58,5656,497211040,33702
1026,y1401,20130221,8790,8790,8740,8740,8660,8674,8692,-116,-98,6308,548386560,31400
1027,y1401,20130222,8674,8692,8674,8800,8662,8742,8738,50,46,13438,1174222880,39632
1028,y1401,20130225,8742,8738,8600,8612,8418,8458,8472,-280,-266,13966,1183444400,41324
1029,y1401,20130226,8458,8472,8452,8494,8362,8370,8432,-102,-40,11382,959874960,42124
1030,y1401,20130227,8370,8432,8380,8396,8340,8374,8370,-58,-62,6942,581078560,44244
1031,y1401,20130228,8374,8370,8400,8418,8332,8358,8386,-12,16,13430,1126338240,47068
1032,y1401,20130301,8358,8386,8310,8348,8290,8314,8312,-72,-74,11528,958414920,52482
1033,y1401,20130304,8314,8312,8344,8402,8336,8382,8378,70,66,9110,763298760,56370
1034,y1401,20130305,8382,8378,8432,8448,8372,8384,8398,6,20,5458,458437360,56986
1035,y1401,20130306,8384,8398,8388,8420,8350,8398,8400,0,2,7444,625351000,59402
1036,y1401,20130307,8398,8400,8388,8396,8308,8320,8340,-80,-60,9028,753099440,61104
1037,y1401,20130308,8320,8340,8370,8400,8360,8380,8380,40,40,5886,493284760,62828
1038,y1401,20130311,8380,8380,8376,8376,8260,8266,8316,-114,-64,17704,1472612440,69572
1039,y1401,20130312,8266,8316,8294,8294,8206,8212,8252,-104,-64,16820,1388170600,73664
1040,y1401,20130313,8212,8252,8202,8214,8076,8100,8120,-152,-132,16070,1305086600,76556
1041,y1401,20130314,8100,8120,8100,8136,8052,8076,8086,-44,-34,22264,1800327480,84274
1042,y1401,20130315,8076,8086,8104,8220,8088,8212,8154,126,68,30234,2465566120,97214
1043,y1401,20130318,8212,8154,8120,8158,8080,8134,8126,-20,-28,21334,1733666480,97460
1044,y1401,20130319,8134,8126,8166,8218,8166,8200,8192,74,66,39394,3227607680,106002
1045,y1401,20130320,8200,8192,8180,8208,8144,8192,8174,0,-18,20222,1653318360,113008
1046,y1401,20130321,8192,8174,8240,8290,8226,8242,8254,68,80,27598,2278282800,118476
1047,y1401,20130322,8242,8254,8256,8270,8196,8200,8222,-54,-32,12002,987034080,118740
1048,y1401,20130325,8200,8222,8220,8250,8200,8220,8222,-2,0,11946,982392760,119296
1049,y1401,20130326,8220,8222,8220,8238,8170,8182,8198,-40,-24,26022,2133343120,122748
1050,y1401,20130327,8182,8198,8226,8260,8190,8254,8218,56,20,22140,1819870600,121728
1051,y1401,20130328,8254,8218,8260,8262,8174,8182,8214,-36,-4,32546,2673532200,126052
1052,y1401,20130329,8182,8214,8096,8134,8000,8090,8090,-124,-124,45228,3659014280,137618
1053,y1401,20130401,8090,8090,8088,8102,7970,7972,8014,-118,-76,45150,3618763360,141574
1054,y1401,20130402,7972,8014,8020,8052,7950,8052,8014,38,0,44460,3563095320,149014
1055,y1401,20130403,8052,8014,8000,8080,7980,8034,8028,20,14,37936,3045975280,149808
1056,y1401,20130408,8034,8028,8000,8090,7984,8074,8060,46,32,41504,3345575720,149646
1057,y1401,20130409,8074,8060,8082,8140,8080,8096,8118,36,58,29170,2368034280,150836
1058,y1401,20130410,8096,8118,8166,8166,8082,8138,8122,20,4,37320,3031196800,151736
1059,y1401,20130411,8138,8122,8118,8148,8030,8032,8072,-90,-50,42684,3445850880,154702
1060,y1401,20130412,8032,8072,8018,8050,7992,8020,8020,-52,-52,33840,2714293920,154782
1061,y1401,20130415,8020,8020,7952,7968,7830,7854,7888,-166,-132,45362,3578618760,153826
1062,y1401,20130416,7854,7888,7720,7838,7702,7836,7776,-52,-112,49932,3883012720,157686
1063,y1401,20130417,7836,7776,7892,7898,7786,7816,7836,40,60,47414,3716265320,161754
1064,y1401,20130418,7816,7836,7750,7834,7720,7780,7784,-56,-52,72746,5663751360,169792
1065,y1401,20130419,7780,7784,7820,7848,7792,7816,7820,32,36,39356,3077831640,170444
1066,y1401,20130422,7816,7820,7750,7762,7608,7612,7676,-208,-144,59702,4583087960,169924
1067,y1401,20130423,7612,7676,7600,7634,7570,7608,7606,-68,-70,42882,3261944200,168532
1068,y1401,20130424,7608,7606,7580,7628,7502,7506,7552,-100,-54,68848,5199532040,174528
1069,y1401,20130425,7506,7552,7526,7578,7504,7506,7540,-46,-12,79176,5970280280,175890
1070,y1401,20130426,7506,7540,7586,7586,7512,7516,7540,-24,0,67310,5076223320,184076
1071,y1401,20130502,7516,7540,7466,7466,7350,7374,7388,-166,-152,85588,6323706240,208690
1072,y1401,20130503,7374,7388,7366,7476,7366,7468,7434,80,46,107566,7998516120,208690
1073,y1401,20130506,7468,7434,7542,7572,7484,7570,7524,136,90,99062,7455171920,219364
1074,y1401,20130507,7570,7524,7540,7628,7520,7544,7576,20,52,181488,13751965560,245382
1075,y1401,20130508,7544,7576,7548,7604,7532,7600,7582,24,6,135476,10272014640,239462
1076,y1401,20130509,7600,7582,7562,7600,7552,7560,7568,-22,-14,118302,8954939440,258268
1077,y1401,20130510,7560,7568,7594,7746,7574,7730,7664,162,96,225664,17295529400,261546
1078,y1401,20130513,7730,7664,7702,7756,7668,7686,7712,22,48,145586,11230228400,250094
1079,y1401,20130514,7686,7712,7750,7782,7706,7716,7744,4,32,110278,8540283760,254534
1080,y1401,20130515,7716,7744,7700,7726,7568,7582,7638,-162,-106,151886,11601259120,250464
1081,y1401,20130516,7582,7638,7582,7686,7566,7640,7622,2,-16,120316,9172845360,254144
1082,y1401,20130517,7640,7622,7676,7740,7660,7720,7706,98,84,142806,11005925600,267700
1083,y1401,20130520,7720,7706,7724,7748,7664,7718,7710,12,4,170882,13178030480,296020
1084,y1401,20130521,7718,7710,7700,7724,7622,7680,7674,-30,-36,151596,11633695720,306200
1085,y1401,20130522,7680,7674,7696,7790,7692,7766,7748,92,74,176424,13671491960,326072
1086,y1401,20130523,7766,7748,7786,7808,7684,7692,7732,-56,-16,203530,15737831840,323428
1087,y1401,20130524,7692,7732,7722,7802,7706,7760,7768,28,36,160984,12505424920,328300
1088,y1401,20130527,7760,7768,7710,7756,7684,7754,7732,-14,-36,117498,9087215720,329476
1089,y1401,20130528,7754,7732,7768,7786,7712,7740,7742,8,10,127384,9863652920,325112
1090,y1401,20130529,7740,7742,7768,7868,7752,7778,7806,36,64,236384,18453570120,330750
1091,y1401,20130530,7778,7806,7722,7746,7670,7718,7704,-88,-102,257386,19833804960,340344
1092,y1401,20130531,7718,7704,7730,7768,7686,7698,7724,-6,20,196534,15180458760,328466
1093,y1401,20130603,7698,7724,7720,7798,7720,7760,7766,36,42,243630,18922132560,321102
1094,y1401,20130604,7760,7766,7780,7780,7630,7658,7674,-108,-92,328074,25180817880,332798
1095,y1401,20130605,7658,7674,7670,7688,7608,7622,7634,-52,-40,265622,20279094920,331864
1096,y1401,20130606,7622,7634,7576,7658,7550,7618,7610,-16,-24,340996,25955191280,316094
1097,y1401,20130607,7618,7610,7620,7712,7554,7710,7646,100,36,381402,29163220480,309736
1098,y1401,20130613,7710,7646,7640,7716,7616,7620,7656,-26,10,282336,21619681320,322686
1099,y1401,20130614,7620,7656,7598,7618,7528,7608,7570,-48,-86,462876,35043008560,335324
1100,y1401,20130617,7608,7570,7600,7660,7572,7636,7624,66,54,395080,30126726040,361538
1101,y1401,20130618,7636,7624,7676,7748,7668,7690,7704,66,80,461538,35559476520,361616
1102,y1401,20130619,7690,7704,7666,7690,7644,7680,7666,-24,-38,358004,27448231880,361694
1103,y1401,20130620,7680,7666,7712,7742,7652,7692,7702,26,36,681034,52464797320,390746
1104,y1401,20130621,7692,7702,7590,7632,7452,7478,7552,-224,-150,873560,65983430800,429280
1105,y1401,20130624,7478,7552,7400,7460,7352,7376,7406,-176,-146,836728,61968949840,472426
1106,y1401,20130625,7376,7406,7412,7456,7356,7438,7396,32,-10,899004,66496535240,450064
1107,y1401,20130626,7438,7396,7402,7442,7278,7332,7346,-64,-50,1121452,82383455840,511946
1108,y1401,20130627,7332,7346,7314,7326,7242,7302,7282,-44,-64,839360,61132045400,498958
1109,y1401,20130628,7302,7282,7270,7344,7260,7294,7316,12,34,666980,48798694720,490484
1110,y1401,20130701,7294,7316,7288,7410,7262,7382,7358,66,42,798590,58764253560,506616
1111,y1401,20130702,7382,7358,7386,7430,7324,7360,7374,2,16,776510,57274698920,481972
1112,y1401,20130703,7360,7374,7362,7384,7312,7322,7346,-52,-28,593888,43629918640,521234
1113,y1401,20130704,7322,7346,7332,7386,7326,7346,7360,0,14,637956,46963193240,545120
1114,y1401,20130705,7346,7360,7358,7358,7276,7316,7304,-44,-56,615828,44981578120,571972
1115,y1401,20130708,7316,7304,7320,7368,7212,7238,7274,-66,-30,943160,68614024040,640150
1116,y1401,20130709,7238,7274,7266,7296,7252,7272,7276,-2,2,578662,42108922040,585656
1117,y1401,20130710,7272,7276,7298,7336,7232,7286,7270,10,-6,708842,51537783320,587306
1118,y1401,20130711,7286,7270,7306,7410,7292,7354,7348,84,78,841030,61805868760,543752
1119,y1401,20130712,7354,7348,7320,7330,7266,7282,7290,-66,-58,690708,50359157920,568246
1120,y1401,20130715,7282,7290,7250,7280,7160,7174,7198,-116,-92,943886,67946249560,605318
1121,y1401,20130716,7174,7198,7200,7218,7160,7206,7192,8,-6,593744,42703898800,603382
1122,y1401,20130717,7206,7192,7218,7302,7194,7240,7244,48,52,739950,53605015520,584420
1123,y1401,20130718,7240,7244,7204,7280,7192,7272,7238,28,-6,658392,47658883200,601312
1124,y1401,20130719,7272,7238,7280,7280,7208,7220,7242,-18,4,566880,41059258680,621738
1125,y1401,20130722,7220,7242,7230,7276,7202,7256,7246,14,4,637174,46181711360,633670
1126,y1401,20130723,7256,7246,7270,7326,7242,7314,7284,68,38,767568,55916578920,639150
1127,y1401,20130724,7314,7284,7252,7270,7222,7244,7244,-40,-40,582800,42229434760,644954
1128,y1401,20130725,7244,7244,7196,7204,7130,7142,7162,-102,-82,830058,59453499440,699710
1129,y1401,20130726,7142,7162,7116,7130,6960,6986,7030,-176,-132,1058366,74407768160,741292
1130,y1401,20130729,6986,7030,6996,7016,6968,6990,6990,-40,-40,511562,35763972840,712372
1131,y1401,20130730,6990,6990,6940,6992,6902,6976,6944,-14,-46,841666,58451805960,711104
1132,y1401,20130731,6976,6944,6940,7064,6934,7030,7018,86,74,941810,66105081000,713236
1133,y1401,20130801,7030,7018,7008,7050,6996,7012,7020,-6,2,565338,39687434920,734716
1134,y1401,20130802,7012,7020,7028,7056,6996,7034,7030,14,10,704494,49539745520,740434
1135,y1401,20130805,7034,7030,7000,7040,6978,6994,7008,-36,-22,586874,41128494760,744814
1136,y1401,20130806,6994,7008,7028,7038,7004,7008,7020,0,12,487410,34221571800,721394
1137,y1401,20130807,7008,7020,6974,6978,6882,6884,6926,-136,-94,763512,52881473960,780808
1138,y1401,20130808,6884,6926,6882,6938,6882,6900,6914,-26,-12,690994,47780271120,738536
1139,y1401,20130809,6900,6914,6918,6978,6912,6920,6946,6,32,800252,55589375560,720442
1140,y1401,20130812,6920,6946,6922,6992,6906,6974,6952,28,6,769724,53511393800,717704
1141,y1401,20130813,6974,6952,7038,7176,7036,7144,7124,192,172,1288042,91768462640,765204
1142,y1401,20130814,7144,7124,7124,7168,7074,7076,7116,-48,-8,957782,68171205760,780946
1143,y1401,20130815,7076,7116,7108,7150,7096,7124,7126,8,10,832978,59365971680,768816
1144,y1401,20130816,7124,7126,7220,7282,7176,7186,7230,60,104,903850,65356418280,780060
1145,y1401,20130819,7186,7230,7250,7270,7214,7232,7240,2,10,690516,50004915240,810092
1146,y1401,20130820,7232,7240,7282,7294,7116,7134,7182,-106,-58,890202,63939004240,790134
1147,y1401,20130821,7134,7182,7130,7164,7110,7126,7138,-56,-44,577178,41202265960,789214
1148,y1401,20130822,7126,7138,7116,7148,7064,7096,7104,-42,-34,706840,50217740680,796318
1149,y1401,20130823,7096,7104,7088,7098,7058,7078,7080,-26,-24,594332,42085363040,807920
1150,y1401,20130826,7078,7080,7210,7362,7208,7362,7316,282,236,720644,52729121960,794816
1151,y1401,20130827,7362,7316,7462,7462,7360,7410,7394,94,78,867302,64128828720,788102
1152,y1401,20130828,7410,7394,7386,7420,7330,7332,7388,-62,-6,736912,54452755040,765204
1153,y1401,20130829,7332,7388,7358,7366,7094,7224,7264,-164,-124,1154718,83887212000,725622
1154,y1401,20130830,7224,7264,7196,7214,7154,7172,7178,-92,-86,748472,53735083000,682450
1155,y1401,20130902,7172,7178,7188,7290,7188,7288,7256,110,78,736246,53426665360,685310
1156,y1401,20130903,7288,7256,7320,7340,7232,7288,7278,32,22,824792,60033936040,674358
1157,y1401,20130904,7288,7278,7240,7240,7166,7188,7196,-90,-82,765076,55062192160,672008
1158,y1401,20130905,7188,7196,7180,7228,7162,7188,7194,-8,-2,540330,38872016440,674910
1159,y1401,20130906,7188,7194,7200,7310,7186,7310,7254,116,60,1017886,73855629840,726202
1160,y1401,20130909,7310,7254,7310,7336,7292,7312,7310,58,56,716344,52369012080,702744
1161,y1401,20130910,7312,7310,7220,7244,7154,7192,7206,-118,-104,951020,68543825840,674132
1162,y1401,20130911,7192,7206,7206,7238,7186,7236,7208,30,2,573098,41311333920,676640
1163,y1401,20130912,7236,7208,7220,7254,7200,7200,7224,-8,16,677144,48925452160,668746
1164,y1401,20130913,7200,7224,7300,7304,7172,7196,7222,-28,-2,880074,63563314680,685530
1165,y1401,20130916,7196,7222,7106,7144,7062,7062,7112,-160,-110,691274,49167165440,703178
1166,y1401,20130917,7062,7112,7098,7104,7048,7102,7076,-10,-36,643314,45524582400,665940
1167,y1401,20130918,7102,7076,7112,7126,7056,7070,7086,-6,10,485690,34421834600,660060
1168,y1401,20130923,7070,7086,7000,7052,6988,7038,7020,-48,-66,441694,31008094640,654152
1169,y1401,20130924,7038,7020,7060,7096,7036,7084,7076,64,56,447024,31635074040,634666
1170,y1401,20130925,7084,7076,7060,7096,7042,7060,7068,-16,-8,444590,31424615720,638924
1171,y1401,20130926,7060,7068,7056,7074,7012,7042,7042,-26,-26,407256,28679938520,631780
1172,y1401,20130927,7042,7042,7038,7058,6978,6982,7012,-60,-30,513574,36015064120,624156
1173,y1401,20130930,6982,7012,6960,7008,6934,6960,6970,-52,-42,359152,25037202640,576720
1174,y1401,20131008,6960,6970,6918,7044,6918,7000,6990,30,20,518356,36234071600,590236
1175,y1401,20131009,7000,6990,7042,7088,7006,7056,7056,66,66,630160,44474485520,614450
1176,y1401,20131010,7056,7056,7068,7104,7058,7096,7078,40,22,628370,44480802440,616956
1177,y1401,20131011,7096,7078,7110,7128,7054,7064,7086,-14,8,526056,37286550320,609610
1178,y1401,20131014,7064,7086,7032,7090,7024,7058,7064,-28,-22,402274,28419317600,616002
1179,y1401,20131015,7058,7064,7058,7090,7038,7086,7066,22,2,436768,30869695520,592038
1180,y1401,20131016,7086,7066,7100,7124,7068,7118,7102,52,36,487468,34626339440,552166
1181,y1401,20131017,7118,7102,7160,7210,7130,7182,7174,80,72,511648,36710529720,530474
1182,y1401,20131018,7182,7174,7164,7192,7130,7170,7162,-4,-12,299258,21434147680,507386
1183,y1401,20131021,7170,7162,7222,7280,7214,7248,7250,86,88,312798,22681556000,494066
1184,y1401,20131022,7248,7250,7250,7252,7166,7172,7202,-78,-48,209308,15077947000,470150
1185,y1401,20131023,7172,7202,7200,7224,7154,7198,7190,-4,-12,204714,14721008120,458200
1186,y1401,20131024,7198,7190,7202,7216,7142,7184,7174,-6,-16,184390,13228375800,440474
1187,y1401,20131025,7184,7174,7150,7182,7116,7124,7152,-50,-22,155064,11091487160,414300
1188,y1401,20131028,7124,7152,7110,7136,7098,7124,7116,-28,-36,112882,8033606240,397378
1189,y1401,20131029,7124,7116,7090,7116,7024,7050,7062,-66,-54,160758,11354888880,371588
1190,y1401,20131030,7050,7062,7092,7242,7092,7190,7178,128,116,279462,20063550240,354006
1191,y1401,20131031,7190,7178,7190,7208,7158,7190,7188,12,10,121548,8736939080,326172
1192,y1401,20131101,7190,7188,7194,7242,7180,7242,7208,54,20,162720,11730598520,319554
1193,y1401,20131104,7242,7208,7222,7260,7216,7250,7232,42,24,108548,7852125440,310802
1194,y1401,20131105,7250,7232,7212,7230,7158,7216,7196,-16,-36,104606,7527774480,282968
1195,y1401,20131106,7216,7196,7196,7220,7174,7202,7198,6,2,78730,5667246960,266370
1196,y1401,20131107,7202,7198,7192,7218,7172,7196,7196,-2,-2,63518,4571812000,259716
1197,y1401,20131108,7196,7196,7160,7190,7148,7172,7174,-24,-22,78630,5640968600,221910
1198,y1401,20131111,7172,7174,7170,7218,7130,7132,7156,-42,-18,64716,4631382440,202738
1199,y1401,20131112,7132,7156,7140,7174,7110,7170,7136,14,-20,46932,3349928720,194650
1200,y1401,20131113,7170,7136,7194,7216,7174,7192,7196,56,60,45482,3273152040,188938
1201,y1401,20131114,7192,7196,7202,7248,7196,7238,7218,42,22,40676,2936323440,185164
1202,y1401,20131115,7238,7218,7218,7284,7218,7240,7252,22,34,50434,3657943160,161622
1203,y1401,20131118,7240,7252,7220,7220,7158,7160,7192,-92,-60,30646,2204430160,157384
1204,y1401,20131119,7160,7192,7148,7180,7140,7154,7158,-38,-34,27676,1981373280,151956
1205,y1401,20131120,7154,7158,7156,7172,7130,7170,7154,12,-4,29160,2086111640,140620
1206,y1401,20131121,7170,7154,7170,7262,7130,7244,7224,90,70,32970,2381983920,128130
1207,y1401,20131122,7244,7224,7310,7334,7274,7274,7312,50,88,37194,2719730840,117528
1208,y1401,20131125,7274,7312,7290,7322,7270,7292,7294,-20,-18,14662,1069689800,112306
1209,y1401,20131126,7292,7294,7270,7300,7222,7224,7264,-70,-30,16210,1177521200,108562
1210,y1401,20131127,7224,7264,7202,7264,7202,7258,7240,-6,-24,20830,1508166760,104404
1211,y1401,20131128,7258,7240,7220,7270,7214,7250,7246,10,6,12864,932205560,103384
1212,y1401,20131129,7250,7246,7280,7312,7248,7310,7276,64,30,13552,986219240,98742
1213,y1401,20131202,7310,7276,7302,7344,7298,7314,7314,38,38,13852,1013249400,95256
1214,y1401,20131203,7314,7314,7320,7320,7254,7270,7280,-44,-34,15244,1109904720,90238
1215,y1401,20131204,7270,7280,7266,7270,7240,7264,7254,-16,-26,8284,601037640,86354
1216,y1401,20131205,7264,7254,7290,7300,7232,7234,7268,-20,14,11136,809574480,83276
1217,y1401,20131206,7234,7268,7252,7272,7226,7230,7248,-38,-20,16066,1164475280,74498
1218,y1401,20131209,7230,7248,7248,7276,7232,7268,7260,20,12,8498,617081320,70258
1219,y1401,20131210,7268,7260,7242,7264,7222,7260,7246,0,-14,12042,872757880,66122
1220,y1401,20131211,7260,7246,7240,7280,7230,7270,7254,24,8,15338,1112656160,59200
1221,y1401,20131212,7270,7254,7256,7296,7230,7234,7260,-20,6,25654,1862588000,48724
1222,y1401,20131213,7234,7260,7224,7224,7094,7102,7152,-158,-108,11448,818764080,42652
1223,y1401,20131216,7102,7152,7112,7124,7032,7032,7074,-120,-78,9374,663239560,37344
1224,y1401,20131217,7032,7074,7070,7116,7046,7068,7084,-6,10,7770,550546240,34268
1225,y1401,20131218,7068,7084,7058,7058,6988,7056,7006,-28,-78,6264,438915280,30514
1226,y1401,20131219,7056,7006,7040,7060,6968,6984,7024,-22,18,7948,558363960,26110
1227,y1401,20131220,6984,7024,7002,7014,6958,6994,6980,-30,-44,4272,298244800,23200
1228,y1401,20131223,6994,6980,7002,7024,6924,6986,6976,6,-4,4130,288169600,20248
1229,y1401,20131224,6986,6976,6958,6978,6908,6940,6936,-36,-40,3206,222404280,17884
1230,y1401,20131225,6940,6936,6940,6940,6858,6864,6890,-72,-46,6198,427074680,15612
1231,y1401,20131226,6864,6890,6880,6880,6836,6850,6848,-40,-42,3050,208924720,14036
1232,y1401,20131227,6850,6848,6834,6870,6832,6852,6850,4,2,2238,153344960,12540
1233,y1401,20131230,6852,6850,6852,6906,6828,6888,6884,38,34,4094,281862360,9726
1234,y1401,20131231,6888,6884,6878,6878,6710,6756,6834,-128,-50,2572,175782120,7596
1235,y1403,20130318,8150,8170,0,0,0,8170,8170,0,0,0,0,2
1236,y1403,20130319,8170,8170,8232,8232,8132,8132,8182,-38,12,4,327280,4
1237,y1403,20130320,8132,8182,0,0,0,8182,8182,0,0,0,0,4
1238,y1403,20130321,8182,8182,8258,8258,8258,8258,8258,76,76,2,165160,6
1239,y1403,20130322,8258,8258,0,0,0,8258,8258,0,0,0,0,6
1240,y1403,20130325,8258,8258,8246,8246,8246,8246,8246,-12,-12,4,329840,6
1241,y1403,20130326,8246,8246,7986,8208,7986,8208,8096,-38,-150,4,323880,6
1242,y1403,20130327,8208,8096,0,0,0,8096,8096,0,0,0,0,6
1243,y1403,20130328,8096,8096,0,0,0,8096,8096,0,0,0,0,6
1244,y1403,20130329,8096,8096,0,0,0,8096,8096,0,0,0,0,6
1245,y1403,20130401,8096,8096,0,0,0,8096,8096,0,0,0,0,6
1246,y1403,20130402,8096,8096,8020,8026,8020,8026,8024,-70,-72,6,481440,8
1247,y1403,20130403,8026,8024,8086,8086,8086,8086,8086,62,62,4,323440,4
1248,y1403,20130408,8086,8086,0,0,0,8086,8086,0,0,0,0,4
1249,y1403,20130409,8086,8086,8368,8368,8172,8172,8270,86,184,4,330800,4
1250,y1403,20130410,8172,8270,8154,8176,8154,8176,8164,-94,-106,4,326600,4
1251,y1403,20130411,8176,8164,0,0,0,8164,8164,0,0,0,0,4
1252,y1403,20130412,8164,8164,0,0,0,8164,8164,0,0,0,0,4
1253,y1403,20130415,8164,8164,8028,8028,8028,8028,8028,-136,-136,2,160560,4
1254,y1403,20130416,8028,8028,7792,7792,7792,7792,7792,-236,-236,2,155840,4
1255,y1403,20130417,7792,7792,0,0,0,7792,7792,0,0,0,0,4
1256,y1403,20130418,7792,7792,0,0,0,7742,7742,-50,-50,0,0,4
1257,y1403,20130419,7742,7742,0,0,0,7776,7776,34,34,0,0,4
1258,y1403,20130422,7776,7776,0,0,0,7776,7776,0,0,0,0,4
1259,y1403,20130423,7776,7776,7638,7700,7638,7700,7668,-76,-108,4,306760,4
1260,y1403,20130424,7700,7668,0,0,0,7668,7668,0,0,0,0,4
1261,y1403,20130425,7668,7668,0,0,0,7668,7668,0,0,0,0,4
1262,y1403,20130426,7668,7668,0,0,0,7668,7668,0,0,0,0,4
1263,y1403,20130502,7668,7668,0,0,0,7668,7668,0,0,0,0,4
1264,y1403,20130503,7668,7668,0,0,0,7714,7714,46,46,0,0,4
1265,y1403,20130506,7714,7714,0,0,0,7806,7806,92,92,0,0,4
1266,y1403,20130507,7806,7806,7782,7782,7782,7782,7782,-24,-24,2,155640,4
1267,y1403,20130508,7782,7782,7624,7624,7616,7616,7618,-166,-164,6,457120,6
1268,y1403,20130509,7616,7618,0,0,0,7604,7604,-14,-14,0,0,6
1269,y1403,20130510,7604,7604,0,0,0,7622,7622,18,18,0,0,6
1270,y1403,20130513,7622,7622,0,0,0,7668,7668,46,46,0,0,6
1271,y1403,20130514,7668,7668,7782,7782,7782,7782,7782,114,114,2,155640,8
1272,y1403,20130515,7782,7782,7668,7668,7668,7668,7668,-114,-114,2,153360,10
1273,y1403,20130516,7668,7668,7714,7714,7608,7698,7684,30,16,16,1229680,8
1274,y1403,20130517,7698,7684,7724,7724,7724,7724,7724,40,40,2,154480,8
1275,y1403,20130520,7724,7724,7906,7906,7760,7770,7806,46,82,12,936800,8
1276,y1403,20130521,7770,7806,7842,7842,7842,7842,7842,36,36,6,470520,8
1277,y1403,20130522,7842,7842,0,0,0,7916,7916,74,74,0,0,8
1278,y1403,20130523,7916,7916,0,0,0,7900,7900,-16,-16,0,0,8
1279,y1403,20130524,7900,7900,7802,7802,7802,7802,7802,-98,-98,2,156040,8
1280,y1403,20130527,7802,7802,0,0,0,7766,7766,-36,-36,0,0,8
1281,y1403,20130528,7766,7766,0,0,0,7766,7766,0,0,0,0,8
1282,y1403,20130529,7766,7766,0,0,0,7766,7766,0,0,0,0,8
1283,y1403,20130530,7766,7766,7778,7778,7778,7778,7778,12,12,2,155560,8
1284,y1403,20130531,7778,7778,0,0,0,7778,7778,0,0,0,0,8
1285,y1403,20130603,7778,7778,0,0,0,7820,7820,42,42,0,0,8
1286,y1403,20130604,7820,7820,0,0,0,7728,7728,-92,-92,0,0,8
1287,y1403,20130605,7728,7728,0,0,0,7688,7688,-40,-40,0,0,8
1288,y1403,20130606,7688,7688,7674,7676,7662,7676,7668,-12,-20,10,766920,8
1289,y1403,20130607,7676,7668,7736,7736,7630,7692,7684,24,16,14,1075800,10
1290,y1403,20130613,7692,7684,0,0,0,7684,7684,0,0,0,0,10
1291,y1403,20130614,7684,7684,7782,7782,7596,7628,7664,-56,-20,8,613160,10
1292,y1403,20130617,7628,7664,7660,7660,7660,7660,7660,-4,-4,2,153200,10
1293,y1403,20130618,7660,7660,7710,7710,7710,7710,7710,50,50,2,154200,8
1294,y1403,20130619,7710,7710,0,0,0,7672,7672,-38,-38,0,0,8
1295,y1403,20130620,7672,7672,0,0,0,7708,7708,36,36,0,0,8
1296,y1403,20130621,7708,7708,7656,7656,7500,7536,7534,-172,-174,24,1808160,8
1297,y1403,20130624,7536,7534,7470,7470,7412,7412,7432,-122,-102,8,594600,8
1298,y1403,20130625,7412,7432,0,0,0,7422,7422,-10,-10,0,0,8
1299,y1403,20130626,7422,7422,7422,7480,7300,7408,7382,-14,-40,36,2657520,6
1300,y1403,20130627,7408,7382,0,0,0,7382,7382,0,0,0,0,6
1301,y1403,20130628,7382,7382,7336,7364,7326,7360,7348,-22,-34,18,1322760,6
1302,y1403,20130701,7360,7348,0,0,0,7390,7390,42,42,0,0,6
1303,y1403,20130702,7390,7390,7350,7390,7350,7390,7370,0,-20,4,294800,6
1304,y1403,20130703,7390,7370,0,0,0,7344,7344,-26,-26,0,0,6
1305,y1403,20130704,7344,7344,0,0,0,7356,7356,12,12,0,0,6
1306,y1403,20130705,7356,7356,7286,7334,7286,7334,7310,-22,-46,4,292400,4
1307,y1403,20130708,7334,7310,7240,7240,7240,7240,7240,-70,-70,2,144800,6
1308,y1403,20130709,7240,7240,7312,7312,7312,7312,7312,72,72,2,146240,4
1309,y1403,20130710,7312,7312,0,0,0,7306,7306,-6,-6,0,0,4
1310,y1403,20130711,7306,7306,7334,7334,7334,7334,7334,28,28,2,146680,6
1311,y1403,20130712,7334,7334,7434,7434,7294,7294,7364,-40,30,4,294560,8
1312,y1403,20130715,7294,7364,7356,7356,7212,7236,7246,-128,-118,24,1739200,6
1313,y1403,20130716,7236,7246,0,0,0,7240,7240,-6,-6,0,0,6
1314,y1403,20130717,7240,7240,0,0,0,7292,7292,52,52,0,0,6
1315,y1403,20130718,7292,7292,7268,7268,7268,7268,7268,-24,-24,2,145360,6
1316,y1403,20130719,7268,7268,7246,7246,7246,7246,7246,-22,-22,2,144920,4
1317,y1403,20130722,7246,7246,0,0,0,7248,7248,2,2,0,0,4
1318,y1403,20130723,7248,7248,0,0,0,7248,7248,0,0,0,0,4
1319,y1403,20130724,7248,7248,7320,7320,7320,7320,7320,72,72,2,146400,6
1320,y1403,20130725,7320,7320,0,0,0,7238,7238,-82,-82,0,0,6
1321,y1403,20130726,7238,7238,0,0,0,7106,7106,-132,-132,0,0,6
1322,y1403,20130729,7106,7106,6998,7048,6998,7048,7022,-58,-84,16,1123680,12
1323,y1403,20130730,7048,7022,6986,6986,6976,6976,6980,-46,-42,4,279240,8
1324,y1403,20130731,6976,6980,7050,7050,6996,6996,7022,16,42,4,280920,10
1325,y1403,20130801,6996,7022,7032,7080,7032,7036,7042,14,20,40,2816960,18
1326,y1403,20130802,7036,7042,7032,7048,7032,7048,7040,6,-2,4,281600,18
1327,y1403,20130805,7048,7040,0,0,0,7018,7018,-22,-22,0,0,18
1328,y1403,20130806,7018,7018,6930,7038,6930,7038,6984,20,-34,6,419120,18
1329,y1403,20130807,7038,6984,6994,6994,6980,6980,6986,-4,2,14,978040,10
1330,y1403,20130808,6980,6986,6924,6970,6902,6902,6926,-84,-60,14,969880,16
1331,y1403,20130809,6902,6926,0,0,0,6926,6926,0,0,0,0,16
1332,y1403,20130812,6926,6926,0,0,0,6926,6926,0,0,0,0,16
1333,y1403,20130813,6926,6926,7084,7152,7084,7152,7118,226,192,4,284720,16
1334,y1403,20130814,7152,7118,7122,7122,7122,7122,7122,4,4,2,142440,16
1335,y1403,20130815,7122,7122,0,0,0,7122,7122,0,0,0,0,16
1336,y1403,20130816,7122,7122,7220,7298,7220,7298,7246,176,124,6,434760,14
1337,y1403,20130819,7298,7246,7242,7352,7204,7278,7280,32,34,1034,75285240,226
1338,y1403,20130820,7278,7280,7262,7262,7176,7176,7210,-104,-70,22,1586200,212
1339,y1403,20130821,7176,7210,7216,7216,7170,7174,7204,-36,-6,50,3602560,246
1340,y1403,20130822,7174,7204,7168,7174,7114,7114,7138,-90,-66,16,1142200,242
1341,y1403,20130823,7114,7138,7126,7132,7122,7122,7128,-16,-10,18,1283200,240
1342,y1403,20130826,7122,7128,7250,7412,7250,7412,7320,284,192,84,6149440,208
1343,y1403,20130827,7412,7320,7414,7442,7408,7428,7424,108,104,156,11583920,194
1344,y1403,20130828,7428,7424,7414,7414,7362,7362,7392,-62,-32,38,2809400,194
1345,y1403,20130829,7362,7392,0,0,0,7268,7268,-124,-124,0,0,194
1346,y1403,20130830,7268,7268,7202,7222,7158,7192,7198,-76,-70,10,719920,188
1347,y1403,20130902,7192,7198,7276,7294,7210,7292,7268,94,70,14,1017760,184
1348,y1403,20130903,7292,7268,7304,7304,7304,7304,7304,36,36,12,876480,178
1349,y1403,20130904,7304,7304,7228,7244,7228,7244,7232,-60,-72,8,578560,170
1350,y1403,20130905,7244,7232,7190,7220,7190,7204,7206,-28,-26,30,2161960,142
1351,y1403,20130906,7204,7206,7234,7320,7234,7320,7286,114,80,6,437200,144
1352,y1403,20130909,7320,7286,0,0,0,7286,7286,0,0,0,0,144
1353,y1403,20130910,7286,7286,0,0,0,7286,7286,0,0,0,0,144
1354,y1403,20130911,7286,7286,7272,7272,7272,7272,7272,-14,-14,2,145440,146
1355,y1403,20130912,7272,7272,7230,7230,7230,7230,7230,-42,-42,2,144600,144
1356,y1403,20130913,7230,7230,7298,7298,7222,7222,7238,-8,8,24,1737320,126
1357,y1403,20130916,7222,7238,7146,7146,7122,7122,7138,-116,-100,8,571120,128
1358,y1403,20130917,7122,7138,7096,7118,7096,7118,7106,-20,-32,16,1137000,124
1359,y1403,20130918,7118,7106,7086,7086,7086,7086,7086,-20,-20,2,141720,124
1360,y1403,20130923,7086,7086,7050,7050,7050,7050,7050,-36,-36,2,141000,124
1361,y1403,20130924,7050,7050,0,0,0,7106,7106,56,56,0,0,124
1362,y1403,20130925,7106,7106,7086,7086,7086,7086,7086,-20,-20,2,141720,124
1363,y1403,20130926,7086,7086,0,0,0,7060,7060,-26,-26,0,0,124
1364,y1403,20130927,7060,7060,0,0,0,7060,7060,0,0,0,0,124
1365,y1403,20130930,7060,7060,0,0,0,7018,7018,-42,-42,0,0,124
1366,y1403,20131008,7018,7018,6990,6990,6990,6990,6990,-28,-28,2,139800,124
1367,y1403,20131009,6990,6990,7008,7044,6980,6980,7008,-10,18,82,5746760,124
1368,y1403,20131010,6980,7008,6998,7022,6998,7022,7018,14,10,24,1684400,124
1369,y1403,20131011,7022,7018,7064,7116,7038,7116,7048,98,30,20,1409920,124
1370,y1403,20131014,7116,7048,6960,7036,6960,7008,7000,-40,-48,24,1680320,128
1371,y1403,20131015,7008,7000,7038,7090,7008,7066,7042,66,42,30,2113040,128
1372,y1403,20131016,7066,7042,7072,7100,7044,7076,7070,34,28,66,4666840,122
1373,y1403,20131017,7076,7070,7108,7180,7108,7150,7136,80,66,68,4853520,126
1374,y1403,20131018,7150,7136,7170,7192,7100,7142,7132,6,-4,144,10272120,124
1375,y1403,20131021,7142,7132,7200,7260,7194,7260,7218,128,86,92,6641360,126
1376,y1403,20131022,7260,7218,7240,7240,7172,7180,7194,-38,-24,24,1726880,130
1377,y1403,20131023,7180,7194,7220,7250,7130,7198,7196,4,2,36,2590600,126
1378,y1403,20131024,7198,7196,7208,7208,7150,7202,7180,6,-16,32,2298080,126
1379,y1403,20131025,7202,7180,7158,7190,7122,7190,7160,10,-20,36,2577960,122
1380,y1403,20131028,7190,7160,7102,7128,7088,7104,7104,-56,-56,32,2273840,126
1381,y1403,20131029,7104,7104,7104,7104,7060,7060,7076,-44,-28,14,990840,124
1382,y1403,20131030,7060,7076,7158,7236,7118,7172,7186,96,110,64,4599360,122
1383,y1403,20131031,7172,7186,7214,7224,7158,7186,7186,0,0,156,11210720,124
1384,y1403,20131101,7186,7186,7190,7268,7176,7268,7210,82,24,146,10528200,128
1385,y1403,20131104,7268,7210,7258,7294,7238,7260,7264,50,54,104,7556280,128
1386,y1403,20131105,7260,7264,7226,7240,7194,7240,7216,-24,-48,54,3896640,124
1387,y1403,20131106,7240,7216,7228,7228,7180,7188,7198,-28,-18,30,2159400,124
1388,y1403,20131107,7188,7198,7208,7300,7150,7202,7188,4,-10,36,2588120,128
1389,y1403,20131108,7202,7188,7162,7176,7140,7170,7156,-18,-32,34,2433080,128
1390,y1403,20131111,7170,7156,7202,7202,7132,7140,7154,-16,-2,12,858520,128
1391,y1403,20131112,7140,7154,7104,7176,7104,7176,7152,22,-2,42,3004160,128
1392,y1403,20131113,7176,7152,7226,7226,7174,7198,7186,46,34,58,4168040,130
1393,y1403,20131114,7198,7186,7186,7266,7186,7256,7224,70,38,62,4479720,124
1394,y1403,20131115,7256,7224,7254,7300,7244,7300,7262,76,38,34,2469520,122
1395,y1403,20131118,7300,7262,7216,7220,7172,7220,7194,-42,-68,26,1870440,124
1396,y1403,20131119,7220,7194,7194,7200,7112,7196,7148,2,-46,56,4003160,130
1397,y1403,20131120,7196,7148,7170,7230,7152,7230,7162,82,14,36,2578640,126
1398,y1403,20131121,7230,7162,7200,7254,7166,7236,7218,74,56,60,4331680,130
1399,y1403,20131122,7236,7218,7322,7360,7280,7282,7308,64,90,60,4385960,128
1400,y1403,20131125,7282,7308,7350,7350,7230,7264,7236,-44,-72,222,16064760,332
1401,y1403,20131126,7264,7236,7258,7314,7228,7228,7272,-8,36,236,17164600,130
1402,y1403,20131127,7228,7272,7280,7298,7216,7278,7246,6,-26,30,2174080,126
1403,y1403,20131128,7278,7246,7270,7270,7238,7254,7252,8,6,18,1305480,130
1404,y1403,20131129,7254,7252,7280,7304,7248,7296,7282,44,30,80,5826280,124
1405,y1403,20131202,7296,7282,7314,7340,7280,7300,7302,18,20,94,6865680,136
1406,y1403,20131203,7300,7302,7278,7298,7248,7248,7274,-54,-28,22,1600600,126
1407,y1403,20131204,7248,7274,7270,7270,7228,7264,7242,-10,-32,28,2028000,126
1408,y1403,20131205,7264,7242,7280,7280,7224,7250,7250,8,8,100,7251120,180
1409,y1403,20131206,7250,7250,7224,7226,7190,7220,7214,-30,-36,52,3752000,136
1410,y1403,20131209,7220,7214,7236,7244,7208,7234,7230,20,16,56,4049520,150
1411,y1403,20131210,7234,7230,7204,7232,7186,7196,7210,-34,-20,46,3317280,140
1412,y1403,20131211,7196,7210,7176,7238,7176,7228,7200,18,-10,36,2592360,142
1413,y1403,20131212,7228,7200,7238,7240,7238,7240,7238,40,38,4,289560,140
1414,y1403,20131213,7240,7238,7116,7160,7116,7130,7128,-108,-110,22,1568520,154
1415,y1403,20131216,7130,7128,7128,7128,6946,6946,7036,-182,-92,16,1125920,154
1416,y1403,20131217,6946,7036,6918,7066,6916,7066,7020,30,-16,46,3229720,148
1417,y1403,20131218,7066,7020,7048,7048,6970,6970,6988,-50,-32,8,559160,148
1418,y1403,20131219,6970,6988,7056,7056,6996,7012,7006,24,18,108,7567480,88
1419,y1403,20131220,7012,7006,0,0,0,7006,7006,0,0,0,0,88
1420,y1403,20131223,7006,7006,7028,7028,6998,6998,7020,-8,14,8,561640,82
1421,y1403,20131224,6998,7020,6988,6992,6934,6946,6966,-74,-54,18,1253920,82
1422,y1403,20131225,6946,6966,6970,6970,6884,6884,6932,-82,-34,6,416000,82
1423,y1403,20131226,6884,6932,6934,6934,6934,6934,6934,2,2,2,138680,80
1424,y1403,20131227,6934,6934,6910,6910,6910,6910,6910,-24,-24,2,138200,78
1425,y1403,20131230,6910,6910,6846,6976,6846,6954,6932,44,22,8,554600,76
1426,y1403,20131231,6954,6932,0,0,0,6874,6874,-58,-58,0,0,76
1427,y1405,20130517,7720,7706,7720,7804,7720,7796,7772,90,66,1642,127647320,2450
1428,y1405,20130520,7796,7772,7800,7818,7750,7800,7790,28,18,1188,92547560,2668
1429,y1405,20130521,7800,7790,7778,7800,7718,7760,7764,-30,-26,1398,108553120,2800
1430,y1405,20130522,7760,7764,7780,7860,7776,7846,7830,82,66,1198,93808320,2978
1431,y1405,20130523,7846,7830,7860,7874,7782,7782,7818,-48,-12,840,65679040,2952
1432,y1405,20130524,7782,7818,7796,7870,7706,7808,7826,-10,8,7590,594093160,7762
1433,y1405,20130527,7808,7826,7788,7796,7758,7770,7770,-56,-56,4950,384641880,12032
1434,y1405,20130528,7770,7770,7792,7806,7728,7754,7744,-16,-26,7918,613312120,15870
1435,y1405,20130529,7754,7744,7760,7866,7760,7790,7802,46,58,7288,568630880,17904
1436,y1405,20130530,7790,7802,7748,7756,7694,7732,7722,-70,-80,1906,147213600,17912
1437,y1405,20130531,7732,7722,7758,7774,7708,7722,7742,0,20,1600,123884120,18030
1438,y1405,20130603,7722,7742,7752,7808,7748,7762,7772,20,30,8112,630482960,21624
1439,y1405,20130604,7762,7772,7780,7788,7648,7682,7676,-90,-96,3928,301569880,22240
1440,y1405,20130605,7682,7676,7688,7706,7634,7644,7652,-32,-24,3006,230038400,22374
1441,y1405,20130606,7644,7652,7628,7676,7572,7630,7642,-22,-10,4158,317827480,22730
1442,y1405,20130607,7630,7642,7626,7728,7584,7722,7634,80,-8,5096,389106200,20918
1443,y1405,20130613,7722,7634,7652,7760,7652,7678,7712,44,78,15340,1183111920,12674
1444,y1405,20130614,7678,7712,7646,7700,7620,7696,7648,-16,-64,12982,993092760,15556
1445,y1405,20130617,7696,7648,7664,7728,7664,7694,7692,46,44,4810,370002080,17514
1446,y1405,20130618,7694,7692,7732,7788,7712,7718,7728,26,36,16584,1281934520,27922
1447,y1405,20130619,7718,7728,7712,7726,7682,7718,7702,-10,-26,8440,650102440,23850
1448,y1405,20130620,7718,7702,7750,7774,7682,7718,7720,16,18,18482,1427078440,31906
1449,y1405,20130621,7718,7720,7672,7672,7480,7514,7588,-206,-132,15400,1168613040,30288
1450,y1405,20130624,7514,7588,7502,7502,7414,7432,7470,-156,-118,15410,1151261520,24774
1451,y1405,20130625,7432,7470,7460,7498,7416,7478,7458,8,-12,7360,548943280,26916
1452,y1405,20130626,7478,7458,7450,7502,7358,7404,7452,-54,-6,21370,1592796920,24260
1453,y1405,20130627,7404,7452,7380,7398,7324,7376,7354,-76,-98,10348,761030080,26386
1454,y1405,20130628,7376,7354,7360,7386,7336,7340,7368,-14,14,10100,744192240,26806
1455,y1405,20130701,7340,7368,7400,7434,7318,7410,7382,42,14,15090,1114021200,30684
1456,y1405,20130702,7410,7382,7400,7450,7366,7388,7416,6,34,23218,1721918840,39034
1457,y1405,20130703,7388,7416,7378,7418,7338,7346,7372,-70,-44,26558,1958263200,50532
1458,y1405,20130704,7346,7372,7372,7410,7358,7376,7392,4,20,10432,771265920,50942
1459,y1405,20130705,7376,7392,7380,7380,7318,7350,7336,-42,-56,6036,442910560,48528
1460,y1405,20130708,7350,7336,7370,7398,7252,7278,7320,-58,-16,18246,1335651400,46842
1461,y1405,20130709,7278,7320,7300,7330,7294,7308,7312,-12,-8,6794,496911600,48022
1462,y1405,20130710,7308,7312,7320,7368,7270,7326,7312,14,0,13530,989371960,44760
1463,y1405,20130711,7326,7312,7336,7440,7334,7388,7382,76,70,17632,1301839040,49930
1464,y1405,20130712,7388,7382,7352,7368,7304,7316,7326,-66,-56,10042,735701840,48422
1465,y1405,20130715,7316,7326,7314,7314,7186,7194,7226,-132,-100,26246,1896641000,56368
1466,y1405,20130716,7194,7226,7212,7236,7186,7224,7212,-2,-14,20918,1508860080,61772
1467,y1405,20130717,7224,7212,7240,7310,7186,7252,7260,40,48,13518,981551000,61900
1468,y1405,20130718,7252,7260,7202,7288,7202,7272,7244,12,-16,13970,1012210560,66034
1469,y1405,20130719,7272,7244,7276,7286,7220,7232,7244,-12,0,23768,1721926800,70448
1470,y1405,20130722,7232,7244,7244,7288,7208,7276,7252,32,8,73472,5329326920,88316
1471,y1405,20130723,7276,7252,7252,7356,7252,7348,7316,96,64,43542,3185673600,92842
1472,y1405,20130724,7348,7316,7270,7306,7254,7290,7282,-26,-34,28256,2058066800,99700
1473,y1405,20130725,7290,7282,7246,7248,7172,7186,7214,-96,-68,36708,2648502000,108726
1474,y1405,20130726,7186,7214,7156,7172,7000,7020,7072,-194,-142,51518,3644182760,123360
1475,y1405,20130729,7020,7072,7032,7052,6988,7016,7014,-56,-58,40080,2811937920,132248
1476,y1405,20130730,7016,7014,6978,7012,6934,6994,6972,-20,-42,50234,3502805000,137576
1477,y1405,20130731,6994,6972,6950,7076,6950,7044,7034,72,62,44658,3141250280,145030
1478,y1405,20130801,7044,7034,7030,7072,7018,7036,7044,2,10,25568,1801020520,144268
1479,y1405,20130802,7036,7044,7056,7084,7026,7072,7062,28,18,32022,2261979040,146714
1480,y1405,20130805,7072,7062,7040,7072,7016,7026,7044,-36,-18,32690,2303322840,147880
1481,y1405,20130806,7026,7044,7042,7070,7030,7032,7048,-12,4,33840,2385451600,150320
1482,y1405,20130807,7032,7048,7000,7000,6910,6914,6948,-134,-100,63586,4418834160,166930
1483,y1405,20130808,6914,6948,6910,6968,6910,6938,6942,-10,-6,49020,3403761400,166324
1484,y1405,20130809,6938,6942,6938,7008,6938,6956,6980,14,38,43170,3013928360,168782
1485,y1405,20130812,6956,6980,6950,7028,6942,7012,6988,32,8,59484,4157913720,173180
1486,y1405,20130813,7012,6988,7100,7222,7076,7196,7172,208,184,83532,5991037080,182908
1487,y1405,20130814,7196,7172,7174,7208,7122,7124,7162,-48,-10,69780,4998126480,186216
1488,y1405,20130815,7124,7162,7140,7198,7140,7170,7174,8,12,52848,3791848880,186656
1489,y1405,20130816,7170,7174,7250,7328,7220,7222,7272,48,98,80388,5845849840,198760
1490,y1405,20130819,7222,7272,7282,7310,7256,7274,7280,2,8,58594,4266413080,204198
1491,y1405,20130820,7274,7280,7310,7328,7160,7184,7230,-96,-50,77390,5595737400,202142
1492,y1405,20130821,7184,7230,7170,7204,7142,7154,7170,-76,-60,70780,5076023360,225980
1493,y1405,20130822,7154,7170,7136,7170,7084,7108,7122,-62,-48,93790,6680549840,250160
1494,y1405,20130823,7108,7122,7086,7102,7070,7092,7086,-30,-36,115852,8209992600,261568
1495,y1405,20130826,7092,7086,7224,7368,7222,7368,7326,282,240,135494,9927158280,259974
1496,y1405,20130827,7368,7326,7440,7456,7342,7370,7368,44,42,189054,13933014960,304756
1497,y1405,20130828,7370,7368,7360,7384,7290,7292,7354,-76,-14,150342,11058075160,326620
1498,y1405,20130829,7292,7354,7326,7326,7066,7186,7228,-168,-126,195544,14134020880,344400
1499,y1405,20130830,7186,7228,7164,7188,7112,7154,7146,-74,-82,130126,9301215640,326768
1500,y1405,20130902,7154,7146,7180,7286,7176,7284,7250,138,104,140054,10156027080,332072
1501,y1405,20130903,7284,7250,7310,7342,7222,7288,7280,38,30,166698,12137176560,339164
1502,y1405,20130904,7288,7280,7228,7234,7160,7184,7196,-96,-84,153862,11072268800,344998
1503,y1405,20130905,7184,7196,7166,7226,7166,7184,7192,-12,-4,118804,8546406000,355368
1504,y1405,20130906,7184,7192,7202,7314,7182,7314,7258,122,66,229948,16692313320,358778
1505,y1405,20130909,7314,7258,7330,7360,7306,7340,7336,82,78,208428,15290499520,397402
1506,y1405,20130910,7340,7336,7250,7260,7164,7200,7220,-136,-116,284704,20561213480,400110
1507,y1405,20130911,7200,7220,7238,7240,7188,7234,7210,14,-10,173684,12525872960,390756
1508,y1405,20130912,7234,7210,7228,7248,7200,7210,7224,0,14,150500,10872426040,392442
1509,y1405,20130913,7210,7224,7262,7300,7184,7214,7230,-10,6,258668,18704634080,372338
1510,y1405,20130916,7214,7230,7106,7154,7086,7088,7128,-142,-102,147084,10484608680,376878
1511,y1405,20130917,7088,7128,7088,7118,7070,7108,7094,-20,-34,130478,9258068760,376552
1512,y1405,20130918,7108,7094,7108,7128,7064,7084,7094,-10,0,111006,7876515240,375114
1513,y1405,20130923,7084,7094,7050,7054,7012,7040,7032,-54,-62,97700,6870701720,384850
1514,y1405,20130924,7040,7032,7056,7092,7042,7072,7070,40,38,136506,9653596200,405912
1515,y1405,20130925,7072,7070,7060,7084,7032,7046,7056,-24,-14,99478,7020255440,405658
1516,y1405,20130926,7046,7056,7048,7060,7008,7038,7036,-18,-20,109002,7669947440,402736
1517,y1405,20130927,7038,7036,7036,7050,6960,6962,6996,-74,-40,182382,12760047000,413508
1518,y1405,20130930,6962,6996,6940,6966,6896,6924,6930,-72,-66,149990,10395187280,424682
1519,y1405,20131008,6924,6930,6858,7006,6858,6944,6946,14,16,217672,15123571160,465884
1520,y1405,20131009,6944,6946,6960,7008,6948,6968,6978,22,32,237242,16556898800,510050
1521,y1405,20131010,6968,6978,6986,7032,6954,7022,6988,44,10,263708,18428669680,504062
1522,y1405,20131011,7022,6988,7046,7060,6994,7006,7026,18,38,251004,17635709000,516410
1523,y1405,20131014,7006,7026,6958,7032,6958,7014,7002,-12,-24,241866,16937214160,544262
1524,y1405,20131015,7014,7002,7030,7080,6996,7074,7044,72,42,494534,34837036120,556978
1525,y1405,20131016,7074,7044,7080,7120,7058,7086,7084,42,40,483820,34275682680,589928
1526,y1405,20131017,7086,7084,7142,7204,7114,7166,7160,82,76,629744,45093544400,605730
1527,y1405,20131018,7166,7160,7148,7174,7120,7168,7150,8,-10,547026,39113194280,662904
1528,y1405,20131021,7168,7150,7216,7290,7216,7258,7254,108,104,683474,49589171120,673942
1529,y1405,20131022,7258,7254,7242,7248,7162,7176,7202,-78,-52,620186,44669197440,701774
1530,y1405,20131023,7176,7202,7208,7236,7152,7216,7196,14,-6,782212,56289870360,712810
1531,y1405,20131024,7216,7196,7216,7226,7168,7202,7194,6,-2,753958,54246264160,720336
1532,y1405,20131025,7202,7194,7160,7204,7130,7136,7170,-58,-24,686502,49225171480,724890
1533,y1405,20131028,7136,7170,7120,7144,7108,7130,7126,-40,-44,449000,32003755960,726666
1534,y1405,20131029,7130,7126,7098,7122,7026,7056,7072,-70,-54,733358,51871676760,733876
1535,y1405,20131030,7056,7072,7108,7268,7106,7214,7198,142,126,1572360,1.13183E+11,794758
1536,y1405,20131031,7214,7198,7200,7240,7182,7212,7212,14,14,927544,66898946360,794088
1537,y1405,20131101,7212,7212,7206,7308,7200,7302,7250,90,38,1212654,87918919240,873958
1538,y1405,20131104,7302,7250,7278,7330,7278,7326,7300,76,50,1026830,74961905200,876050
1539,y1405,20131105,7326,7300,7282,7296,7222,7268,7258,-32,-42,859856,62422474840,840478
1540,y1405,20131106,7268,7258,7248,7252,7202,7206,7224,-52,-34,673480,48663796320,833086
1541,y1405,20131107,7206,7224,7200,7226,7178,7202,7202,-22,-22,601214,43302896920,824642
1542,y1405,20131108,7202,7202,7176,7190,7140,7160,7166,-42,-36,651058,46666368000,826814
1543,y1405,20131111,7160,7166,7160,7212,7128,7130,7152,-36,-14,680648,48689948720,843238
1544,y1405,20131112,7130,7152,7142,7196,7110,7188,7148,36,-4,751712,53739354600,856474
1545,y1405,20131113,7188,7148,7226,7236,7192,7222,7212,74,64,750210,54117813320,808804
1546,y1405,20131114,7222,7212,7224,7296,7224,7282,7252,70,40,852508,61828180400,845856
1547,y1405,20131115,7282,7252,7272,7324,7250,7256,7286,4,34,947296,69036501920,815804
1548,y1405,20131118,7256,7286,7212,7228,7174,7178,7200,-108,-86,729808,52554375680,828764
1549,y1405,20131119,7178,7200,7172,7188,7146,7156,7166,-44,-34,769766,55168589680,845130
1550,y1405,20131120,7156,7166,7152,7186,7138,7184,7162,18,-4,699338,50092928840,838808
1551,y1405,20131121,7184,7162,7188,7288,7184,7272,7242,110,80,1134932,82211984360,873010
1552,y1405,20131122,7272,7242,7378,7384,7300,7302,7342,60,100,1004284,73746858480,875812
1553,y1405,20131125,7302,7342,7312,7352,7292,7314,7320,-28,-22,788588,57730945440,892304
1554,y1405,20131126,7314,7320,7290,7314,7234,7240,7276,-80,-44,863778,62849742920,872344
1555,y1405,20131127,7240,7276,7234,7276,7224,7274,7250,-2,-26,654262,47442152360,877760
1556,y1405,20131128,7274,7250,7240,7282,7230,7254,7256,4,6,684364,49660725360,875424
1557,y1405,20131129,7254,7256,7266,7334,7256,7330,7292,74,36,835558,60937179640,917300
1558,y1405,20131202,7330,7292,7324,7362,7312,7316,7328,24,36,950454,69661487840,927080
1559,y1405,20131203,7316,7328,7318,7322,7262,7264,7294,-64,-34,938256,68450962640,912320
1560,y1405,20131204,7264,7294,7244,7278,7240,7262,7256,-32,-38,663668,48165602520,916540
1561,y1405,20131205,7262,7256,7284,7306,7202,7204,7266,-52,10,885256,64324661760,903448
1562,y1405,20131206,7204,7266,7236,7242,7190,7232,7220,-34,-46,812380,58668476880,888868
1563,y1405,20131209,7232,7220,7238,7258,7208,7222,7230,2,10,705604,51025926320,863636
1564,y1405,20131210,7222,7230,7210,7232,7184,7228,7210,-2,-20,581402,41928748160,854764
1565,y1405,20131211,7228,7210,7216,7264,7198,7254,7234,44,24,712480,51550069680,867586
1566,y1405,20131212,7254,7234,7254,7272,7190,7196,7226,-38,-8,724798,52380325200,858206
1567,y1405,20131213,7196,7226,7170,7170,7040,7044,7098,-182,-128,861400,61155343160,870672
1568,y1405,20131216,7044,7098,7066,7074,7002,7006,7036,-92,-62,726966,51160528280,899480
1569,y1405,20131217,7006,7036,7028,7054,7010,7022,7034,-14,-2,698692,49148695880,877380
1570,y1405,20131218,7022,7034,6982,7010,6930,7008,6962,-26,-72,790586,55047283280,863694
1571,y1405,20131219,7008,6962,6986,7016,6950,6952,6986,-10,24,642444,44884094040,868940
1572,y1405,20131220,6952,6986,6978,7004,6956,6960,6978,-26,-8,609588,42539918480,874968
1573,y1405,20131223,6960,6978,6986,7008,6926,6982,6974,4,-4,757250,52817869240,826172
1574,y1405,20131224,6982,6974,6962,6976,6914,6940,6946,-34,-28,574462,39912729520,834868
1575,y1405,20131225,6940,6946,6944,6952,6864,6882,6910,-64,-36,635470,43913818200,861044
1576,y1405,20131226,6882,6910,6882,6896,6856,6874,6876,-36,-34,499348,34341966880,878616
1577,y1405,20131227,6874,6876,6852,6928,6842,6922,6890,46,14,557200,38401970200,867086
1578,y1405,20131230,6922,6890,6920,6974,6894,6908,6930,18,40,604936,41927274680,821852
1579,y1405,20131231,6908,6930,6878,6894,6842,6850,6866,-80,-64,430684,29572557800,835414
1580,y1407,20130716,7280,7280,0,0,0,7280,7280,0,0,0,0,0
1581,y1407,20130717,7280,7280,0,0,0,7280,7280,0,0,0,0,0
1582,y1407,20130718,7280,7280,0,0,0,7264,7264,-16,-16,0,0,0
1583,y1407,20130719,7264,7264,0,0,0,7264,7264,0,0,0,0,0
1584,y1407,20130722,7264,7264,0,0,0,7272,7272,8,8,0,0,0
1585,y1407,20130723,7272,7272,7444,7444,7156,7272,7316,0,44,10,731720,0
1586,y1407,20130724,7272,7316,0,0,0,7284,7284,-32,-32,0,0,0
1587,y1407,20130725,7284,7284,0,0,0,7216,7216,-68,-68,0,0,0
1588,y1407,20130726,7216,7216,0,0,0,7074,7074,-142,-142,0,0,0
1589,y1407,20130729,7074,7074,0,0,0,7016,7016,-58,-58,0,0,0
1590,y1407,20130730,7016,7016,0,0,0,6974,6974,-42,-42,0,0,0
1591,y1407,20130731,6974,6974,0,0,0,7036,7036,62,62,0,0,0
1592,y1407,20130801,7036,7036,0,0,0,7046,7046,10,10,0,0,0
1593,y1407,20130802,7046,7046,0,0,0,7064,7064,18,18,0,0,0
1594,y1407,20130805,7064,7064,0,0,0,7046,7046,-18,-18,0,0,0
1595,y1407,20130806,7046,7046,0,0,0,7046,7046,0,0,0,0,0
1596,y1407,20130807,7046,7046,0,0,0,7046,7046,0,0,0,0,0
1597,y1407,20130808,7046,7046,0,0,0,7046,7046,0,0,0,0,0
1598,y1407,20130809,7046,7046,0,0,0,7084,7084,38,38,0,0,0
1599,y1407,20130812,7084,7084,7100,7100,7100,7100,7100,16,16,2,142000,2
1600,y1407,20130813,7100,7100,0,0,0,7286,7286,186,186,0,0,2
1601,y1407,20130814,7286,7286,7222,7222,7222,7222,7222,-64,-64,2,144440,2
1602,y1407,20130815,7222,7222,0,0,0,7234,7234,12,12,0,0,2
1603,y1407,20130816,7234,7234,7260,7408,7260,7408,7334,174,100,4,293360,4
1604,y1407,20130819,7408,7334,0,0,0,7342,7342,8,8,0,0,4
1605,y1407,20130820,7342,7342,0,0,0,7292,7292,-50,-50,0,0,4
1606,y1407,20130821,7292,7292,7226,7274,7212,7212,7230,-80,-62,10,723080,6
1607,y1407,20130822,7212,7230,0,0,0,7182,7182,-48,-48,0,0,6
1608,y1407,20130823,7182,7182,7040,7178,7040,7100,7132,-82,-50,36,2567720,10
1609,y1407,20130826,7100,7132,7312,7400,7312,7400,7378,268,246,8,590240,4
1610,y1407,20130827,7400,7378,0,0,0,7378,7378,0,0,0,0,4
1611,y1407,20130828,7378,7378,0,0,0,7364,7364,-14,-14,0,0,4
1612,y1407,20130829,7364,7364,0,0,0,7364,7364,0,0,0,0,4
1613,y1407,20130830,7364,7364,0,0,0,7282,7282,-82,-82,0,0,4
1614,y1407,20130902,7282,7282,0,0,0,7386,7386,104,104,0,0,4
1615,y1407,20130903,7386,7386,0,0,0,7416,7416,30,30,0,0,4
1616,y1407,20130904,7416,7416,7222,7240,7222,7240,7230,-176,-186,4,289240,4
1617,y1407,20130905,7240,7230,0,0,0,7230,7230,0,0,0,0,4
1618,y1407,20130906,7230,7230,0,0,0,7230,7230,0,0,0,0,4
1619,y1407,20130909,7230,7230,7430,7430,7426,7426,7426,196,196,6,445640,10
1620,y1407,20130910,7426,7426,7292,7292,7226,7258,7260,-168,-166,14,1016640,8
1621,y1407,20130911,7258,7260,0,0,0,7250,7250,-10,-10,0,0,8
1622,y1407,20130912,7250,7250,0,0,0,7250,7250,0,0,0,0,8
1623,y1407,20130913,7250,7250,0,0,0,7250,7250,0,0,0,0,8
1624,y1407,20130916,7250,7250,0,0,0,7148,7148,-102,-102,0,0,8
1625,y1407,20130917,7148,7148,0,0,0,7148,7148,0,0,0,0,8
1626,y1407,20130918,7148,7148,7096,7192,7096,7108,7144,-40,-4,66,4715680,14
1627,y1407,20130923,7108,7144,7096,7096,7064,7064,7080,-80,-64,4,283200,14
1628,y1407,20130924,7064,7080,0,0,0,7118,7118,38,38,0,0,14
1629,y1407,20130925,7118,7118,7120,7120,7100,7100,7110,-18,-8,4,284400,16
1630,y1407,20130926,7100,7110,7088,7088,7052,7052,7076,-58,-34,14,990680,22
1631,y1407,20130927,7052,7076,7040,7040,7010,7012,7016,-64,-60,12,841960,22
1632,y1407,20130930,7012,7016,0,0,0,6950,6950,-66,-66,0,0,22
1633,y1407,20131008,6950,6950,0,0,0,6950,6950,0,0,0,0,22
1634,y1407,20131009,6950,6950,0,0,0,6950,6950,0,0,0,0,22
1635,y1407,20131010,6950,6950,7050,7050,6982,6982,7016,32,66,4,280640,22
1636,y1407,20131011,6982,7016,7016,7106,7016,7106,7060,90,44,4,282440,22
1637,y1407,20131014,7106,7060,0,0,0,7060,7060,0,0,0,0,22
1638,y1407,20131015,7060,7060,7040,7056,7040,7056,7048,-4,-12,4,281920,22
1639,y1407,20131016,7056,7048,7108,7108,7108,7108,7108,60,60,2,142160,22
1640,y1407,20131017,7108,7108,0,0,0,7184,7184,76,76,0,0,22
1641,y1407,20131018,7184,7184,7100,7100,7100,7100,7100,-84,-84,2,142000,22
1642,y1407,20131021,7100,7100,0,0,0,7202,7202,102,102,0,0,22
1643,y1407,20131022,7202,7202,0,0,0,7152,7152,-50,-50,0,0,22
1644,y1407,20131023,7152,7152,0,0,0,7148,7148,-4,-4,0,0,22
1645,y1407,20131024,7148,7148,7212,7212,7140,7196,7186,48,38,10,718600,22
1646,y1407,20131025,7196,7186,0,0,0,7186,7186,0,0,0,0,22
1647,y1407,20131028,7186,7186,0,0,0,7138,7138,-48,-48,0,0,22
1648,y1407,20131029,7138,7138,7092,7092,7092,7092,7092,-46,-46,2,141840,22
1649,y1407,20131030,7092,7092,7138,7138,7138,7138,7138,46,46,2,142760,22
1650,y1407,20131031,7138,7138,7230,7240,7176,7218,7216,80,78,14,1010240,22
1651,y1407,20131101,7218,7216,7260,7280,7234,7272,7262,56,46,14,1016880,22
1652,y1407,20131104,7272,7262,7292,7292,7292,7292,7292,30,30,2,145840,22
1653,y1407,20131105,7292,7292,0,0,0,7292,7292,0,0,0,0,22
1654,y1407,20131106,7292,7292,7262,7262,7190,7190,7226,-102,-66,4,289040,22
1655,y1407,20131107,7190,7226,0,0,0,7226,7226,0,0,0,0,22
1656,y1407,20131108,7226,7226,7228,7228,7134,7194,7174,-32,-52,30,2152640,32
1657,y1407,20131111,7194,7174,0,0,0,7172,7172,-2,-2,0,0,32
1658,y1407,20131112,7172,7172,7182,7194,7182,7194,7188,22,16,4,287520,32
1659,y1407,20131113,7194,7188,7204,7232,7204,7232,7216,44,28,14,1010240,30
1660,y1407,20131114,7232,7216,7248,7274,7234,7248,7242,32,26,16,1158880,28
1661,y1407,20131115,7248,7242,7318,7318,7292,7292,7296,50,54,10,729720,30
1662,y1407,20131118,7292,7296,7238,7238,7238,7238,7238,-58,-58,4,289520,30
1663,y1407,20131119,7238,7238,0,0,0,7204,7204,-34,-34,0,0,30
1664,y1407,20131120,7204,7204,0,0,0,7200,7200,-4,-4,0,0,30
1665,y1407,20131121,7200,7200,7248,7290,7248,7258,7262,58,62,10,726240,28
1666,y1407,20131122,7258,7262,7342,7348,7286,7286,7318,24,56,40,2927240,24
1667,y1407,20131125,7286,7318,0,0,0,7298,7298,-20,-20,0,0,24
1668,y1407,20131126,7298,7298,7304,7304,7282,7282,7292,-16,-6,16,1166880,24
1669,y1407,20131127,7282,7292,0,0,0,7266,7266,-26,-26,0,0,24
1670,y1407,20131128,7266,7266,0,0,0,7272,7272,6,6,0,0,24
1671,y1407,20131129,7272,7272,7270,7270,7252,7252,7260,-20,-12,4,290440,24
1672,y1407,20131202,7252,7260,0,0,0,7294,7294,34,34,0,0,24
1673,y1407,20131203,7294,7294,0,0,0,7262,7262,-32,-32,0,0,24
1674,y1407,20131204,7262,7262,7270,7270,7230,7230,7260,-32,-2,8,580800,26
1675,y1407,20131205,7230,7260,0,0,0,7270,7270,10,10,0,0,26
1676,y1407,20131206,7270,7270,0,0,0,7224,7224,-46,-46,0,0,26
1677,y1407,20131209,7224,7224,0,0,0,7224,7224,0,0,0,0,26
1678,y1407,20131210,7224,7224,7196,7214,7196,7214,7204,-10,-20,24,1729400,26
1679,y1407,20131211,7214,7204,7222,7222,7222,7222,7222,18,18,2,144440,24
1680,y1407,20131212,7222,7222,7246,7246,7224,7224,7234,2,12,8,578800,22
1681,y1407,20131213,7224,7234,7136,7142,7070,7070,7124,-164,-110,20,1424840,34
1682,y1407,20131216,7070,7124,7010,7058,7010,7058,7034,-66,-90,6,422080,36
1683,y1407,20131217,7058,7034,7094,7094,7080,7080,7086,46,52,4,283480,38
1684,y1407,20131218,7080,7086,6988,6988,6988,6988,6988,-98,-98,2,139760,36
1685,y1407,20131219,6988,6988,0,0,0,6988,6988,0,0,0,0,36
1686,y1407,20131220,6988,6988,6972,6972,6972,6972,6972,-16,-16,4,278880,34
1687,y1407,20131223,6972,6972,7010,7060,6972,7000,7008,28,36,18,1261560,30
1688,y1407,20131224,7000,7008,0,0,0,6980,6980,-28,-28,0,0,30
1689,y1407,20131225,6980,6980,6968,6968,6888,6888,6926,-92,-54,28,1939520,30
1690,y1407,20131226,6888,6926,6924,6924,6896,6896,6910,-30,-16,4,276400,30
1691,y1407,20131227,6896,6910,6908,6936,6908,6936,6914,26,4,8,553200,28
1692,y1407,20131230,6936,6914,6956,6956,6956,6956,6956,42,42,2,139120,28
1693,y1407,20131231,6956,6956,0,0,0,6902,6902,-54,-54,0,0,28
1694,y1408,20130816,7172,7172,7426,7426,7226,7420,7356,248,184,6,441440,2
1695,y1408,20130819,7420,7356,0,0,0,7356,7356,0,0,0,0,2
1696,y1408,20130820,7356,7356,7224,7224,7224,7224,7224,-132,-132,2,144480,4
1697,y1408,20130821,7224,7224,7246,7246,7246,7246,7246,22,22,2,144920,4
1698,y1408,20130822,7246,7246,0,0,0,7246,7246,0,0,0,0,4
1699,y1408,20130823,7246,7246,0,0,0,7246,7246,0,0,0,0,4
1700,y1408,20130826,7246,7246,7342,7534,7342,7530,7500,284,254,38,2850200,26
1701,y1408,20130827,7530,7500,7438,7488,7436,7470,7450,-30,-50,22,1639080,34
1702,y1408,20130828,7470,7450,7456,7456,7384,7384,7414,-66,-36,26,1927680,32
1703,y1408,20130829,7384,7414,7376,7418,7202,7202,7348,-212,-66,12,881760,34
1704,y1408,20130830,7202,7348,7244,7244,7192,7216,7216,-132,-132,6,433040,32
1705,y1408,20130902,7216,7216,0,0,0,7234,7234,18,18,0,0,32
1706,y1408,20130903,7234,7234,0,0,0,7300,7300,66,66,0,0,32
1707,y1408,20130904,7300,7300,0,0,0,7300,7300,0,0,0,0,32
1708,y1408,20130905,7300,7300,0,0,0,7300,7300,0,0,0,0,32
1709,y1408,20130906,7300,7300,0,0,0,7300,7300,0,0,0,0,32
1710,y1408,20130909,7300,7300,7340,7394,7316,7342,7358,42,58,20,1471880,34
1711,y1408,20130910,7342,7358,7296,7296,7208,7208,7254,-150,-104,6,435240,32
1712,y1408,20130911,7208,7254,7248,7250,7232,7250,7242,-4,-12,6,434600,32
1713,y1408,20130912,7250,7242,7214,7264,7214,7264,7238,22,-4,4,289560,32
1714,y1408,20130913,7264,7238,7390,7390,7234,7236,7292,-2,54,48,3500600,34
1715,y1408,20130916,7236,7292,7178,7206,7158,7206,7180,-86,-112,6,430840,34
1716,y1408,20130917,7206,7180,0,0,0,7180,7180,0,0,0,0,34
1717,y1408,20130918,7180,7180,0,0,0,7180,7180,0,0,0,0,34
1718,y1408,20130923,7180,7180,0,0,0,7116,7116,-64,-64,0,0,34
1719,y1408,20130924,7116,7116,0,0,0,7116,7116,0,0,0,0,34
1720,y1408,20130925,7116,7116,0,0,0,7110,7110,-6,-6,0,0,34
1721,y1408,20130926,7110,7110,0,0,0,7076,7076,-34,-34,0,0,34
1722,y1408,20130927,7076,7076,0,0,0,7018,7018,-58,-58,0,0,34
1723,y1408,20130930,7018,7018,6978,6978,6978,6978,6978,-40,-40,4,279120,34
1724,y1408,20131008,6978,6978,0,0,0,6978,6978,0,0,0,0,34
1725,y1408,20131009,6978,6978,0,0,0,6978,6978,0,0,0,0,34
1726,y1408,20131010,6978,6978,0,0,0,6978,6978,0,0,0,0,34
1727,y1408,20131011,6978,6978,7092,7092,7092,7092,7092,114,114,2,141840,34
1728,y1408,20131014,7092,7092,7050,7050,7026,7026,7038,-66,-54,4,281520,36
1729,y1408,20131015,7026,7038,7036,7052,7036,7044,7046,6,8,12,845520,32
1730,y1408,20131016,7044,7046,7090,7090,7090,7090,7090,44,44,2,141800,32
1731,y1408,20131017,7090,7090,0,0,0,7166,7166,76,76,0,0,32
1732,y1408,20131018,7166,7166,0,0,0,7084,7084,-82,-82,0,0,32
1733,y1408,20131021,7084,7084,7242,7248,7234,7248,7240,164,156,6,434480,30
1734,y1408,20131022,7248,7240,7232,7232,7232,7232,7232,-8,-8,2,144640,32
1735,y1408,20131023,7232,7232,7224,7254,7178,7178,7220,-54,-12,12,866480,30
1736,y1408,20131024,7178,7220,7204,7204,7204,7204,7204,-16,-16,2,144080,32
1737,y1408,20131025,7204,7204,7208,7208,7172,7172,7190,-32,-14,4,287600,32
1738,y1408,20131028,7172,7190,0,0,0,7146,7146,-44,-44,0,0,32
1739,y1408,20131029,7146,7146,7090,7090,7088,7088,7088,-58,-58,22,1559640,42
1740,y1408,20131030,7088,7088,7194,7194,7194,7194,7194,106,106,4,287760,42
1741,y1408,20131031,7194,7194,0,0,0,7194,7194,0,0,0,0,42
1742,y1408,20131101,7194,7194,0,0,0,7238,7238,44,44,0,0,42
1743,y1408,20131104,7238,7238,7320,7328,7284,7310,7308,72,70,20,1461640,32
1744,y1408,20131105,7310,7308,0,0,0,7308,7308,0,0,0,0,32
1745,y1408,20131106,7308,7308,0,0,0,7300,7300,-8,-8,0,0,32
1746,y1408,20131107,7300,7300,0,0,0,7300,7300,0,0,0,0,32
1747,y1408,20131108,7300,7300,0,0,0,7248,7248,-52,-52,0,0,32
1748,y1408,20131111,7248,7248,0,0,0,7248,7248,0,0,0,0,32
1749,y1408,20131112,7248,7248,0,0,0,7264,7264,16,16,0,0,32
1750,y1408,20131113,7264,7264,0,0,0,7264,7264,0,0,0,0,32
1751,y1408,20131114,7264,7264,7260,7278,7260,7278,7268,14,4,4,290760,30
1752,y1408,20131115,7278,7268,7320,7358,7320,7358,7338,90,70,8,587120,34
1753,y1408,20131118,7358,7338,0,0,0,7280,7280,-58,-58,0,0,34
1754,y1408,20131119,7280,7280,0,0,0,7246,7246,-34,-34,0,0,34
1755,y1408,20131120,7246,7246,0,0,0,7242,7242,-4,-4,0,0,34
1756,y1408,20131121,7242,7242,0,0,0,7304,7304,62,62,0,0,34
1757,y1408,20131122,7304,7304,0,0,0,7360,7360,56,56,0,0,34
1758,y1408,20131125,7360,7360,0,0,0,7338,7338,-22,-22,0,0,34
1759,y1408,20131126,7338,7338,7302,7302,7302,7302,7302,-36,-36,18,1314360,30
1760,y1408,20131127,7302,7302,0,0,0,7276,7276,-26,-26,0,0,30
1761,y1408,20131128,7276,7276,7240,7240,7240,7240,7240,-36,-36,2,144800,30
1762,y1408,20131129,7240,7240,7312,7314,7290,7314,7306,74,66,22,1607360,30
1763,y1408,20131202,7314,7306,7306,7306,7296,7296,7300,-10,-6,6,438000,32
1764,y1408,20131203,7296,7300,0,0,0,7268,7268,-32,-32,0,0,32
1765,y1408,20131204,7268,7268,0,0,0,7268,7268,0,0,0,0,32
1766,y1408,20131205,7268,7268,0,0,0,7278,7278,10,10,0,0,32
1767,y1408,20131206,7278,7278,0,0,0,7278,7278,0,0,0,0,32
1768,y1408,20131209,7278,7278,7220,7248,7220,7248,7228,-30,-50,12,867560,32
1769,y1408,20131210,7248,7228,7220,7242,7218,7218,7226,-10,-2,6,433600,32
1770,y1408,20131211,7218,7226,0,0,0,7226,7226,0,0,0,0,32
1771,y1408,20131212,7226,7226,0,0,0,7226,7226,0,0,0,0,32
1772,y1408,20131213,7226,7226,0,0,0,7064,7064,-162,-162,0,0,32
1773,y1408,20131216,7064,7064,0,0,0,7062,7062,-2,-2,0,0,32
1774,y1408,20131217,7062,7062,7086,7086,7040,7040,7062,-22,0,4,282520,34
1775,y1408,20131218,7040,7062,6980,6980,6980,6980,6980,-82,-82,2,139600,32
1776,y1408,20131219,6980,6980,7034,7034,7034,7034,7034,54,54,4,281360,32
1777,y1408,20131220,7034,7034,0,0,0,6996,6996,-38,-38,0,0,32
1778,y1408,20131223,6996,6996,6974,7006,6974,7006,6990,10,-6,4,279600,34
1779,y1408,20131224,7006,6990,0,0,0,6990,6990,0,0,0,0,34
1780,y1408,20131225,6990,6990,0,0,0,6990,6990,0,0,0,0,34
1781,y1408,20131226,6990,6990,0,0,0,6930,6930,-60,-60,0,0,34
1782,y1408,20131227,6930,6930,0,0,0,6930,6930,0,0,0,0,34
1783,y1408,20131230,6930,6930,0,0,0,6930,6930,0,0,0,0,34
1784,y1408,20131231,6930,6930,6898,6898,6898,6898,6898,-32,-32,2,137960,34
1785,y1409,20130917,7140,7184,7150,7164,7130,7156,7142,-28,-42,1798,128422960,2688
1786,y1409,20130918,7156,7142,7142,7168,7130,7136,7148,-6,6,532,38029800,2908
1787,y1409,20130923,7136,7148,7092,7100,7068,7094,7084,-54,-64,1042,73821480,3460
1788,y1409,20130924,7094,7084,7106,7132,7098,7120,7112,36,28,1506,107136800,4548
1789,y1409,20130925,7120,7112,7106,7136,7090,7090,7114,-22,2,1422,101185160,5052
1790,y1409,20130926,7090,7114,7108,7108,7056,7086,7084,-28,-30,1380,97779840,4850
1791,y1409,20130927,7086,7084,7086,7092,7020,7030,7046,-54,-38,878,61866080,4816
1792,y1409,20130930,7030,7046,7000,7026,6968,6970,6984,-76,-62,1964,137177480,5722
1793,y1409,20131008,6970,6984,6900,7030,6900,6986,6984,2,0,4944,345384200,7894
1794,y1409,20131009,6986,6984,7048,7048,6990,6994,7012,10,28,8946,627400440,14532
1795,y1409,20131010,6994,7012,7008,7036,6986,7020,7010,8,-2,10222,716703520,18866
1796,y1409,20131011,7020,7010,7030,7068,7016,7026,7042,16,32,4738,333652960,19296
1797,y1409,20131014,7026,7042,6996,7046,6988,6988,7002,-54,-40,14590,1021789000,29010
1798,y1409,20131015,6988,7002,7006,7080,7002,7072,7048,70,46,14894,1049801120,33028
1799,y1409,20131016,7072,7048,7090,7120,7060,7082,7082,34,34,15598,1104673400,37012
1800,y1409,20131017,7082,7082,7150,7202,7122,7168,7150,86,68,20242,1447543680,42892
1801,y1409,20131018,7168,7150,7150,7186,7126,7186,7150,36,0,15018,1074012720,47148
1802,y1409,20131021,7186,7150,7250,7298,7236,7274,7270,124,120,20338,1478684640,53838
1803,y1409,20131022,7274,7270,7280,7280,7192,7206,7232,-64,-38,17986,1300836800,60408
1804,y1409,20131023,7206,7232,7228,7270,7200,7248,7232,16,0,21302,1540972000,66348
1805,y1409,20131024,7248,7232,7258,7264,7208,7234,7230,2,-2,12516,905003920,68794
1806,y1409,20131025,7234,7230,7198,7236,7170,7176,7200,-54,-30,8204,590826200,69062
1807,y1409,20131028,7176,7200,7168,7178,7134,7160,7154,-40,-46,11142,797138240,69402
1808,y1409,20131029,7160,7154,7142,7150,7066,7094,7110,-60,-44,18084,1285932760,72428
1809,y1409,20131030,7094,7110,7140,7296,7140,7244,7234,134,124,38780,2805712600,84492
1810,y1409,20131031,7244,7234,7256,7264,7210,7242,7236,8,2,26640,1927868880,84440
1811,y1409,20131101,7242,7236,7248,7332,7226,7328,7270,92,34,35296,2566225800,92858
1812,y1409,20131104,7328,7270,7342,7354,7302,7348,7324,78,54,57052,4179063400,110822
1813,y1409,20131105,7348,7324,7306,7318,7242,7302,7282,-22,-42,57928,4218866280,116448
1814,y1409,20131106,7302,7282,7280,7288,7234,7238,7256,-44,-26,34248,2485649040,117284
1815,y1409,20131107,7238,7256,7236,7260,7210,7234,7236,-22,-20,34138,2470501120,119360
1816,y1409,20131108,7234,7236,7204,7226,7170,7190,7200,-46,-36,28118,2024752200,123416
1817,y1409,20131111,7190,7200,7192,7236,7162,7166,7186,-34,-14,29666,2132320560,125194
1818,y1409,20131112,7166,7186,7190,7228,7154,7226,7184,40,-2,36586,2628658360,128114
1819,y1409,20131113,7226,7184,7222,7270,7222,7258,7248,74,64,40680,2948732320,131712
1820,y1409,20131114,7258,7248,7258,7336,7258,7322,7288,74,40,57268,4174576960,139756
1821,y1409,20131115,7322,7288,7304,7368,7290,7296,7324,8,36,82114,6014124320,140810
1822,y1409,20131118,7296,7324,7260,7276,7216,7218,7244,-106,-80,78874,5714947520,157932
1823,y1409,20131119,7218,7244,7200,7236,7184,7196,7206,-48,-38,66814,4815792400,164362
1824,y1409,20131120,7196,7206,7200,7224,7176,7220,7200,14,-6,73924,5323537880,180458
1825,y1409,20131121,7220,7200,7232,7314,7220,7298,7272,98,72,96254,7000936120,186496
1826,y1409,20131122,7298,7272,7400,7402,7320,7320,7360,48,88,100768,7418458600,196704
1827,y1409,20131125,7320,7360,7338,7372,7312,7336,7340,-24,-20,70848,5201530800,201012
1828,y1409,20131126,7336,7340,7290,7342,7270,7274,7306,-66,-34,67888,4959937040,202018
1829,y1409,20131127,7274,7306,7274,7304,7220,7302,7280,-4,-26,54414,3961656960,201288
1830,y1409,20131128,7302,7280,7260,7318,7258,7282,7286,2,6,58168,4238557400,200332
1831,y1409,20131129,7282,7286,7292,7350,7280,7350,7314,64,28,68334,4999211760,206056
1832,y1409,20131202,7350,7314,7350,7380,7318,7324,7340,10,26,98068,7199446200,226726
1833,y1409,20131203,7324,7340,7310,7324,7272,7274,7298,-66,-42,71670,5231491680,236572
1834,y1409,20131204,7274,7298,7252,7288,7252,7276,7268,-22,-30,60350,4386296000,243926
1835,y1409,20131205,7276,7268,7316,7316,7220,7220,7280,-48,12,73732,5368012280,244782
1836,y1409,20131206,7220,7280,7250,7258,7206,7250,7236,-30,-44,61956,4483987480,243368
1837,y1409,20131209,7250,7236,7250,7280,7236,7250,7256,14,20,64450,4677308880,244846
1838,y1409,20131210,7250,7256,7226,7268,7214,7262,7242,6,-14,68662,4973216520,246046
1839,y1409,20131211,7262,7242,7238,7300,7230,7284,7272,42,30,80412,5847611440,259806
1840,y1409,20131212,7284,7272,7280,7300,7224,7230,7260,-42,-12,77662,5639522240,263660
1841,y1409,20131213,7230,7260,7210,7210,7084,7086,7134,-174,-126,111974,7989410200,260572
1842,y1409,20131216,7086,7134,7110,7118,7050,7052,7080,-82,-54,69726,4937369840,256576
1843,y1409,20131217,7052,7080,7060,7104,7060,7070,7082,-10,2,55952,3963240200,258756
1844,y1409,20131218,7070,7082,7040,7066,6990,7064,7016,-18,-66,74250,5210058800,257660
1845,y1409,20131219,7064,7016,7050,7070,6990,6994,7032,-22,16,72502,5098518400,268734
1846,y1409,20131220,6994,7032,7026,7044,6998,7000,7018,-32,-14,67384,4729475480,268710
1847,y1409,20131223,7000,7018,7040,7048,6968,7024,7014,6,-4,80518,5648873560,267758
1848,y1409,20131224,7024,7014,7004,7014,6960,6984,6988,-30,-26,50298,3515668000,267982
1849,y1409,20131225,6984,6988,6980,6994,6908,6924,6950,-64,-38,62932,4373894440,271482
1850,y1409,20131226,6924,6950,6920,6936,6900,6918,6918,-32,-32,39864,2758036640,272190
1851,y1409,20131227,6918,6918,6900,6980,6888,6970,6940,52,22,70504,4894271800,274836
1852,y1409,20131230,6970,6940,6970,7016,6944,6960,6978,20,38,72760,5077625480,279560
1853,y1409,20131231,6960,6978,6940,6944,6900,6904,6920,-74,-58,56412,3904162960,281116
1854,y1411,20131118,7246,7246,0,0,0,7246,7246,0,0,0,0,0
1855,y1411,20131119,7246,7246,7230,7230,7172,7172,7200,-74,-46,4,288040,2
1856,y1411,20131120,7172,7200,0,0,0,7196,7196,-4,-4,0,0,2
1857,y1411,20131121,7196,7196,0,0,0,7266,7266,70,70,0,0,2
1858,y1411,20131122,7266,7266,7340,7340,7340,7340,7340,74,74,2,146800,4
1859,y1411,20131125,7340,7340,0,0,0,7340,7340,0,0,0,0,4
1860,y1411,20131126,7340,7340,7314,7314,7302,7302,7308,-38,-32,4,292320,4
1861,y1411,20131127,7302,7308,0,0,0,7308,7308,0,0,0,0,4
1862,y1411,20131128,7308,7308,0,0,0,7314,7314,6,6,0,0,4
1863,y1411,20131129,7314,7314,0,0,0,7342,7342,28,28,0,0,4
1864,y1411,20131202,7342,7342,7358,7358,7358,7358,7358,16,16,2,147160,4
1865,y1411,20131203,7358,7358,0,0,0,7358,7358,0,0,0,0,4
1866,y1411,20131204,7358,7358,0,0,0,7328,7328,-30,-30,0,0,4
1867,y1411,20131205,7328,7328,0,0,0,7340,7340,12,12,0,0,4
1868,y1411,20131206,7340,7340,0,0,0,7296,7296,-44,-44,0,0,4
1869,y1411,20131209,7296,7296,7314,7314,7244,7252,7278,-44,-18,52,3784640,10
1870,y1411,20131210,7252,7278,0,0,0,7278,7278,0,0,0,0,10
1871,y1411,20131211,7278,7278,7324,7324,7324,7324,7324,46,46,2,146480,10
1872,y1411,20131212,7324,7324,0,0,0,7264,7264,-60,-60,0,0,10
1873,y1411,20131213,7264,7264,7160,7160,7134,7134,7148,-130,-116,18,1286920,24
1874,y1411,20131216,7134,7148,7104,7106,7092,7106,7100,-42,-48,6,426040,24
1875,y1411,20131217,7106,7100,0,0,0,7100,7100,0,0,0,0,24
1876,y1411,20131218,7100,7100,0,0,0,7100,7100,0,0,0,0,24
1877,y1411,20131219,7100,7100,7078,7094,7078,7094,7086,-6,-14,4,283440,26
1878,y1411,20131220,7094,7086,0,0,0,7086,7086,0,0,0,0,26
1879,y1411,20131223,7086,7086,7054,7100,7052,7100,7074,14,-12,10,707440,26
1880,y1411,20131224,7100,7074,7036,7036,7036,7036,7036,-38,-38,2,140720,28
1881,y1411,20131225,7036,7036,0,0,0,7036,7036,0,0,0,0,28
1882,y1411,20131226,7036,7036,0,0,0,7036,7036,0,0,0,0,28
1883,y1411,20131227,7036,7036,6990,6990,6990,6990,6990,-46,-46,2,139800,28
1884,y1411,20131230,6990,6990,7032,7040,7014,7014,7028,24,38,6,421720,30
1885,y1411,20131231,7014,7028,7006,7006,6992,6992,6998,-36,-30,6,419920,36
1886,y1412,20131217,7154,7154,0,0,0,7154,7154,0,0,0,0,4
1887,y1412,20131218,7154,7154,7032,7032,7032,7032,7032,-122,-122,2,140640,4
1888,y1412,20131219,7032,7032,0,0,0,7020,7020,-12,-12,0,0,4
1889,y1412,20131220,7020,7020,0,0,0,7008,7008,-12,-12,0,0,4
1890,y1412,20131223,7008,7008,0,0,0,6998,6998,-10,-10,0,0,4
1891,y1412,20131224,6998,6998,0,0,0,6998,6998,0,0,0,0,4
1892,y1412,20131225,6998,6998,0,0,0,6998,6998,0,0,0,0,4
1893,y1412,20131226,6998,6998,0,0,0,6998,6998,0,0,0,0,4
1894,y1412,20131227,6998,6998,0,0,0,6998,6998,0,0,0,0,4
1895,y1412,20131230,6998,6998,0,0,0,6998,6998,0,0,0,0,4
1896,y1412,20131231,6998,6998,7010,7010,6982,6994,6996,-4,-2,10,699760,8