   ,合约,日期,前收盘价,前结算价,开盘价,最高价,最低价,收盘价,结算价,涨跌1,涨跌2,成交量,成交金额,持仓量
1,p1101,20110104,9980,9968,9980,9980,9980,9980,9980,12,12,480,47904000,386
2,p1101,20110105,9980,9980,9920,9920,9920,9920,9920,-60,-60,386,38291200,0
3,p1101,20110106,9920,9920,0,0,0,9920,9920,0,0,0,0,0
4,p1101,20110107,9920,9920,0,0,0,9920,9920,0,0,0,0,0
5,p1101,20110110,9920,9920,0,0,0,9920,9920,0,0,0,0,0
6,p1101,20110111,9920,9920,0,0,0,9920,9920,0,0,0,0,0
7,p1101,20110112,9920,9920,0,0,0,9920,9920,0,0,0,0,0
8,p1101,20110113,9920,9920,0,0,0,9920,9920,0,0,0,0,0
9,p1101,20110114,9920,9920,0,0,0,9920,9920,0,0,0,0,0
10,p1101,20110117,9920,9920,0,0,0,9920,9952,0,32,0,0,0
11,p1102,20110104,9702,9702,9798,9798,9798,9798,9798,96,96,2,195960,24
12,p1102,20110105,9798,9798,9798,9898,9798,9898,9864,100,66,6,591880,20
13,p1102,20110106,9898,9864,10050,10050,10050,10050,10050,186,186,2,201000,18
14,p1102,20110107,10050,10050,9806,9806,9806,9806,9806,-244,-244,2,196120,18
15,p1102,20110110,9806,9806,0,0,0,9806,9806,0,0,0,0,18
16,p1102,20110111,9806,9806,0,0,0,9806,9806,0,0,0,0,18
17,p1102,20110112,9806,9806,9606,9606,9606,9606,9606,-200,-200,2,192120,18
18,p1102,20110113,9606,9606,0,0,0,9606,9606,0,0,0,0,18
19,p1102,20110114,9606,9606,9830,9830,9672,9672,9750,66,144,4,390040,20
20,p1102,20110117,9672,9750,0,0,0,9750,9750,0,0,0,0,20
21,p1102,20110118,9750,9750,9886,9886,9886,9886,9886,136,136,2,197720,18
22,p1102,20110119,9886,9886,10078,10078,9870,9870,9974,-16,88,8,797920,18
23,p1102,20110120,9870,9974,9974,9974,9974,9974,9974,0,0,4,398960,14
24,p1102,20110121,9974,9974,9852,9852,9852,9852,9852,-122,-122,2,197040,14
25,p1102,20110124,9852,9852,0,0,0,9852,9852,0,0,0,0,14
26,p1102,20110125,9852,9852,10140,10140,9912,9912,10026,60,174,4,401040,12
27,p1102,20110126,9912,10026,9610,9610,9610,9610,9610,-416,-416,2,192200,12
28,p1102,20110127,9610,9610,0,0,0,9610,9610,0,0,0,0,12
29,p1102,20110128,9610,9610,9880,9948,9880,9948,9936,338,326,12,1192400,0
30,p1102,20110131,9948,9936,0,0,0,9936,9936,0,0,0,0,0
31,p1102,20110201,9936,9936,0,0,0,9936,9936,0,0,0,0,0
32,p1102,20110209,9936,9936,0,0,0,9936,9936,0,0,0,0,0
33,p1102,20110210,9936,9936,0,0,0,9936,9936,0,0,0,0,0
34,p1102,20110211,9936,9936,0,0,0,9936,9936,0,0,0,0,0
35,p1102,20110214,9936,9936,0,0,0,9936,9936,0,0,0,0,0
36,p1102,20110215,9936,9936,0,0,0,9936,9936,0,0,0,0,0
37,p1102,20110216,9936,9936,0,0,0,9936,9936,0,0,0,0,0
38,p1102,20110217,9936,9936,0,0,0,9936,9936,0,0,0,0,0
39,p1102,20110218,9936,9936,0,0,0,9936,9936,0,0,0,0,0
40,p1102,20110221,9936,9936,0,0,0,9936,9936,0,0,0,0,0
41,p1103,20110104,9850,9850,9806,9896,9806,9830,9844,-20,-6,6,590640,166
42,p1103,20110105,9830,9844,9814,9814,9814,9814,9814,-30,-30,2,196280,164
43,p1103,20110106,9814,9814,10090,10090,10090,10090,10090,276,276,2,201800,164
44,p1103,20110107,10090,10090,9860,9860,9770,9770,9814,-320,-276,4,392600,160
45,p1103,20110110,9770,9814,9770,9770,9770,9770,9770,-44,-44,26,2540200,134
46,p1103,20110111,9770,9770,9850,9850,9782,9782,9798,12,28,8,783920,134
47,p1103,20110112,9782,9798,9448,9796,9448,9650,9632,-148,-166,12,1155960,130
48,p1103,20110113,9650,9632,9728,9728,9728,9728,9728,96,96,2,194560,130
49,p1103,20110114,9728,9728,9680,9700,9680,9700,9692,-28,-36,6,581600,130
50,p1103,20110117,9700,9692,0,0,0,9692,9692,0,0,0,0,130
51,p1103,20110118,9692,9692,9570,9600,9570,9600,9584,-92,-108,4,383400,130
52,p1103,20110119,9600,9584,9698,9710,9698,9710,9702,126,118,6,582120,130
53,p1103,20110120,9710,9702,9640,9640,9640,9640,9640,-62,-62,4,385600,130
54,p1103,20110121,9640,9640,0,0,0,9640,9640,0,0,0,0,130
55,p1103,20110124,9640,9640,9832,9898,9832,9892,9876,252,236,68,6716120,138
56,p1103,20110125,9892,9876,9840,9850,9840,9850,9844,-26,-32,4,393800,136
57,p1103,20110126,9850,9844,0,0,0,9844,9844,0,0,0,0,136
58,p1103,20110127,9844,9844,9472,9838,9472,9838,9654,-6,-190,80,7724000,162
59,p1103,20110128,9838,9654,0,0,0,9654,9654,0,0,0,0,162
60,p1103,20110131,9654,9654,0,0,0,9654,9654,0,0,0,0,162
61,p1103,20110201,9654,9654,0,0,0,9654,9654,0,0,0,0,162
62,p1103,20110209,9654,9654,0,0,0,9654,9654,0,0,0,0,162
63,p1103,20110210,9654,9654,10232,10232,10232,10232,10232,578,578,24,2455680,160
64,p1103,20110211,10232,10232,10250,10250,10200,10200,10218,-32,-14,40,4087800,140
65,p1103,20110214,10200,10218,10680,10680,10680,10680,10680,462,462,102,10893600,142
66,p1103,20110215,10680,10680,10200,10200,10200,10200,10200,-480,-480,2,204000,140
67,p1103,20110216,10200,10200,0,0,0,10200,10200,0,0,0,0,140
68,p1103,20110217,10200,10200,9838,10286,9838,10286,10062,86,-138,4,402480,140
69,p1103,20110218,10286,10062,9830,9880,9830,9880,9864,-182,-198,22,2170200,138
70,p1103,20110221,9880,9864,0,0,0,9864,9864,0,0,0,0,138
71,p1103,20110222,9864,9864,0,0,0,9864,9864,0,0,0,0,138
72,p1103,20110223,9864,9864,9550,9550,9500,9500,9524,-364,-340,4,381000,136
73,p1103,20110224,9500,9524,0,0,0,9524,9524,0,0,0,0,136
74,p1103,20110225,9524,9524,9380,9380,9380,9380,9380,-144,-144,12,1125600,124
75,p1103,20110228,9380,9380,9530,9530,9530,9530,9530,150,150,4,381200,120
76,p1103,20110301,9530,9530,0,0,0,9530,9530,0,0,0,0,120
77,p1103,20110302,9530,9530,0,0,0,9530,9530,0,0,0,0,120
78,p1103,20110303,9530,9530,0,0,0,9530,9530,0,0,0,0,120
79,p1103,20110304,9530,9530,0,0,0,9530,9530,0,0,0,0,120
80,p1103,20110307,9530,9530,0,0,0,9530,9530,0,0,0,0,120
81,p1103,20110308,9530,9530,0,0,0,9530,9530,0,0,0,0,120
82,p1103,20110309,9530,9530,0,0,0,9530,9530,0,0,0,0,120
83,p1103,20110310,9530,9530,0,0,0,9530,9530,0,0,0,0,120
84,p1103,20110311,9530,9530,0,0,0,9530,9530,0,0,0,0,120
85,p1103,20110314,9530,9530,0,0,0,9530,9530,0,0,0,0,0
86,p1104,20110104,9984,9892,9928,10446,9928,10000,10100,108,208,36,3636360,32
87,p1104,20110105,10000,10100,9928,9986,9902,9938,9932,-162,-168,10,993240,32
88,p1104,20110106,9938,9932,10072,10156,10012,10130,10092,198,160,20,2018760,30
89,p1104,20110107,10130,10092,10050,10050,9956,9988,10024,-104,-68,12,1202880,30
90,p1104,20110110,9988,10024,0,0,0,10024,10024,0,0,0,0,30
91,p1104,20110111,10024,10024,9988,9988,9988,9988,9988,-36,-36,2,199760,30
92,p1104,20110112,9988,9988,9910,9928,9910,9928,9918,-60,-70,4,396760,30
93,p1104,20110113,9928,9918,9960,9960,9960,9960,9960,42,42,2,199200,30
94,p1104,20110114,9960,9960,9964,9964,9888,9936,9928,-24,-32,6,595760,30
95,p1104,20110117,9936,9928,9926,9926,9884,9884,9910,-44,-18,6,594640,30
96,p1104,20110118,9884,9910,9800,9908,9786,9908,9850,-2,-60,8,788040,30
97,p1104,20110119,9908,9850,0,0,0,9850,9850,0,0,0,0,30
98,p1104,20110120,9850,9850,9998,9998,9968,9980,9976,130,126,12,1197280,18
99,p1104,20110121,9980,9976,9850,9850,9850,9850,9850,-126,-126,2,197000,18
100,p1104,20110124,9850,9850,10090,10090,10090,10090,10090,240,240,2,201800,18
101,p1104,20110125,10090,10090,9872,10198,9872,10088,10052,-2,-38,6,603160,20
102,p1104,20110126,10088,10052,9652,9940,9612,9612,9720,-440,-332,10,972160,14
103,p1104,20110127,9612,9720,9800,9800,9800,9800,9800,80,80,2,196000,12
104,p1104,20110128,9800,9800,0,0,0,9800,9800,0,0,0,0,12
105,p1104,20110131,9800,9800,0,0,0,9800,9800,0,0,0,0,12
106,p1104,20110201,9800,9800,0,0,0,9800,9800,0,0,0,0,12
107,p1104,20110209,9800,9800,0,0,0,9800,9800,0,0,0,0,12
108,p1104,20110210,9800,9800,0,0,0,9800,9800,0,0,0,0,12
109,p1104,20110211,9800,9800,10350,10350,10010,10010,10180,210,380,4,407200,10
110,p1104,20110214,10010,10180,0,0,0,10180,10180,0,0,0,0,10
111,p1104,20110215,10180,10180,0,0,0,10180,10180,0,0,0,0,10
112,p1104,20110216,10180,10180,9852,9852,9852,9852,9852,-328,-328,2,197040,10
113,p1104,20110217,9852,9852,0,0,0,9852,9852,0,0,0,0,10
114,p1104,20110218,9852,9852,9710,9710,9710,9710,9710,-142,-142,2,194200,10
115,p1104,20110221,9710,9710,9622,9622,9622,9622,9622,-88,-88,2,192440,10
116,p1104,20110222,9622,9622,0,0,0,9622,9622,0,0,0,0,10
117,p1104,20110223,9622,9622,0,0,0,9622,9622,0,0,0,0,10
118,p1104,20110224,9622,9622,9420,9650,9420,9650,9534,28,-88,4,381400,10
119,p1104,20110225,9650,9534,0,0,0,9534,9534,0,0,0,0,10
120,p1104,20110228,9534,9534,0,0,0,9534,9534,0,0,0,0,10
121,p1104,20110301,9534,9534,0,0,0,9534,9534,0,0,0,0,10
122,p1104,20110302,9534,9534,0,0,0,9534,9534,0,0,0,0,10
123,p1104,20110303,9534,9534,0,0,0,9534,9534,0,0,0,0,10
124,p1104,20110304,9534,9534,0,0,0,9534,9534,0,0,0,0,10
125,p1104,20110307,9534,9534,0,0,0,9534,9534,0,0,0,0,10
126,p1104,20110308,9534,9534,0,0,0,9534,9534,0,0,0,0,10
127,p1104,20110309,9534,9534,0,0,0,9534,9534,0,0,0,0,10
128,p1104,20110310,9534,9534,0,0,0,9534,9534,0,0,0,0,10
129,p1104,20110311,9534,9534,0,0,0,9534,9534,0,0,0,0,10
130,p1104,20110314,9534,9534,9730,9730,9090,9358,9370,-176,-164,10,937120,10
131,p1104,20110315,9358,9370,0,0,0,9370,9370,0,0,0,0,10
132,p1104,20110316,9370,9370,0,0,0,9370,9370,0,0,0,0,10
133,p1104,20110317,9370,9370,0,0,0,9370,9370,0,0,0,0,10
134,p1104,20110318,9370,9370,0,0,0,9370,9370,0,0,0,0,10
135,p1104,20110321,9370,9370,0,0,0,9370,9370,0,0,0,0,10
136,p1104,20110322,9370,9370,0,0,0,9370,9370,0,0,0,0,10
137,p1104,20110323,9370,9370,0,0,0,9370,9370,0,0,0,0,10
138,p1104,20110324,9370,9370,0,0,0,9370,9370,0,0,0,0,10
139,p1104,20110325,9370,9370,0,0,0,9370,9370,0,0,0,0,10
140,p1104,20110328,9370,9370,0,0,0,9370,9370,0,0,0,0,10
141,p1104,20110329,9370,9370,0,0,0,9370,9370,0,0,0,0,10
142,p1104,20110330,9370,9370,9736,9736,9700,9700,9718,330,348,4,388720,10
143,p1104,20110331,9700,9718,9302,9416,9302,9416,9392,-302,-326,10,939320,2
144,p1104,20110401,9416,9392,9474,9474,9474,9474,9474,82,82,2,189480,0
145,p1104,20110406,9474,9474,0,0,0,9474,9474,0,0,0,0,0
146,p1104,20110407,9474,9474,0,0,0,9474,9474,0,0,0,0,0
147,p1104,20110408,9474,9474,0,0,0,9474,9474,0,0,0,0,0
148,p1104,20110411,9474,9474,0,0,0,9474,9474,0,0,0,0,0
149,p1104,20110412,9474,9474,0,0,0,9474,9474,0,0,0,0,0
150,p1104,20110413,9474,9474,0,0,0,9474,9474,0,0,0,0,0
151,p1104,20110414,9474,9474,0,0,0,9474,9474,0,0,0,0,0
152,p1104,20110415,9474,9474,0,0,0,9474,9474,0,0,0,0,0
153,p1104,20110418,9474,9474,0,0,0,9474,9474,0,0,0,0,0
154,p1105,20110104,9818,9782,9870,9990,9850,9974,9942,192,160,2822,280611480,20420
155,p1105,20110105,9974,9942,9900,9962,9860,9930,9910,-12,-32,6868,680662720,19710
156,p1105,20110106,9930,9910,9990,10186,9986,10170,10104,260,194,4506,455305720,16420
157,p1105,20110107,10170,10104,10104,10130,9874,9944,10030,-160,-74,3956,396842120,16110
158,p1105,20110110,9944,10030,10016,10016,9880,9926,9946,-104,-84,1168,116190160,16090
159,p1105,20110111,9926,9946,9890,10010,9890,10000,9962,54,16,2082,207439560,15998
160,p1105,20110112,10000,9962,9970,10030,9800,9838,9928,-124,-34,2544,252590160,15294
161,p1105,20110113,9838,9928,10098,10098,9916,9924,9966,-4,38,1500,149492840,15338
162,p1105,20110114,9924,9966,9942,9960,9880,9904,9916,-62,-50,3344,331605160,13202
163,p1105,20110117,9904,9916,9868,9898,9820,9862,9862,-54,-54,1842,181688120,12418
164,p1105,20110118,9862,9862,9812,9870,9764,9840,9816,-22,-46,1558,152951520,12580
165,p1105,20110119,9840,9816,9900,9958,9866,9930,9926,114,110,2944,292235880,11302
166,p1105,20110120,9930,9926,9888,9960,9856,9930,9910,4,-16,1182,117154160,10864
167,p1105,20110121,9930,9910,9880,9962,9830,9962,9938,52,28,1032,102568080,10538
168,p1105,20110124,9962,9938,10000,10184,10000,10080,10114,142,176,3962,400742280,8366
169,p1105,20110125,10080,10114,9998,10042,9898,9898,9958,-216,-156,1350,134445200,8924
170,p1105,20110126,9898,9958,9756,9756,9544,9686,9652,-272,-306,1330,128392320,9042
171,p1105,20110127,9686,9652,9686,9864,9686,9800,9796,148,144,392,38401080,8990
172,p1105,20110128,9800,9796,9798,9860,9798,9838,9834,42,38,816,80253480,8836
173,p1105,20110131,9838,9834,9838,9998,9838,9980,9958,146,124,740,73699200,8372
174,p1105,20110201,9980,9958,10068,10078,10010,10066,10046,108,88,446,44809840,8268
175,p1105,20110209,10066,10046,10172,10270,10172,10270,10222,224,176,426,43551320,8090
176,p1105,20110210,10270,10222,10270,10410,10270,10342,10380,120,158,228,23668040,7964
177,p1105,20110211,10342,10380,10250,10350,10240,10322,10318,-58,-62,216,22287040,7974
178,p1105,20110214,10322,10318,10316,10376,10240,10338,10306,20,-12,364,37516600,7950
179,p1105,20110215,10338,10306,10338,10350,10250,10278,10322,-28,16,1134,117063840,8228
180,p1105,20110216,10278,10322,10150,10180,10080,10160,10132,-162,-190,924,93624880,8128
181,p1105,20110217,10160,10132,10170,10218,10020,10022,10148,-110,16,542,55011320,7926
182,p1105,20110218,10022,10148,10174,10174,10000,10000,10082,-148,-66,328,33071880,7780
183,p1105,20110221,10000,10082,9950,10002,9950,9960,9978,-122,-104,646,64465480,7406
184,p1105,20110222,9960,9978,9988,10070,9926,10010,10006,32,28,938,93867000,6846
185,p1105,20110223,10010,10006,9700,9700,9444,9650,9638,-356,-368,572,55137800,6624
186,p1105,20110224,9650,9638,9674,9726,9444,9496,9558,-142,-80,486,46455560,6350
187,p1105,20110225,9496,9558,9534,9670,9532,9662,9644,104,86,490,47255720,6184
188,p1105,20110228,9662,9644,9720,9800,9720,9778,9758,134,114,254,24789200,6044
189,p1105,20110301,9778,9758,9770,9780,9672,9750,9716,-8,-42,772,75022560,5870
190,p1105,20110302,9750,9716,9780,9880,9760,9880,9840,164,124,242,23817320,5708
191,p1105,20110303,9880,9840,9840,9950,9826,9842,9882,2,42,134,13242200,5686
192,p1105,20110304,9842,9882,9898,9920,9858,9918,9906,36,24,406,40225240,5580
193,p1105,20110307,9918,9906,9926,9960,9886,9948,9938,42,32,236,23458120,5572
194,p1105,20110308,9948,9938,9900,9906,9776,9830,9838,-108,-100,356,35026200,5680
195,p1105,20110309,9830,9838,9830,9836,9770,9782,9790,-56,-48,1914,187416680,5202
196,p1105,20110310,9782,9790,9680,9700,9616,9632,9682,-158,-108,2598,251580360,4944
197,p1105,20110311,9632,9682,9632,9690,9574,9580,9618,-102,-64,1502,144488040,4766
198,p1105,20110314,9580,9618,9500,9558,9300,9318,9402,-300,-216,3134,294664480,6432
199,p1105,20110315,9318,9402,9302,9416,9302,9414,9364,12,-38,146,13671640,6402
200,p1105,20110316,9414,9364,9298,9332,9190,9332,9240,-32,-124,298,27539040,6226
201,p1105,20110317,9332,9240,9450,9450,9280,9382,9366,142,126,38,3559080,6234
202,p1105,20110318,9382,9366,9508,9570,9480,9548,9528,182,162,124,11815720,6202
203,p1105,20110321,9548,9528,9604,9676,9588,9642,9634,114,106,266,25627040,6250
204,p1105,20110322,9642,9634,9604,9608,9492,9492,9556,-142,-78,318,30392560,6208
205,p1105,20110323,9492,9556,9472,9550,9226,9530,9530,-26,-26,784,74724480,6088
206,p1105,20110324,9530,9530,9508,9508,9270,9270,9344,-260,-186,210,19624720,6126
207,p1105,20110325,9270,9344,9302,9448,9302,9388,9410,44,66,446,41969080,6214
208,p1105,20110328,9388,9410,9442,9442,9302,9350,9414,-60,4,132,12428840,6218
209,p1105,20110329,9350,9414,9226,9302,9226,9300,9296,-114,-118,34,3160960,6222
210,p1105,20110330,9300,9296,9310,9460,9310,9418,9422,122,126,54,5088600,6218
211,p1105,20110331,9418,9422,9418,9480,9384,9404,9428,-18,6,604,56951920,6140
212,p1105,20110401,9404,9428,9542,9648,9436,9436,9468,8,40,158,14959440,6108
213,p1105,20110406,9436,9468,9500,9538,9440,9538,9508,70,40,24,2282200,6104
214,p1105,20110407,9538,9508,9500,9522,9430,9440,9464,-68,-44,462,43728080,5990
215,p1105,20110408,9440,9464,9500,9500,9458,9462,9462,-2,-2,712,67376920,5980
216,p1105,20110411,9462,9462,9560,9620,9560,9580,9576,118,114,18,1723880,5978
217,p1105,20110412,9580,9576,9480,9480,9402,9410,9434,-166,-142,96,9057560,5944
218,p1105,20110413,9410,9434,9358,9364,9296,9360,9320,-74,-114,168,15657720,5814
219,p1105,20110414,9360,9320,9360,9400,9350,9362,9372,42,52,64,5998240,5802
220,p1105,20110415,9362,9372,9350,9400,9300,9310,9330,-62,-42,150,13995600,5758
221,p1105,20110418,9310,9330,9300,9348,9300,9320,9300,-10,-30,1444,134294680,5754
222,p1105,20110419,9320,9300,9320,9438,9268,9280,9330,-20,30,68,6345640,5748
223,p1105,20110420,9280,9330,9344,9396,9344,9390,9376,60,46,22,2063080,5740
224,p1105,20110421,9390,9376,9400,9400,9354,9360,9382,-16,6,94,8820320,5724
225,p1105,20110422,9360,9382,9354,9398,9354,9398,9386,16,4,34,3191760,5702
226,p1105,20110425,9398,9386,9390,9420,9384,9408,9404,22,18,32,3009560,5684
227,p1105,20110426,9408,9404,9350,9350,9330,9330,9340,-74,-64,68,6351680,5618
228,p1105,20110427,9330,9340,9504,9504,9300,9370,9354,30,14,94,8794240,5534
229,p1105,20110428,9370,9354,9376,9468,9322,9330,9416,-24,62,118,11112040,5496
230,p1105,20110429,9330,9416,9200,9300,9100,9100,9216,-316,-200,78,7189000,5436
231,p1105,20110503,9100,9216,8702,9698,8702,9232,9210,16,-6,426,39237440,5436
232,p1105,20110504,9232,9210,0,0,0,9210,9210,0,0,0,0,5436
233,p1105,20110505,9210,9210,9300,9300,9300,9300,9300,90,90,4,372000,5436
234,p1105,20110506,9300,9300,0,0,0,9300,9300,0,0,0,0,5436
235,p1105,20110509,9300,9300,0,0,0,9300,9300,0,0,0,0,5436
236,p1105,20110510,9300,9300,9400,9400,9300,9300,9332,0,32,6,560000,5436
237,p1105,20110511,9300,9332,0,0,0,9332,9332,0,0,0,0,5436
238,p1105,20110512,9332,9332,0,0,0,9332,9332,0,0,0,0,5436
239,p1105,20110513,9332,9332,0,0,0,9332,9332,0,0,0,0,5436
240,p1105,20110516,9332,9332,0,0,0,9332,9212,0,-120,0,0,0
241,p1106,20110104,9772,9776,0,0,0,9776,9776,0,0,0,0,36
242,p1106,20110105,9776,9776,9814,9838,9814,9838,9826,62,50,4,393040,36
243,p1106,20110106,9838,9826,0,0,0,9826,9826,0,0,0,0,36
244,p1106,20110107,9826,9826,9970,10088,9960,9960,10010,134,184,12,1201280,34
245,p1106,20110110,9960,10010,9940,9940,9940,9940,9940,-70,-70,2,198800,34
246,p1106,20110111,9940,9940,0,0,0,9940,9940,0,0,0,0,34
247,p1106,20110112,9940,9940,9800,9800,9800,9800,9800,-140,-140,2,196000,32
248,p1106,20110113,9800,9800,0,0,0,9800,9800,0,0,0,0,32
249,p1106,20110114,9800,9800,0,0,0,9800,9800,0,0,0,0,32
250,p1106,20110117,9800,9800,0,0,0,9800,9800,0,0,0,0,32
251,p1106,20110118,9800,9800,9216,9738,9212,9738,9474,-62,-326,8,758000,34
252,p1106,20110119,9738,9474,9898,9944,9790,9840,9866,366,392,70,6906520,30
253,p1106,20110120,9840,9866,9966,9966,9966,9966,9966,100,100,12,1195920,36
254,p1106,20110121,9966,9966,0,0,0,9966,9966,0,0,0,0,36
255,p1106,20110124,9966,9966,10562,10562,9940,9940,10250,-26,284,4,410040,36
256,p1106,20110125,9940,10250,9896,9896,9846,9846,9888,-404,-362,16,1582320,30
257,p1106,20110126,9846,9888,0,0,0,9888,9888,0,0,0,0,30
258,p1106,20110127,9888,9888,9752,9752,9752,9752,9752,-136,-136,2,195040,30
259,p1106,20110128,9752,9752,9728,9728,9680,9680,9712,-72,-40,6,582720,30
260,p1106,20110131,9680,9712,0,0,0,9712,9712,0,0,0,0,30
261,p1106,20110201,9712,9712,0,0,0,9712,9712,0,0,0,0,30
262,p1106,20110209,9712,9712,0,0,0,9712,9712,0,0,0,0,30
263,p1106,20110210,9712,9712,10294,10294,10294,10294,10294,582,582,2,205880,28
264,p1106,20110211,10294,10294,0,0,0,10294,10294,0,0,0,0,28
265,p1106,20110214,10294,10294,0,0,0,10294,10294,0,0,0,0,28
266,p1106,20110215,10294,10294,0,0,0,10294,10294,0,0,0,0,28
267,p1106,20110216,10294,10294,0,0,0,10294,10294,0,0,0,0,28
268,p1106,20110217,10294,10294,0,0,0,10294,10294,0,0,0,0,28
269,p1106,20110218,10294,10294,0,0,0,10294,10294,0,0,0,0,28
270,p1106,20110221,10294,10294,0,0,0,10294,10294,0,0,0,0,28
271,p1106,20110222,10294,10294,0,0,0,10294,10294,0,0,0,0,28
272,p1106,20110223,10294,10294,0,0,0,10294,10294,0,0,0,0,28
273,p1106,20110224,10294,10294,0,0,0,10294,10294,0,0,0,0,28
274,p1106,20110225,10294,10294,0,0,0,10294,10294,0,0,0,0,28
275,p1106,20110228,10294,10294,9678,9700,9678,9700,9692,-594,-602,12,1163120,32
276,p1106,20110301,9700,9692,0,0,0,9692,9692,0,0,0,0,32
277,p1106,20110302,9692,9692,0,0,0,9692,9692,0,0,0,0,32
278,p1106,20110303,9692,9692,9710,9710,9710,9710,9710,18,18,8,776800,24
279,p1106,20110304,9710,9710,0,0,0,9710,9710,0,0,0,0,24
280,p1106,20110307,9710,9710,0,0,0,9710,9710,0,0,0,0,24
281,p1106,20110308,9710,9710,0,0,0,9710,9710,0,0,0,0,24
282,p1106,20110309,9710,9710,9530,9530,9464,9464,9468,-246,-242,30,2840520,52
283,p1106,20110310,9464,9468,9458,9534,9352,9388,9460,-80,-8,52,4919200,30
284,p1106,20110311,9388,9460,0,0,0,9460,9460,0,0,0,0,30
285,p1106,20110314,9460,9460,0,0,0,9460,9460,0,0,0,0,30
286,p1106,20110315,9460,9460,9106,9416,9106,9416,9260,-44,-200,4,370440,30
287,p1106,20110316,9416,9260,0,0,0,9260,9260,0,0,0,0,30
288,p1106,20110317,9260,9260,8996,9168,8996,9168,9082,-92,-178,4,363280,30
289,p1106,20110318,9168,9082,9200,9532,9200,9302,9286,220,204,10,928680,24
290,p1106,20110321,9302,9286,0,0,0,9286,9286,0,0,0,0,24
291,p1106,20110322,9286,9286,9744,9744,9312,9402,9468,116,182,16,1515040,26
292,p1106,20110323,9402,9468,9578,9578,9292,9500,9440,32,-28,10,944120,26
293,p1106,20110324,9500,9440,0,0,0,9440,9440,0,0,0,0,26
294,p1106,20110325,9440,9440,9438,9438,9296,9296,9366,-144,-74,4,374680,26
295,p1106,20110328,9296,9366,0,0,0,9366,9366,0,0,0,0,26
296,p1106,20110329,9366,9366,0,0,0,9366,9366,0,0,0,0,26
297,p1106,20110330,9366,9366,9272,9420,9272,9420,9346,54,-20,4,373840,26
298,p1106,20110331,9420,9346,9270,9480,9270,9480,9374,134,28,4,375000,24
299,p1106,20110401,9480,9374,9360,9524,9360,9390,9408,16,34,8,752680,24
300,p1106,20110406,9390,9408,9440,9440,9440,9440,9440,32,32,2,188800,26
301,p1106,20110407,9440,9440,0,0,0,9440,9440,0,0,0,0,26
302,p1106,20110408,9440,9440,0,0,0,9440,9440,0,0,0,0,26
303,p1106,20110411,9440,9440,0,0,0,9440,9440,0,0,0,0,26
304,p1106,20110412,9440,9440,9650,9652,9444,9444,9532,4,92,14,1334600,28
305,p1106,20110413,9444,9532,9200,9386,9200,9380,9274,-152,-258,20,1854920,26
306,p1106,20110414,9380,9274,0,0,0,9274,9274,0,0,0,0,26
307,p1106,20110415,9274,9274,0,0,0,9274,9274,0,0,0,0,26
308,p1106,20110418,9274,9274,0,0,0,9274,9274,0,0,0,0,26
309,p1106,20110419,9274,9274,0,0,0,9274,9274,0,0,0,0,26
310,p1106,20110420,9274,9274,0,0,0,9274,9274,0,0,0,0,26
311,p1106,20110421,9274,9274,0,0,0,9274,9274,0,0,0,0,26
312,p1106,20110422,9274,9274,9338,9338,9338,9338,9338,64,64,2,186760,24
313,p1106,20110425,9338,9338,0,0,0,9338,9338,0,0,0,0,24
314,p1106,20110426,9338,9338,0,0,0,9338,9338,0,0,0,0,24
315,p1106,20110427,9338,9338,0,0,0,9338,9338,0,0,0,0,24
316,p1106,20110428,9338,9338,0,0,0,9338,9338,0,0,0,0,24
317,p1106,20110429,9338,9338,9230,9230,9230,9230,9230,-108,-108,2,184600,24
318,p1106,20110503,9230,9230,0,0,0,9230,9230,0,0,0,0,24
319,p1106,20110504,9230,9230,9330,9330,9330,9330,9330,100,100,2,186600,26
320,p1106,20110505,9330,9330,9070,9070,9070,9070,9070,-260,-260,2,181400,24
321,p1106,20110506,9070,9070,9050,9050,9050,9050,9050,-20,-20,4,362000,20
322,p1106,20110509,9050,9050,0,0,0,9050,9050,0,0,0,0,20
323,p1106,20110510,9050,9050,0,0,0,9050,9050,0,0,0,0,20
324,p1106,20110511,9050,9050,0,0,0,9050,9050,0,0,0,0,20
325,p1106,20110512,9050,9050,0,0,0,9050,9050,0,0,0,0,20
326,p1106,20110513,9050,9050,0,0,0,9050,9050,0,0,0,0,20
327,p1106,20110516,9050,9050,0,0,0,9050,9050,0,0,0,0,20
328,p1106,20110517,9050,9050,0,0,0,9050,9050,0,0,0,0,20
329,p1106,20110518,9050,9050,0,0,0,9050,9050,0,0,0,0,20
330,p1106,20110519,9050,9050,0,0,0,9050,9050,0,0,0,0,20
331,p1106,20110520,9050,9050,0,0,0,9050,9050,0,0,0,0,20
332,p1106,20110523,9050,9050,0,0,0,9050,9050,0,0,0,0,20
333,p1106,20110524,9050,9050,9316,9316,9250,9250,9272,200,222,6,556360,22
334,p1106,20110525,9250,9272,0,0,0,9272,9272,0,0,0,0,22
335,p1106,20110526,9272,9272,9300,9540,8932,9540,9200,268,-72,10,920080,26
336,p1106,20110527,9540,9200,8930,9000,8930,9000,8964,-200,-236,4,358600,26
337,p1106,20110530,9000,8964,8930,9130,8930,9100,9094,136,130,18,1637000,10
338,p1106,20110531,9100,9094,0,0,0,9094,9094,0,0,0,0,10
339,p1106,20110601,9094,9094,8950,8950,8950,8950,8950,-144,-144,10,895000,0
340,p1106,20110602,8950,8950,0,0,0,8950,8950,0,0,0,0,0
341,p1106,20110603,8950,8950,0,0,0,8950,8950,0,0,0,0,0
342,p1106,20110607,8950,8950,0,0,0,8950,8950,0,0,0,0,0
343,p1106,20110608,8950,8950,0,0,0,8950,8950,0,0,0,0,0
344,p1106,20110609,8950,8950,0,0,0,8950,8950,0,0,0,0,0
345,p1106,20110610,8950,8950,0,0,0,8950,8950,0,0,0,0,0
346,p1106,20110613,8950,8950,0,0,0,8950,8950,0,0,0,0,0
347,p1106,20110614,8950,8950,0,0,0,8950,8950,0,0,0,0,0
348,p1106,20110615,8950,8950,0,0,0,8950,8950,0,0,0,0,0
349,p1107,20110104,9802,9790,0,0,0,9790,9790,0,0,0,0,30
350,p1107,20110105,9790,9790,10036,10036,9732,9868,9878,78,88,6,592720,32
351,p1107,20110106,9868,9878,10016,10018,10016,10018,10016,140,138,4,400680,28
352,p1107,20110107,10018,10016,0,0,0,10016,10016,0,0,0,0,28
353,p1107,20110110,10016,10016,0,0,0,10016,10016,0,0,0,0,28
354,p1107,20110111,10016,10016,0,0,0,10016,10016,0,0,0,0,28
355,p1107,20110112,10016,10016,0,0,0,10016,10016,0,0,0,0,28
356,p1107,20110113,10016,10016,9750,9750,9750,9750,9750,-266,-266,2,195000,30
357,p1107,20110114,9750,9750,0,0,0,9750,9750,0,0,0,0,30
358,p1107,20110117,9750,9750,0,0,0,9750,9750,0,0,0,0,30
359,p1107,20110118,9750,9750,9740,9740,9740,9740,9740,-10,-10,4,389600,28
360,p1107,20110119,9740,9740,0,0,0,9740,9740,0,0,0,0,28
361,p1107,20110120,9740,9740,0,0,0,9740,9740,0,0,0,0,28
362,p1107,20110121,9740,9740,0,0,0,9740,9740,0,0,0,0,28
363,p1107,20110124,9740,9740,0,0,0,9740,9740,0,0,0,0,28
364,p1107,20110125,9740,9740,0,0,0,9740,9740,0,0,0,0,28
365,p1107,20110126,9740,9740,0,0,0,9740,9740,0,0,0,0,28
366,p1107,20110127,9740,9740,9708,9710,9708,9710,9708,-30,-32,6,582520,26
367,p1107,20110128,9710,9708,0,0,0,9708,9708,0,0,0,0,26
368,p1107,20110131,9708,9708,0,0,0,9708,9708,0,0,0,0,26
369,p1107,20110201,9708,9708,0,0,0,9708,9708,0,0,0,0,26
370,p1107,20110209,9708,9708,0,0,0,9708,9708,0,0,0,0,26
371,p1107,20110210,9708,9708,10286,10286,10286,10286,10286,578,578,2,205720,26
372,p1107,20110211,10286,10286,0,0,0,10286,10286,0,0,0,0,26
373,p1107,20110214,10286,10286,0,0,0,10286,10286,0,0,0,0,26
374,p1107,20110215,10286,10286,0,0,0,10286,10286,0,0,0,0,26
375,p1107,20110216,10286,10286,0,0,0,10286,10286,0,0,0,0,26
376,p1107,20110217,10286,10286,10008,10008,10008,10008,10008,-278,-278,4,400320,30
377,p1107,20110218,10008,10008,0,0,0,10008,10008,0,0,0,0,30
378,p1107,20110221,10008,10008,9764,9764,9764,9764,9764,-244,-244,2,195280,30
379,p1107,20110222,9764,9764,0,0,0,9764,9764,0,0,0,0,30
380,p1107,20110223,9764,9764,0,0,0,9764,9764,0,0,0,0,30
381,p1107,20110224,9764,9764,0,0,0,9764,9764,0,0,0,0,30
382,p1107,20110225,9764,9764,9332,9454,9328,9448,9414,-316,-350,14,1318120,36
383,p1107,20110228,9448,9414,9590,9590,9590,9590,9590,176,176,12,1150800,32
384,p1107,20110301,9590,9590,0,0,0,9590,9590,0,0,0,0,32
385,p1107,20110302,9590,9590,0,0,0,9590,9590,0,0,0,0,32
386,p1107,20110303,9590,9590,0,0,0,9590,9590,0,0,0,0,32
387,p1107,20110304,9590,9590,9600,9600,9600,9600,9600,10,10,2,192000,30
388,p1107,20110307,9600,9600,9870,9870,9696,9696,9784,96,184,16,1565520,32
389,p1107,20110308,9696,9784,0,0,0,9784,9784,0,0,0,0,32
390,p1107,20110309,9784,9784,9490,9490,9490,9490,9490,-294,-294,2,189800,32
391,p1107,20110310,9490,9490,9250,9250,9250,9250,9250,-240,-240,2,185000,32
392,p1107,20110311,9250,9250,9418,9418,9378,9378,9394,128,144,10,939400,30
393,p1107,20110314,9378,9394,0,0,0,9394,9394,0,0,0,0,30
394,p1107,20110315,9394,9394,0,0,0,9394,9394,0,0,0,0,30
395,p1107,20110316,9394,9394,8930,8930,8930,8930,8930,-464,-464,2,178600,30
396,p1107,20110317,8930,8930,0,0,0,8930,8930,0,0,0,0,30
397,p1107,20110318,8930,8930,0,0,0,8930,8930,0,0,0,0,30
398,p1107,20110321,8930,8930,0,0,0,8930,8930,0,0,0,0,30
399,p1107,20110322,8930,8930,9330,9330,9330,9330,9330,400,400,2,186600,32
400,p1107,20110323,9330,9330,0,0,0,9330,9330,0,0,0,0,32
401,p1107,20110324,9330,9330,0,0,0,9330,9330,0,0,0,0,32
402,p1107,20110325,9330,9330,0,0,0,9330,9330,0,0,0,0,32
403,p1107,20110328,9330,9330,9368,9368,9330,9330,9348,0,18,4,373960,30
404,p1107,20110329,9330,9348,0,0,0,9348,9348,0,0,0,0,30
405,p1107,20110330,9348,9348,9280,9338,9280,9300,9298,-48,-50,8,743960,30
406,p1107,20110331,9300,9298,0,0,0,9298,9298,0,0,0,0,30
407,p1107,20110401,9298,9298,9444,9444,9444,9444,9444,146,146,2,188880,30
408,p1107,20110406,9444,9444,0,0,0,9444,9444,0,0,0,0,30
409,p1107,20110407,9444,9444,0,0,0,9444,9444,0,0,0,0,30
410,p1107,20110408,9444,9444,0,0,0,9444,9444,0,0,0,0,30
411,p1107,20110411,9444,9444,0,0,0,9444,9444,0,0,0,0,30
412,p1107,20110412,9444,9444,0,0,0,9444,9444,0,0,0,0,30
413,p1107,20110413,9444,9444,0,0,0,9444,9444,0,0,0,0,30
414,p1107,20110414,9444,9444,0,0,0,9444,9444,0,0,0,0,30
415,p1107,20110415,9444,9444,0,0,0,9444,9444,0,0,0,0,30
416,p1107,20110418,9444,9444,0,0,0,9444,9444,0,0,0,0,30
417,p1107,20110419,9444,9444,9360,9360,9132,9210,9236,-234,-208,26,2401800,30
418,p1107,20110420,9210,9236,0,0,0,9236,9236,0,0,0,0,30
419,p1107,20110421,9236,9236,0,0,0,9236,9236,0,0,0,0,30
420,p1107,20110422,9236,9236,0,0,0,9236,9236,0,0,0,0,30
421,p1107,20110425,9236,9236,0,0,0,9236,9236,0,0,0,0,30
422,p1107,20110426,9236,9236,9236,9240,9236,9240,9238,4,2,4,369520,30
423,p1107,20110427,9240,9238,0,0,0,9238,9238,0,0,0,0,30
424,p1107,20110428,9238,9238,0,0,0,9238,9238,0,0,0,0,30
425,p1107,20110429,9238,9238,9162,9164,9162,9164,9162,-74,-76,4,366520,28
426,p1107,20110503,9164,9162,9166,9166,9166,9166,9166,4,4,6,549960,22
427,p1107,20110504,9166,9166,0,0,0,9166,9166,0,0,0,0,22
428,p1107,20110505,9166,9166,0,0,0,9166,9166,0,0,0,0,22
429,p1107,20110506,9166,9166,9018,9030,9018,9030,9024,-136,-142,4,360960,22
430,p1107,20110509,9030,9024,0,0,0,9024,9024,0,0,0,0,22
431,p1107,20110510,9024,9024,0,0,0,9024,9024,0,0,0,0,22
432,p1107,20110511,9024,9024,0,0,0,9024,9024,0,0,0,0,22
433,p1107,20110512,9024,9024,0,0,0,9024,9024,0,0,0,0,22
434,p1107,20110513,9024,9024,0,0,0,9024,9024,0,0,0,0,22
435,p1107,20110516,9024,9024,0,0,0,9024,9024,0,0,0,0,22
436,p1107,20110517,9024,9024,0,0,0,9024,9024,0,0,0,0,22
437,p1107,20110518,9024,9024,0,0,0,9024,9024,0,0,0,0,22
438,p1107,20110519,9024,9024,0,0,0,9024,9024,0,0,0,0,22
439,p1107,20110520,9024,9024,0,0,0,9024,9024,0,0,0,0,22
440,p1107,20110523,9024,9024,0,0,0,9024,9024,0,0,0,0,22
441,p1107,20110524,9024,9024,0,0,0,9024,9024,0,0,0,0,22
442,p1107,20110525,9024,9024,0,0,0,9024,9024,0,0,0,0,22
443,p1107,20110526,9024,9024,9462,9462,9462,9462,9462,438,438,2,189240,22
444,p1107,20110527,9462,9462,0,0,0,9462,9462,0,0,0,0,22
445,p1107,20110530,9462,9462,0,0,0,9462,9462,0,0,0,0,22
446,p1107,20110531,9462,9462,0,0,0,9462,9462,0,0,0,0,22
447,p1107,20110601,9462,9462,0,0,0,9462,9462,0,0,0,0,22
448,p1107,20110602,9462,9462,9388,9520,9388,9520,9462,58,0,6,567760,18
449,p1107,20110603,9520,9462,0,0,0,9462,9462,0,0,0,0,18
450,p1107,20110607,9462,9462,9580,9580,9580,9580,9580,118,118,2,191600,16
451,p1107,20110608,9580,9580,0,0,0,9580,9580,0,0,0,0,16
452,p1107,20110609,9580,9580,0,0,0,9580,9580,0,0,0,0,16
453,p1107,20110610,9580,9580,9312,9312,9312,9312,9312,-268,-268,2,186240,16
454,p1107,20110613,9312,9312,0,0,0,9312,9312,0,0,0,0,16
455,p1107,20110614,9312,9312,9280,9280,9280,9280,9280,-32,-32,8,742400,8
456,p1107,20110615,9280,9280,0,0,0,9280,9280,0,0,0,0,8
457,p1107,20110616,9280,9280,0,0,0,9280,9280,0,0,0,0,8
458,p1107,20110617,9280,9280,8816,9450,8816,9450,9132,170,-148,4,365320,6
459,p1107,20110620,9450,9132,0,0,0,9132,9132,0,0,0,0,6
460,p1107,20110621,9132,9132,0,0,0,9132,9132,0,0,0,0,6
461,p1107,20110622,9132,9132,0,0,0,9132,9132,0,0,0,0,6
462,p1107,20110623,9132,9132,0,0,0,9132,9132,0,0,0,0,6
463,p1107,20110624,9132,9132,0,0,0,9132,9132,0,0,0,0,6
464,p1107,20110627,9132,9132,9132,9132,9132,9132,9132,0,0,6,547920,0
465,p1107,20110628,9132,9132,0,0,0,9132,9132,0,0,0,0,0
466,p1107,20110629,9132,9132,0,0,0,9132,9132,0,0,0,0,0
467,p1107,20110630,9132,9132,0,0,0,9132,9132,0,0,0,0,0
468,p1107,20110701,9132,9132,0,0,0,9132,9132,0,0,0,0,0
469,p1107,20110704,9132,9132,0,0,0,9132,9132,0,0,0,0,0
470,p1107,20110705,9132,9132,0,0,0,9132,9132,0,0,0,0,0
471,p1107,20110706,9132,9132,0,0,0,9132,9132,0,0,0,0,0
472,p1107,20110707,9132,9132,0,0,0,9132,9132,0,0,0,0,0
473,p1107,20110708,9132,9132,0,0,0,9132,9132,0,0,0,0,0
474,p1107,20110711,9132,9132,0,0,0,9132,9132,0,0,0,0,0
475,p1107,20110712,9132,9132,0,0,0,9132,9132,0,0,0,0,0
476,p1107,20110713,9132,9132,0,0,0,9132,9132,0,0,0,0,0
477,p1107,20110714,9132,9132,0,0,0,9132,9132,0,0,0,0,0
478,p1108,20110104,9730,9730,9908,9916,9886,9916,9904,186,174,46,4556200,8
479,p1108,20110105,9916,9904,0,0,0,9904,9904,0,0,0,0,8
480,p1108,20110106,9904,9904,10096,10096,9972,9998,10022,94,118,6,601320,8
481,p1108,20110107,9998,10022,0,0,0,10022,10022,0,0,0,0,8
482,p1108,20110110,10022,10022,9920,9920,9810,9880,9860,-142,-162,20,1972200,10
483,p1108,20110111,9880,9860,9948,9948,9824,9830,9834,-30,-26,46,4523920,48
484,p1108,20110112,9830,9834,9928,10380,9446,9746,9678,-88,-156,284,27488840,32
485,p1108,20110113,9746,9678,9886,9886,9850,9850,9856,172,178,38,3745880,30
486,p1108,20110114,9850,9856,9840,9904,9840,9860,9848,4,-8,20,1969680,16
487,p1108,20110117,9860,9848,0,0,0,9848,9848,0,0,0,0,16
488,p1108,20110118,9848,9848,0,0,0,9848,9848,0,0,0,0,16
489,p1108,20110119,9848,9848,9824,9824,9824,9824,9824,-24,-24,4,392960,12
490,p1108,20110120,9824,9824,0,0,0,9824,9824,0,0,0,0,12
491,p1108,20110121,9824,9824,0,0,0,9824,9824,0,0,0,0,12
492,p1108,20110124,9824,9824,0,0,0,9824,9824,0,0,0,0,12
493,p1108,20110125,9824,9824,9996,9996,9950,9950,9972,126,148,4,398920,12
494,p1108,20110126,9950,9972,9550,9550,9550,9550,9550,-422,-422,2,191000,12
495,p1108,20110127,9550,9550,0,0,0,9550,9550,0,0,0,0,12
496,p1108,20110128,9550,9550,9764,9764,9644,9680,9696,130,146,10,969640,10
497,p1108,20110131,9680,9696,10238,10238,9800,9800,10018,104,322,4,400760,10
498,p1108,20110201,9800,10018,0,0,0,10018,10018,0,0,0,0,10
499,p1108,20110209,10018,10018,0,0,0,10018,10018,0,0,0,0,10
500,p1108,20110210,10018,10018,0,0,0,10018,10018,0,0,0,0,10
501,p1108,20110211,10018,10018,0,0,0,10018,10018,0,0,0,0,10
502,p1108,20110214,10018,10018,10160,10250,10160,10250,10204,232,186,4,408200,12
503,p1108,20110215,10250,10204,10122,10122,10122,10122,10122,-82,-82,2,202440,12
504,p1108,20110216,10122,10122,0,0,0,10122,10122,0,0,0,0,12
505,p1108,20110217,10122,10122,0,0,0,10122,10122,0,0,0,0,12
506,p1108,20110218,10122,10122,0,0,0,10122,10122,0,0,0,0,12
507,p1108,20110221,10122,10122,0,0,0,10122,10122,0,0,0,0,12
508,p1108,20110222,10122,10122,0,0,0,10122,10122,0,0,0,0,12
509,p1108,20110223,10122,10122,9516,9516,9516,9516,9516,-606,-606,10,951600,22
510,p1108,20110224,9516,9516,9352,9490,9352,9490,9380,-26,-136,14,1313440,16
511,p1108,20110225,9490,9380,9810,9810,9302,9302,9486,-78,106,6,569200,14
512,p1108,20110228,9302,9486,0,0,0,9486,9486,0,0,0,0,14
513,p1108,20110301,9486,9486,0,0,0,9486,9486,0,0,0,0,14
514,p1108,20110302,9486,9486,0,0,0,9486,9486,0,0,0,0,14
515,p1108,20110303,9486,9486,9550,9650,9550,9650,9616,164,130,6,577000,10
516,p1108,20110304,9650,9616,9710,9710,9710,9710,9710,94,94,2,194200,10
517,p1108,20110307,9710,9710,0,0,0,9710,9710,0,0,0,0,10
518,p1108,20110308,9710,9710,0,0,0,9710,9710,0,0,0,0,10
519,p1108,20110309,9710,9710,9410,9538,9410,9538,9494,-172,-216,6,569720,8
520,p1108,20110310,9538,9494,0,0,0,9494,9494,0,0,0,0,8
521,p1108,20110311,9494,9494,9250,9448,9188,9280,9332,-214,-162,12,1120000,10
522,p1108,20110314,9280,9332,0,0,0,9332,9332,0,0,0,0,10
523,p1108,20110315,9332,9332,0,0,0,9332,9332,0,0,0,0,10
524,p1108,20110316,9332,9332,9332,9332,9332,9332,9332,0,0,2,186640,10
525,p1108,20110317,9332,9332,0,0,0,9332,9332,0,0,0,0,10
526,p1108,20110318,9332,9332,0,0,0,9332,9332,0,0,0,0,10
527,p1108,20110321,9332,9332,9342,9342,9342,9342,9342,10,10,2,186840,8
528,p1108,20110322,9342,9342,0,0,0,9342,9342,0,0,0,0,8
529,p1108,20110323,9342,9342,0,0,0,9342,9342,0,0,0,0,8
530,p1108,20110324,9342,9342,0,0,0,9342,9342,0,0,0,0,8
531,p1108,20110325,9342,9342,0,0,0,9342,9342,0,0,0,0,8
532,p1108,20110328,9342,9342,9050,9230,9050,9230,9110,-112,-232,6,546600,8
533,p1108,20110329,9230,9110,0,0,0,9110,9110,0,0,0,0,8
534,p1108,20110330,9110,9110,0,0,0,9110,9110,0,0,0,0,8
535,p1108,20110331,9110,9110,9218,9280,9200,9280,9234,170,124,38,3508960,16
536,p1108,20110401,9280,9234,0,0,0,9234,9234,0,0,0,0,16
537,p1108,20110406,9234,9234,0,0,0,9234,9234,0,0,0,0,16
538,p1108,20110407,9234,9234,0,0,0,9234,9234,0,0,0,0,16
539,p1108,20110408,9234,9234,0,0,0,9234,9234,0,0,0,0,16
540,p1108,20110411,9234,9234,0,0,0,9234,9234,0,0,0,0,16
541,p1108,20110412,9234,9234,0,0,0,9234,9234,0,0,0,0,16
542,p1108,20110413,9234,9234,9342,9342,9342,9342,9342,108,108,8,747360,8
543,p1108,20110414,9342,9342,0,0,0,9342,9342,0,0,0,0,8
544,p1108,20110415,9342,9342,9348,9348,9348,9348,9348,6,6,2,186960,8
545,p1108,20110418,9348,9348,0,0,0,9348,9348,0,0,0,0,8
546,p1108,20110419,9348,9348,0,0,0,9348,9348,0,0,0,0,8
547,p1108,20110420,9348,9348,0,0,0,9348,9348,0,0,0,0,8
548,p1108,20110421,9348,9348,0,0,0,9348,9348,0,0,0,0,8
549,p1108,20110422,9348,9348,9240,9398,9240,9310,9316,-38,-32,30,2794800,8
550,p1108,20110425,9310,9316,9330,9330,9330,9330,9330,14,14,2,186600,8
551,p1108,20110426,9330,9330,0,0,0,9330,9330,0,0,0,0,8
552,p1108,20110427,9330,9330,0,0,0,9330,9330,0,0,0,0,8
553,p1108,20110428,9330,9330,0,0,0,9330,9330,0,0,0,0,8
554,p1108,20110429,9330,9330,0,0,0,9330,9330,0,0,0,0,8
555,p1108,20110503,9330,9330,0,0,0,9330,9330,0,0,0,0,8
556,p1108,20110504,9330,9330,0,0,0,9330,9330,0,0,0,0,8
557,p1108,20110505,9330,9330,0,0,0,9330,9330,0,0,0,0,8
558,p1108,20110506,9330,9330,0,0,0,9330,9330,0,0,0,0,8
559,p1108,20110509,9330,9330,0,0,0,9330,9330,0,0,0,0,8
560,p1108,20110510,9330,9330,0,0,0,9330,9330,0,0,0,0,8
561,p1108,20110511,9330,9330,0,0,0,9330,9330,0,0,0,0,8
562,p1108,20110512,9330,9330,0,0,0,9330,9330,0,0,0,0,8
563,p1108,20110513,9330,9330,0,0,0,9330,9330,0,0,0,0,8
564,p1108,20110516,9330,9330,0,0,0,9330,9330,0,0,0,0,8
565,p1108,20110517,9330,9330,0,0,0,9330,9330,0,0,0,0,8
566,p1108,20110518,9330,9330,9228,9228,9152,9152,9190,-178,-140,4,367600,8
567,p1108,20110519,9152,9190,0,0,0,9190,9190,0,0,0,0,8
568,p1108,20110520,9190,9190,0,0,0,9190,9190,0,0,0,0,8
569,p1108,20110523,9190,9190,9290,9290,9290,9290,9290,100,100,2,185800,6
570,p1108,20110524,9290,9290,0,0,0,9290,9290,0,0,0,0,6
571,p1108,20110525,9290,9290,0,0,0,9290,9290,0,0,0,0,6
572,p1108,20110526,9290,9290,0,0,0,9290,9290,0,0,0,0,6
573,p1108,20110527,9290,9290,0,0,0,9290,9290,0,0,0,0,6
574,p1108,20110530,9290,9290,0,0,0,9290,9290,0,0,0,0,6
575,p1108,20110531,9290,9290,0,0,0,9290,9290,0,0,0,0,6
576,p1108,20110601,9290,9290,0,0,0,9290,9290,0,0,0,0,6
577,p1108,20110602,9290,9290,0,0,0,9290,9290,0,0,0,0,6
578,p1108,20110603,9290,9290,9546,9546,9546,9546,9546,256,256,4,381840,4
579,p1108,20110607,9546,9546,9400,9400,9400,9400,9400,-146,-146,2,188000,4
580,p1108,20110608,9400,9400,0,0,0,9400,9400,0,0,0,0,4
581,p1108,20110609,9400,9400,0,0,0,9400,9400,0,0,0,0,4
582,p1108,20110610,9400,9400,0,0,0,9400,9400,0,0,0,0,4
583,p1108,20110613,9400,9400,9320,9320,9320,9320,9320,-80,-80,2,186400,2
584,p1108,20110614,9320,9320,0,0,0,9320,9320,0,0,0,0,2
585,p1108,20110615,9320,9320,0,0,0,9320,9320,0,0,0,0,2
586,p1108,20110616,9320,9320,0,0,0,9320,9320,0,0,0,0,2
587,p1108,20110617,9320,9320,0,0,0,9320,9320,0,0,0,0,2
588,p1108,20110620,9320,9320,0,0,0,9320,9320,0,0,0,0,2
589,p1108,20110621,9320,9320,0,0,0,9320,9320,0,0,0,0,2
590,p1108,20110622,9320,9320,0,0,0,9320,9320,0,0,0,0,2
591,p1108,20110623,9320,9320,0,0,0,9320,9320,0,0,0,0,2
592,p1108,20110624,9320,9320,0,0,0,9320,9320,0,0,0,0,2
593,p1108,20110627,9320,9320,0,0,0,9320,9320,0,0,0,0,2
594,p1108,20110628,9320,9320,0,0,0,9320,9320,0,0,0,0,2
595,p1108,20110629,9320,9320,8854,8966,8854,8966,8894,-354,-426,6,533720,4
596,p1108,20110630,8966,8894,0,0,0,8894,8894,0,0,0,0,4
597,p1108,20110701,8894,8894,0,0,0,8894,8894,0,0,0,0,4
598,p1108,20110704,8894,8894,0,0,0,8894,8894,0,0,0,0,4
599,p1108,20110705,8894,8894,0,0,0,8894,8894,0,0,0,0,4
600,p1108,20110706,8894,8894,0,0,0,8894,8894,0,0,0,0,4
601,p1108,20110707,8894,8894,0,0,0,8894,8894,0,0,0,0,4
602,p1108,20110708,8894,8894,0,0,0,8894,8894,0,0,0,0,4
603,p1108,20110711,8894,8894,0,0,0,8894,8894,0,0,0,0,4
604,p1108,20110712,8894,8894,0,0,0,8894,8894,0,0,0,0,4
605,p1108,20110713,8894,8894,0,0,0,8894,8894,0,0,0,0,4
606,p1108,20110714,8894,8894,8552,8552,8552,8552,8552,-342,-342,2,171040,4
607,p1108,20110715,8552,8552,0,0,0,8552,8552,0,0,0,0,4
608,p1108,20110718,8552,8552,0,0,0,8552,8552,0,0,0,0,4
609,p1108,20110719,8552,8552,0,0,0,8552,8552,0,0,0,0,4
610,p1108,20110720,8552,8552,0,0,0,8552,8552,0,0,0,0,4
611,p1108,20110721,8552,8552,8666,8666,8666,8666,8666,114,114,2,173320,2
612,p1108,20110722,8666,8666,0,0,0,8666,8666,0,0,0,0,2
613,p1108,20110725,8666,8666,0,0,0,8666,8666,0,0,0,0,2
614,p1108,20110726,8666,8666,0,0,0,8666,8666,0,0,0,0,2
615,p1108,20110727,8666,8666,0,0,0,8666,8666,0,0,0,0,2
616,p1108,20110728,8666,8666,0,0,0,8666,8666,0,0,0,0,2
617,p1108,20110729,8666,8666,9098,9098,9098,9098,9098,432,432,2,181960,0
618,p1108,20110801,9098,9098,0,0,0,9098,9098,0,0,0,0,0
619,p1108,20110802,9098,9098,0,0,0,9098,9098,0,0,0,0,0
620,p1108,20110803,9098,9098,0,0,0,9098,9098,0,0,0,0,0
621,p1108,20110804,9098,9098,0,0,0,9098,9098,0,0,0,0,0
622,p1108,20110805,9098,9098,0,0,0,9098,9098,0,0,0,0,0
623,p1108,20110808,9098,9098,0,0,0,9098,9098,0,0,0,0,0
624,p1108,20110809,9098,9098,0,0,0,9098,9098,0,0,0,0,0
625,p1108,20110810,9098,9098,0,0,0,9098,9098,0,0,0,0,0
626,p1108,20110811,9098,9098,0,0,0,9098,9098,0,0,0,0,0
627,p1108,20110812,9098,9098,0,0,0,9098,9098,0,0,0,0,0
628,p1109,20110104,9786,9766,9820,9952,9798,9924,9896,158,130,219102,21684164120,171810
629,p1109,20110105,9924,9896,9800,9860,9754,9794,9812,-102,-84,183922,18049483920,163598
630,p1109,20110106,9794,9812,9880,10118,9880,10088,10026,276,214,255552,25625626240,180714
631,p1109,20110107,10088,10026,9960,10080,9758,9852,9958,-174,-68,416438,41474240480,174940
632,p1109,20110110,9852,9958,9920,9934,9762,9814,9842,-144,-116,262514,25841121960,176136
633,p1109,20110111,9814,9842,9870,9916,9810,9890,9860,48,18,193388,19069180520,169788
634,p1109,20110112,9890,9860,9886,9942,9672,9718,9790,-142,-70,463450,45374696720,189226
635,p1109,20110113,9718,9790,9900,9988,9780,9790,9860,0,70,277382,27353232440,173460
636,p1109,20110114,9790,9860,9766,9852,9744,9836,9810,-24,-50,192084,18845476120,163812
637,p1109,20110117,9836,9810,9800,9832,9710,9764,9778,-46,-32,237124,23187880320,164740
638,p1109,20110118,9764,9778,9722,9780,9644,9720,9704,-58,-74,204972,19891997200,157104
639,p1109,20110119,9720,9704,9760,9860,9734,9856,9804,152,100,182388,17883153560,158842
640,p1109,20110120,9856,9804,9800,9890,9770,9834,9838,30,34,211524,20810621400,160294
641,p1109,20110121,9834,9838,9770,9884,9770,9856,9838,18,0,227258,22358495200,166266
642,p1109,20110124,9856,9838,9898,10160,9898,10008,10062,170,224,320304,32231988280,186228
643,p1109,20110125,10008,10062,9968,9988,9792,9794,9888,-268,-174,220190,21776549640,178036
644,p1109,20110126,9794,9888,9688,9688,9306,9586,9542,-302,-346,243932,23277735480,158542
645,p1109,20110127,9586,9542,9712,9758,9622,9674,9686,132,144,174380,16892209640,162010
646,p1109,20110128,9674,9686,9622,9724,9622,9682,9688,-4,2,128198,12420094400,153958
647,p1109,20110131,9682,9688,9708,9876,9706,9856,9830,168,142,108334,10651077200,147058
648,p1109,20110201,9856,9830,9920,9942,9858,9908,9904,78,74,87282,8645863360,141880
649,p1109,20110209,9908,9904,10010,10134,9900,10130,10066,226,162,186386,18765155240,159024
650,p1109,20110210,10130,10066,10236,10296,10164,10198,10232,132,166,176780,18089580520,154778
651,p1109,20110211,10198,10232,10076,10200,10076,10160,10160,-72,-72,158712,16126588680,156268
652,p1109,20110214,10160,10160,10184,10214,10060,10182,10146,22,-14,145110,14724003400,161566
653,p1109,20110215,10182,10146,10088,10126,10026,10038,10084,-108,-62,140688,14186980640,164112
654,p1109,20110216,10038,10084,9880,9896,9752,9848,9842,-236,-242,203074,19987423480,166912
655,p1109,20110217,9848,9842,9880,9924,9686,9688,9818,-154,-24,210282,20646424560,177622
656,p1109,20110218,9688,9818,9848,9860,9652,9654,9754,-164,-64,185922,18136039240,171130
657,p1109,20110221,9654,9754,9620,9682,9566,9644,9642,-110,-112,151608,14619883600,172818
658,p1109,20110222,9644,9642,9746,9788,9572,9732,9698,90,56,255262,24755313400,179398
659,p1109,20110223,9732,9698,9300,9366,9128,9316,9310,-382,-388,209838,19539648480,158012
660,p1109,20110224,9316,9310,9364,9408,9060,9180,9256,-130,-54,198346,18361088440,144418
661,p1109,20110225,9180,9256,9224,9346,9214,9330,9292,74,36,135158,12560882080,133062
662,p1109,20110228,9330,9292,9442,9478,9406,9456,9438,164,146,132556,12511416200,132004
663,p1109,20110301,9456,9438,9438,9460,9330,9428,9400,-10,-38,195288,18360032520,135156
664,p1109,20110302,9428,9400,9428,9606,9410,9578,9512,178,112,221646,21086010800,145736
665,p1109,20110303,9578,9512,9578,9666,9506,9510,9582,-2,70,138464,13270256960,138362
666,p1109,20110304,9510,9582,9580,9638,9530,9632,9596,50,14,136878,13136338840,134614
667,p1109,20110307,9632,9596,9620,9688,9592,9648,9636,52,40,124746,12021221280,129106
668,p1109,20110308,9648,9636,9590,9594,9430,9490,9512,-146,-124,132114,12568287360,126952
669,p1109,20110309,9490,9512,9500,9516,9376,9388,9442,-124,-70,158240,14943161120,118978
670,p1109,20110310,9388,9442,9270,9312,9204,9230,9268,-212,-174,129600,12011743800,116298
671,p1109,20110311,9230,9268,9270,9288,9152,9168,9200,-100,-68,167212,15386346560,116424
672,p1109,20110314,9168,9200,9060,9156,8958,8988,9044,-212,-156,157598,14255407120,121432
673,p1109,20110315,8988,9044,9000,9086,8962,9058,9028,14,-16,153728,13880921840,123980
674,p1109,20110316,9058,9028,8822,8970,8784,8948,8880,-80,-148,139850,12420605840,117246
675,p1109,20110317,8948,8880,8900,9050,8882,9026,8982,146,102,128816,11572034960,115500
676,p1109,20110318,9026,8982,9120,9198,9104,9178,9158,196,176,102986,9433305320,110326
677,p1109,20110321,9178,9158,9270,9312,9212,9276,9272,118,114,148786,13795438280,111530
678,p1109,20110322,9276,9272,9240,9254,9152,9160,9208,-112,-64,153062,14094078480,120396
679,p1109,20110323,9160,9208,9178,9258,9162,9240,9216,32,8,177608,16368574200,126882
680,p1109,20110324,9240,9216,9180,9210,8968,8978,9072,-238,-144,326874,29657291000,141528
681,p1109,20110325,8978,9072,9080,9184,9058,9110,9120,38,48,244796,22325560360,126466
682,p1109,20110328,9110,9120,9128,9206,9008,9124,9136,4,16,256426,23429064840,111338
683,p1109,20110329,9124,9136,9090,9098,9000,9082,9050,-54,-86,223488,20229622640,104486
684,p1109,20110330,9082,9050,9120,9214,9102,9184,9156,134,106,168428,15422958160,102844
685,p1109,20110331,9184,9156,9200,9228,9136,9180,9182,24,26,148004,13590602600,99070
686,p1109,20110401,9180,9182,9300,9306,9252,9260,9276,78,94,117110,10864320120,95524
687,p1109,20110406,9260,9276,9284,9370,9244,9360,9332,84,56,108660,10142206200,97386
688,p1109,20110407,9360,9332,9340,9374,9270,9294,9312,-38,-20,125262,11665887840,106656
689,p1109,20110408,9294,9312,9250,9404,9246,9398,9320,86,8,164060,15292493760,101496
690,p1109,20110411,9398,9320,9454,9560,9454,9488,9510,168,190,130752,12435881880,94230
691,p1109,20110412,9488,9510,9406,9410,9312,9320,9366,-190,-144,87606,8206430160,88922
692,p1109,20110413,9320,9366,9230,9250,9154,9230,9192,-136,-174,67640,6218394080,86420
693,p1109,20110414,9230,9192,9200,9246,9118,9120,9184,-72,-8,58342,5358541560,82328
694,p1109,20110415,9120,9184,9158,9180,9078,9080,9134,-104,-50,47690,4356561560,82818
695,p1109,20110418,9080,9134,9080,9114,9028,9096,9084,-38,-50,27984,2542298320,81866
696,p1109,20110419,9096,9084,9130,9160,9026,9044,9090,-40,6,31804,2891194400,82080
697,p1109,20110420,9044,9090,9070,9194,9070,9190,9150,100,60,27380,2505356000,76096
698,p1109,20110421,9190,9150,9216,9222,9162,9192,9188,42,38,22172,2037534400,72484
699,p1109,20110422,9192,9188,9200,9296,9200,9296,9248,108,60,26208,2423755160,71856
700,p1109,20110425,9296,9248,9310,9338,9254,9268,9286,20,38,18030,1674327200,70450
701,p1109,20110426,9268,9286,9270,9270,9140,9146,9172,-140,-114,22952,2105247440,71292
702,p1109,20110427,9146,9172,9180,9210,9114,9130,9164,-42,-8,13980,1281260160,70252
703,p1109,20110428,9130,9164,9158,9248,9158,9246,9204,82,40,15244,1403181600,69706
704,p1109,20110429,9246,9204,9110,9130,9038,9056,9064,-148,-140,18522,1679187880,68096
705,p1109,20110503,9056,9064,9120,9158,9116,9158,9134,94,70,10978,1002851720,64436
706,p1109,20110504,9158,9134,9080,9120,9022,9058,9062,-76,-72,15460,1401107440,58496
707,p1109,20110505,9058,9062,9028,9076,8956,9054,9030,-8,-32,13002,1174100360,55500
708,p1109,20110506,9054,9030,8860,8900,8804,8814,8856,-216,-174,27220,2410739720,51810
709,p1109,20110509,8814,8856,8830,8896,8830,8886,8874,30,18,11190,993106920,47894
710,p1109,20110510,8886,8874,8890,8970,8870,8958,8912,84,38,11268,1004411360,44920
711,p1109,20110511,8958,8912,8976,9002,8944,8952,8972,40,60,6998,627903560,43064
712,p1109,20110512,8952,8972,8900,8990,8866,8866,8914,-106,-58,10400,927087320,41370
713,p1109,20110513,8866,8914,8920,9002,8920,8988,8952,74,38,7702,689603120,37906
714,p1109,20110516,8988,8952,8952,8958,8898,8924,8926,-28,-26,6068,541734400,37544
715,p1109,20110517,8924,8926,8926,8932,8840,8926,8882,0,-44,9954,884285880,34716
716,p1109,20110518,8926,8882,8940,9028,8940,9012,9002,130,120,8486,763942600,31822
717,p1109,20110519,9012,9002,9070,9144,9070,9086,9080,84,78,6068,551086280,29832
718,p1109,20110520,9086,9080,9102,9200,9096,9198,9152,118,72,8472,775360360,29108
719,p1109,20110523,9198,9152,9210,9230,9152,9174,9194,22,42,7420,682227320,29294
720,p1109,20110524,9174,9194,9166,9290,9166,9278,9230,84,36,4806,443630880,29104
721,p1109,20110525,9278,9230,9288,9288,9210,9230,9230,0,0,6780,625913680,25968
722,p1109,20110526,9230,9230,9286,9338,9286,9334,9312,104,82,4360,406045520,25588
723,p1109,20110527,9334,9312,9350,9356,9302,9330,9320,18,8,3228,300871800,24498
724,p1109,20110530,9330,9320,9332,9400,9308,9356,9372,36,52,6954,651760840,20530
725,p1109,20110531,9356,9372,9350,9374,9330,9352,9348,-20,-24,1882,175930120,20406
726,p1109,20110601,9352,9348,9378,9378,9312,9322,9336,-26,-12,1118,104385440,20126
727,p1109,20110602,9322,9336,9310,9356,9300,9356,9328,20,-8,1324,123506760,19766
728,p1109,20110603,9356,9328,9376,9496,9368,9486,9426,158,98,3866,364422240,17886
729,p1109,20110607,9486,9426,9398,9398,9358,9396,9376,-30,-50,2184,204811040,17614
730,p1109,20110608,9396,9376,9392,9428,9340,9360,9376,-16,0,2374,222599680,17364
731,p1109,20110609,9360,9376,9400,9420,9378,9400,9400,24,24,3176,298585360,16036
732,p1109,20110610,9400,9400,9370,9416,9316,9324,9366,-76,-34,2420,226663080,15534
733,p1109,20110613,9324,9366,9270,9310,9270,9280,9290,-86,-76,1512,140464840,15572
734,p1109,20110614,9280,9290,9266,9322,9266,9298,9292,8,2,522,48506880,15376
735,p1109,20110615,9298,9292,9312,9326,9254,9288,9276,-4,-16,1230,114116880,15324
736,p1109,20110616,9288,9276,9218,9246,9190,9202,9212,-74,-64,1152,106131560,14898
737,p1109,20110617,9202,9212,9202,9210,9100,9150,9174,-62,-38,520,47709200,14810
738,p1109,20110620,9150,9174,9174,9204,9058,9180,9162,6,-12,704,64503880,14590
739,p1109,20110621,9180,9162,9212,9236,9176,9192,9214,30,52,1144,105420480,14582
740,p1109,20110622,9192,9214,9202,9206,9140,9144,9178,-70,-36,206,18909800,14568
741,p1109,20110623,9144,9178,9132,9132,9010,9042,9048,-136,-130,1274,115275240,14900
742,p1109,20110624,9042,9048,8994,9038,8976,9000,9014,-48,-34,944,85094200,14546
743,p1109,20110627,9000,9014,8880,8978,8844,8872,8918,-142,-96,1236,110229800,14344
744,p1109,20110628,8872,8918,8900,8930,8832,8856,8866,-62,-52,518,45927960,14318
745,p1109,20110629,8856,8866,8900,8920,8882,8906,8904,40,38,642,57168280,14270
746,p1109,20110630,8906,8904,8938,8942,8910,8942,8914,38,10,1196,106620080,13558
747,p1109,20110701,8942,8914,8882,8882,8660,8866,8816,-48,-98,1078,95057640,13462
748,p1109,20110704,8866,8816,8870,8920,8846,8900,8896,84,80,1264,112463440,13634
749,p1109,20110705,8900,8896,8918,8940,8848,8872,8898,-24,2,500,44492560,13694
750,p1109,20110706,8872,8898,8852,8890,8830,8862,8864,-36,-34,368,32624680,13774
751,p1109,20110707,8862,8864,8868,8880,8838,8880,8864,16,0,230,20390000,13724
752,p1109,20110708,8880,8864,8958,8998,8942,8966,8960,102,96,1048,93910920,13538
753,p1109,20110711,8966,8960,8808,8988,8808,8972,8970,12,10,710,63693320,13296
754,p1109,20110712,8972,8970,8944,8944,8832,8860,8890,-110,-80,404,35920720,13104
755,p1109,20110713,8860,8890,8928,8972,8912,8972,8948,82,58,182,16285440,13006
756,p1109,20110714,8972,8948,9016,9016,8960,8988,8982,40,34,908,81560000,12972
757,p1109,20110715,8988,8982,8942,8984,8942,8984,8960,2,-22,54,4839440,12968
758,p1109,20110718,8984,8960,8912,9000,8912,8942,8966,-18,6,1080,96846400,12806
759,p1109,20110719,8942,8966,8938,8970,8936,8970,8944,4,-22,4782,427723800,8082
760,p1109,20110720,8970,8944,8970,9036,8932,9010,9000,66,56,818,73631120,7746
761,p1109,20110721,9010,9000,9010,9046,8992,9034,9028,34,28,740,66819120,7114
762,p1109,20110722,9034,9028,9042,9048,9008,9036,9024,8,-4,306,27618440,6884
763,p1109,20110725,9036,9024,8988,8988,8940,8950,8954,-74,-70,244,21852080,6792
764,p1109,20110726,8950,8954,8952,8976,8946,8970,8954,16,0,180,16120600,6784
765,p1109,20110727,8970,8954,8998,9036,8998,9020,9010,66,56,2202,198444040,5332
766,p1109,20110728,9020,9010,8980,8980,8930,8940,8942,-70,-68,306,27366200,5310
767,p1109,20110729,8940,8942,8884,8946,8854,8854,8914,-88,-28,1212,108040760,4390
768,p1109,20110801,8854,8914,8900,8924,8852,8900,8886,-14,-28,346,30749880,4156
769,p1109,20110802,8900,8886,8886,8918,8876,8900,8908,14,22,1042,92832600,4042
770,p1109,20110803,8900,8908,8920,8938,8920,8930,8928,22,20,50,4464760,3998
771,p1109,20110804,8930,8928,8912,8912,8880,8880,8884,-48,-44,86,7640800,3914
772,p1109,20110805,8880,8884,8728,8748,8544,8622,8620,-262,-264,214,18450320,3858
773,p1109,20110808,8622,8620,8402,8628,8402,8600,8584,-20,-36,250,21464120,3690
774,p1109,20110809,8600,8584,8410,8410,8178,8350,8274,-234,-310,1208,99956720,2852
775,p1109,20110810,8350,8274,8440,8460,8420,8460,8446,186,172,848,71635360,2996
776,p1109,20110811,8460,8446,8444,8470,8410,8470,8452,24,6,62,5241320,2990
777,p1109,20110812,8470,8452,8588,8590,8492,8496,8508,44,56,62,5275320,2968
778,p1109,20110815,8496,8508,8580,8580,8496,8496,8520,-12,12,32,2726680,2962
779,p1109,20110816,8496,8520,8542,8542,8402,8430,8472,-90,-48,24,2033360,2960
780,p1109,20110817,8430,8472,8452,8470,8436,8436,8454,-36,-18,24,2029000,2962
781,p1109,20110818,8436,8454,8452,8496,8452,8474,8482,20,28,188,15947040,2822
782,p1109,20110819,8474,8482,8398,8508,8398,8508,8474,26,-8,312,26440840,2644
783,p1109,20110822,8508,8474,8502,8502,8452,8452,8470,-22,-4,50,4235640,2642
784,p1109,20110823,8452,8470,8452,8510,8452,8510,8478,40,8,58,4917880,2642
785,p1109,20110824,8510,8478,8432,8532,8432,8518,8500,40,22,34,2890560,2642
786,p1109,20110825,8518,8500,8498,8518,8486,8518,8496,18,-4,10,849720,2642
787,p1109,20110826,8518,8496,8462,8474,8456,8460,8464,-36,-32,104,8804360,2568
788,p1109,20110829,8460,8464,8472,8550,8468,8520,8492,56,28,32,2717880,2556
789,p1109,20110830,8520,8492,8500,8520,8470,8472,8484,-20,-8,810,68733520,2554
790,p1109,20110831,8472,8484,8452,8550,8452,8528,8522,44,38,158,13467040,2466
791,p1109,20110901,8528,8522,8550,8560,8550,8550,8554,28,32,34,2908800,2452
792,p1109,20110902,8550,8554,0,0,0,8554,8554,0,0,0,0,2452
793,p1109,20110905,8554,8554,0,0,0,8554,8554,0,0,0,0,2452
794,p1109,20110906,8554,8554,0,0,0,8554,8554,0,0,0,0,2452
795,p1109,20110907,8554,8554,0,0,0,8554,8554,0,0,0,0,2452
796,p1109,20110908,8554,8554,0,0,0,8554,8554,0,0,0,0,2452
797,p1109,20110909,8554,8554,8500,8510,8500,8510,8508,-44,-46,22,1872000,2450
798,p1109,20110913,8510,8508,0,0,0,8508,8508,0,0,0,0,2450
799,p1109,20110914,8508,8508,8520,8520,8488,8512,8520,4,12,400,34084200,2290
800,p1109,20110915,8512,8520,0,0,0,8520,8522,0,2,0,0,0
801,p1110,20110104,9780,9822,0,0,0,9822,9822,0,0,0,0,14
802,p1110,20110105,9822,9822,0,0,0,9822,9822,0,0,0,0,14
803,p1110,20110106,9822,9822,9984,10050,9984,10050,10016,228,194,8,801360,14
804,p1110,20110107,10050,10016,10050,10154,9866,9876,9992,-140,-24,12,1199160,14
805,p1110,20110110,9876,9992,0,0,0,9992,9992,0,0,0,0,14
806,p1110,20110111,9992,9992,0,0,0,9992,9992,0,0,0,0,14
807,p1110,20110112,9992,9992,9960,9960,9952,9952,9956,-40,-36,4,398240,14
808,p1110,20110113,9952,9956,9924,9924,9924,9924,9924,-32,-32,2,198480,12
809,p1110,20110114,9924,9924,9922,9922,9922,9922,9922,-2,-2,2,198440,12
810,p1110,20110117,9922,9922,0,0,0,9922,9922,0,0,0,0,12
811,p1110,20110118,9922,9922,0,0,0,9922,9922,0,0,0,0,12
812,p1110,20110119,9922,9922,0,0,0,9922,9922,0,0,0,0,12
813,p1110,20110120,9922,9922,9740,9872,9740,9830,9814,-92,-108,26,2551880,8
814,p1110,20110121,9830,9814,0,0,0,9814,9814,0,0,0,0,8
815,p1110,20110124,9814,9814,0,0,0,9814,9814,0,0,0,0,8
816,p1110,20110125,9814,9814,9904,10068,9904,9980,9984,166,170,12,1198080,8
817,p1110,20110126,9980,9984,9606,9606,9606,9606,9606,-378,-378,4,384240,8
818,p1110,20110127,9606,9606,9600,9888,9600,9698,9674,92,68,22,2128640,12
819,p1110,20110128,9698,9674,9544,9544,9544,9544,9544,-130,-130,2,190880,12
820,p1110,20110131,9544,9544,10016,10016,10016,10016,10016,472,472,8,801280,12
821,p1110,20110201,10016,10016,9950,10048,9950,10048,9982,32,-34,6,598960,8
822,p1110,20110209,10048,9982,0,0,0,9982,9982,0,0,0,0,8
823,p1110,20110210,9982,9982,10522,10522,10264,10288,10362,306,380,70,7253680,8
824,p1110,20110211,10288,10362,0,0,0,10362,10362,0,0,0,0,8
825,p1110,20110214,10362,10362,10186,10236,10162,10200,10190,-162,-172,12,1222920,12
826,p1110,20110215,10200,10190,10102,10172,10102,10172,10146,-18,-44,10,1014760,10
827,p1110,20110216,10172,10146,9932,10290,9630,9630,9914,-516,-232,14,1388120,16
828,p1110,20110217,9630,9914,0,0,0,9914,9914,0,0,0,0,16
829,p1110,20110218,9914,9914,0,0,0,9914,9914,0,0,0,0,16
830,p1110,20110221,9914,9914,0,0,0,9914,9914,0,0,0,0,16
831,p1110,20110222,9914,9914,9790,9790,9692,9692,9740,-222,-174,8,779280,16
832,p1110,20110223,9692,9740,9390,9390,9390,9390,9390,-350,-350,2,187800,16
833,p1110,20110224,9390,9390,9472,9472,9190,9222,9324,-168,-66,14,1305440,14
834,p1110,20110225,9222,9324,0,0,0,9324,9324,0,0,0,0,14
835,p1110,20110228,9324,9324,9630,9630,9432,9500,9506,176,182,12,1140760,14
836,p1110,20110301,9500,9506,9410,9626,9400,9400,9478,-106,-28,6,568720,14
837,p1110,20110302,9400,9478,9738,9778,9424,9634,9734,156,256,54,5256640,62
838,p1110,20110303,9634,9734,9632,9790,9620,9790,9640,56,-94,64,6170520,22
839,p1110,20110304,9790,9640,0,0,0,9640,9640,0,0,0,0,22
840,p1110,20110307,9640,9640,0,0,0,9640,9640,0,0,0,0,22
841,p1110,20110308,9640,9640,0,0,0,9640,9640,0,0,0,0,22
842,p1110,20110309,9640,9640,9328,9470,9328,9470,9394,-170,-246,22,2066720,16
843,p1110,20110310,9470,9394,0,0,0,9394,9394,0,0,0,0,16
844,p1110,20110311,9394,9394,0,0,0,9394,9394,0,0,0,0,16
845,p1110,20110314,9394,9394,0,0,0,9394,9394,0,0,0,0,16
846,p1110,20110315,9394,9394,9238,9238,9000,9120,9128,-274,-266,12,1095520,16
847,p1110,20110316,9120,9128,8782,8782,8782,8782,8782,-346,-346,4,351280,16
848,p1110,20110317,8782,8782,0,0,0,8782,8782,0,0,0,0,16
849,p1110,20110318,8782,8782,0,0,0,8782,8782,0,0,0,0,16
850,p1110,20110321,8782,8782,9306,9306,9130,9130,9218,348,436,4,368720,16
851,p1110,20110322,9130,9218,9184,9184,9184,9184,9184,-34,-34,2,183680,16
852,p1110,20110323,9184,9184,9218,9220,9218,9220,9218,36,34,4,368760,14
853,p1110,20110324,9220,9218,8904,9052,8904,8998,8970,-220,-248,58,5203640,14
854,p1110,20110325,8998,8970,9100,9176,9026,9174,9146,204,176,26,2378320,12
855,p1110,20110328,9174,9146,9120,9120,9120,9120,9120,-26,-26,20,1824000,32
856,p1110,20110329,9120,9120,9154,9154,8934,9138,9106,18,-14,32,2914240,22
857,p1110,20110330,9138,9106,9224,9224,9224,9224,9224,118,118,2,184480,20
858,p1110,20110331,9224,9224,9144,9200,9144,9200,9172,-24,-52,4,366880,20
859,p1110,20110401,9200,9172,0,0,0,9172,9172,0,0,0,0,20
860,p1110,20110406,9172,9172,0,0,0,9172,9172,0,0,0,0,20
861,p1110,20110407,9172,9172,0,0,0,9172,9172,0,0,0,0,20
862,p1110,20110408,9172,9172,9242,9504,9242,9504,9388,332,216,8,751040,20
863,p1110,20110411,9504,9388,9570,9628,9570,9620,9606,232,218,16,1537080,28
864,p1110,20110412,9620,9606,9450,9450,9450,9450,9450,-156,-156,2,189000,28
865,p1110,20110413,9450,9450,9268,9268,9268,9268,9268,-182,-182,2,185360,28
866,p1110,20110414,9268,9268,0,0,0,9268,9268,0,0,0,0,28
867,p1110,20110415,9268,9268,9210,9210,9130,9130,9168,-138,-100,12,1100240,20
868,p1110,20110418,9130,9168,9130,9130,9130,9130,9130,-38,-38,2,182600,20
869,p1110,20110419,9130,9130,0,0,0,9130,9130,0,0,0,0,20
870,p1110,20110420,9130,9130,9298,9298,9168,9240,9234,110,104,12,1108240,20
871,p1110,20110421,9240,9234,0,0,0,9234,9234,0,0,0,0,20
872,p1110,20110422,9234,9234,9266,9266,9266,9266,9266,32,32,2,185320,22
873,p1110,20110425,9266,9266,0,0,0,9266,9266,0,0,0,0,22
874,p1110,20110426,9266,9266,0,0,0,9266,9266,0,0,0,0,22
875,p1110,20110427,9266,9266,9220,9220,9220,9220,9220,-46,-46,2,184400,22
876,p1110,20110428,9220,9220,0,0,0,9220,9220,0,0,0,0,22
877,p1110,20110429,9220,9220,9080,9080,9080,9080,9080,-140,-140,2,181600,22
878,p1110,20110503,9080,9080,9262,9262,9168,9174,9206,94,126,10,920680,26
879,p1110,20110504,9174,9206,9110,9138,9110,9138,9126,-68,-80,16,1460320,26
880,p1110,20110505,9138,9126,9070,9076,9050,9076,9064,-50,-62,6,543920,22
881,p1110,20110506,9076,9064,8958,8958,8958,8958,8958,-106,-106,2,179160,20
882,p1110,20110509,8958,8958,0,0,0,8958,8958,0,0,0,0,20
883,p1110,20110510,8958,8958,0,0,0,8958,8958,0,0,0,0,20
884,p1110,20110511,8958,8958,0,0,0,8958,8958,0,0,0,0,20
885,p1110,20110512,8958,8958,0,0,0,8958,8958,0,0,0,0,20
886,p1110,20110513,8958,8958,9084,9084,8968,9046,9022,88,64,24,2165680,22
887,p1110,20110516,9046,9022,8998,9000,8998,9000,8998,-22,-24,4,359960,18
888,p1110,20110517,9000,8998,0,0,0,8998,8998,0,0,0,0,18
889,p1110,20110518,8998,8998,0,0,0,8998,8998,0,0,0,0,18
890,p1110,20110519,8998,8998,9110,9110,9110,9110,9110,112,112,2,182200,16
891,p1110,20110520,9110,9110,0,0,0,9110,9110,0,0,0,0,16
892,p1110,20110523,9110,9110,0,0,0,9110,9110,0,0,0,0,16
893,p1110,20110524,9110,9110,0,0,0,9110,9110,0,0,0,0,16
894,p1110,20110525,9110,9110,0,0,0,9110,9110,0,0,0,0,16
895,p1110,20110526,9110,9110,0,0,0,9110,9110,0,0,0,0,16
896,p1110,20110527,9110,9110,0,0,0,9110,9110,0,0,0,0,16
897,p1110,20110530,9110,9110,0,0,0,9110,9110,0,0,0,0,16
898,p1110,20110531,9110,9110,0,0,0,9110,9110,0,0,0,0,16
899,p1110,20110601,9110,9110,9216,9366,9216,9366,9266,256,156,6,555960,10
900,p1110,20110602,9366,9266,0,0,0,9266,9266,0,0,0,0,10
901,p1110,20110603,9266,9266,0,0,0,9266,9266,0,0,0,0,10
902,p1110,20110607,9266,9266,0,0,0,9266,9266,0,0,0,0,10
903,p1110,20110608,9266,9266,0,0,0,9266,9266,0,0,0,0,10
904,p1110,20110609,9266,9266,9426,9426,9426,9426,9426,160,160,8,754080,2
905,p1110,20110610,9426,9426,9474,9474,9324,9324,9398,-102,-28,4,375960,2
906,p1110,20110613,9324,9398,0,0,0,9398,9398,0,0,0,0,2
907,p1110,20110614,9398,9398,0,0,0,9398,9398,0,0,0,0,2
908,p1110,20110615,9398,9398,0,0,0,9398,9398,0,0,0,0,2
909,p1110,20110616,9398,9398,0,0,0,9398,9398,0,0,0,0,2
910,p1110,20110617,9398,9398,0,0,0,9398,9398,0,0,0,0,2
911,p1110,20110620,9398,9398,0,0,0,9398,9398,0,0,0,0,2
912,p1110,20110621,9398,9398,0,0,0,9398,9398,0,0,0,0,2
913,p1110,20110622,9398,9398,0,0,0,9398,9398,0,0,0,0,2
914,p1110,20110623,9398,9398,0,0,0,9398,9398,0,0,0,0,2
915,p1110,20110624,9398,9398,0,0,0,9398,9398,0,0,0,0,2
916,p1110,20110627,9398,9398,0,0,0,9398,9398,0,0,0,0,2
917,p1110,20110628,9398,9398,0,0,0,9398,9398,0,0,0,0,2
918,p1110,20110629,9398,9398,0,0,0,9398,9398,0,0,0,0,2
919,p1110,20110630,9398,9398,0,0,0,9398,9398,0,0,0,0,2
920,p1110,20110701,9398,9398,8930,8948,8930,8948,8932,-450,-466,10,893360,10
921,p1110,20110704,8948,8932,8988,8988,8988,8988,8988,56,56,2,179760,8
922,p1110,20110705,8988,8988,0,0,0,8988,8988,0,0,0,0,8
923,p1110,20110706,8988,8988,8872,8872,8862,8862,8868,-126,-120,6,532080,4
924,p1110,20110707,8862,8868,0,0,0,8868,8868,0,0,0,0,4
925,p1110,20110708,8868,8868,8998,8998,8958,8958,8970,90,102,6,538280,6
926,p1110,20110711,8958,8970,0,0,0,8970,8970,0,0,0,0,6
927,p1110,20110712,8970,8970,0,0,0,8970,8970,0,0,0,0,6
928,p1110,20110713,8970,8970,9068,9068,9000,9000,9034,30,64,8,722720,2
929,p1110,20110714,9000,9034,9130,9130,9020,9020,9074,-14,40,4,363000,2
930,p1110,20110715,9020,9074,0,0,0,9074,9074,0,0,0,0,2
931,p1110,20110718,9074,9074,9136,9268,9002,9004,9088,-70,14,58,5271040,6
932,p1110,20110719,9004,9088,0,0,0,9088,9088,0,0,0,0,6
933,p1110,20110720,9088,9088,0,0,0,9088,9088,0,0,0,0,6
934,p1110,20110721,9088,9088,0,0,0,9088,9088,0,0,0,0,6
935,p1110,20110722,9088,9088,0,0,0,9088,9088,0,0,0,0,6
936,p1110,20110725,9088,9088,9130,9130,9040,9040,9084,-48,-4,4,363400,6
937,p1110,20110726,9040,9084,0,0,0,9084,9084,0,0,0,0,6
938,p1110,20110727,9084,9084,0,0,0,9084,9084,0,0,0,0,6
939,p1110,20110728,9084,9084,0,0,0,9084,9084,0,0,0,0,6
940,p1110,20110729,9084,9084,0,0,0,9084,9084,0,0,0,0,6
941,p1110,20110801,9084,9084,0,0,0,9084,9084,0,0,0,0,6
942,p1110,20110802,9084,9084,0,0,0,9084,9084,0,0,0,0,6
943,p1110,20110803,9084,9084,0,0,0,9084,9084,0,0,0,0,6
944,p1110,20110804,9084,9084,0,0,0,9084,9084,0,0,0,0,6
945,p1110,20110805,9084,9084,0,0,0,9084,9084,0,0,0,0,6
946,p1110,20110808,9084,9084,0,0,0,9084,9084,0,0,0,0,6
947,p1110,20110809,9084,9084,0,0,0,9084,9084,0,0,0,0,6
948,p1110,20110810,9084,9084,9500,9500,9500,9500,9500,416,416,2,190000,8
949,p1110,20110811,9500,9500,0,0,0,9500,9500,0,0,0,0,8
950,p1110,20110812,9500,9500,8930,8930,8930,8930,8930,-570,-570,2,178600,8
951,p1110,20110815,8930,8930,8822,8822,8822,8822,8822,-108,-108,2,176440,6
952,p1110,20110816,8822,8822,0,0,0,8822,8822,0,0,0,0,6
953,p1110,20110817,8822,8822,0,0,0,8822,8822,0,0,0,0,6
954,p1110,20110818,8822,8822,0,0,0,8822,8822,0,0,0,0,6
955,p1110,20110819,8822,8822,0,0,0,8822,8822,0,0,0,0,6
956,p1110,20110822,8822,8822,0,0,0,8822,8822,0,0,0,0,6
957,p1110,20110823,8822,8822,0,0,0,8822,8822,0,0,0,0,6
958,p1110,20110824,8822,8822,0,0,0,8822,8822,0,0,0,0,6
959,p1110,20110825,8822,8822,0,0,0,8822,8822,0,0,0,0,6
960,p1110,20110826,8822,8822,0,0,0,8822,8822,0,0,0,0,6
961,p1110,20110829,8822,8822,0,0,0,8822,8822,0,0,0,0,6
962,p1110,20110830,8822,8822,0,0,0,8822,8822,0,0,0,0,6
963,p1110,20110831,8822,8822,9002,9002,9002,9002,9002,180,180,2,180040,4
964,p1110,20110901,9002,9002,0,0,0,9002,9002,0,0,0,0,4
965,p1110,20110902,9002,9002,0,0,0,9002,9002,0,0,0,0,4
966,p1110,20110905,9002,9002,8966,8966,8966,8966,8966,-36,-36,2,179320,2
967,p1110,20110906,8966,8966,0,0,0,8966,8966,0,0,0,0,2
968,p1110,20110907,8966,8966,8700,9120,8700,9120,8940,154,-26,6,536400,0
969,p1110,20110908,9120,8940,0,0,0,8940,8940,0,0,0,0,0
970,p1110,20110909,8940,8940,0,0,0,8940,8940,0,0,0,0,0
971,p1110,20110913,8940,8940,0,0,0,8940,8940,0,0,0,0,0
972,p1110,20110914,8940,8940,0,0,0,8940,8940,0,0,0,0,0
973,p1110,20110915,8940,8940,0,0,0,8940,8940,0,0,0,0,0
974,p1110,20110916,8940,8940,0,0,0,8940,8940,0,0,0,0,0
975,p1110,20110919,8940,8940,0,0,0,8940,8940,0,0,0,0,0
976,p1110,20110920,8940,8940,0,0,0,8940,8940,0,0,0,0,0
977,p1110,20110921,8940,8940,0,0,0,8940,8940,0,0,0,0,0
978,p1110,20110922,8940,8940,0,0,0,8940,8940,0,0,0,0,0
979,p1110,20110923,8940,8940,0,0,0,8940,8940,0,0,0,0,0
980,p1110,20110926,8940,8940,0,0,0,8940,8940,0,0,0,0,0
981,p1110,20110927,8940,8940,0,0,0,8940,8940,0,0,0,0,0
982,p1110,20110928,8940,8940,0,0,0,8940,8940,0,0,0,0,0
983,p1110,20110929,8940,8940,0,0,0,8940,8940,0,0,0,0,0
984,p1110,20110930,8940,8940,0,0,0,8940,8940,0,0,0,0,0
985,p1110,20111010,8940,8940,0,0,0,8940,8940,0,0,0,0,0
986,p1110,20111011,8940,8940,0,0,0,8940,8940,0,0,0,0,0
987,p1110,20111012,8940,8940,0,0,0,8940,8940,0,0,0,0,0
988,p1110,20111013,8940,8940,0,0,0,8940,8940,0,0,0,0,0
989,p1110,20111014,8940,8940,0,0,0,8940,8940,0,0,0,0,0
990,p1110,20111017,8940,8940,0,0,0,8940,8940,0,0,0,0,0
991,p1110,20111018,8940,8940,0,0,0,8940,8940,0,0,0,0,0
992,p1110,20111019,8940,8940,0,0,0,8940,8940,0,0,0,0,0
993,p1110,20111020,8940,8940,0,0,0,8940,8940,0,0,0,0,0
994,p1110,20111021,8940,8940,0,0,0,8940,8940,0,0,0,0,0
995,p1111,20110104,9792,9802,0,0,0,9802,9802,0,0,0,0,160
996,p1111,20110105,9802,9802,0,0,0,9802,9802,0,0,0,0,160
997,p1111,20110106,9802,9802,0,0,0,9802,9802,0,0,0,0,160
998,p1111,20110107,9802,9802,0,0,0,9802,9802,0,0,0,0,160
999,p1111,20110110,9802,9802,0,0,0,9802,9802,0,0,0,0,160
1000,p1111,20110111,9802,9802,9810,9810,9810,9810,9810,8,8,140,13734000,20
1001,p1111,20110112,9810,9810,9940,9940,9940,9940,9940,130,130,2,198800,20
1002,p1111,20110113,9940,9940,10528,10528,9890,9890,10208,-50,268,4,408360,20
1003,p1111,20110114,9890,10208,0,0,0,10208,10208,0,0,0,0,20
1004,p1111,20110117,10208,10208,0,0,0,10208,10208,0,0,0,0,20
1005,p1111,20110118,10208,10208,0,0,0,10208,10208,0,0,0,0,20
1006,p1111,20110119,10208,10208,10000,10000,10000,10000,10000,-208,-208,2,200000,22
1007,p1111,20110120,10000,10000,0,0,0,10000,10000,0,0,0,0,22
1008,p1111,20110121,10000,10000,0,0,0,10000,10000,0,0,0,0,22
1009,p1111,20110124,10000,10000,0,0,0,10000,10000,0,0,0,0,22
1010,p1111,20110125,10000,10000,0,0,0,10000,10000,0,0,0,0,22
1011,p1111,20110126,10000,10000,9476,9476,9476,9476,9476,-524,-524,2,189520,24
1012,p1111,20110127,9476,9476,9748,9748,9748,9748,9748,272,272,2,194960,24
1013,p1111,20110128,9748,9748,9702,9702,9700,9700,9700,-48,-48,4,388040,24
1014,p1111,20110131,9700,9700,0,0,0,9700,9700,0,0,0,0,24
1015,p1111,20110201,9700,9700,0,0,0,9700,9700,0,0,0,0,24
1016,p1111,20110209,9700,9700,10060,10060,10060,10060,10060,360,360,4,402400,24
1017,p1111,20110210,10060,10060,10258,10334,10220,10300,10262,240,202,16,1642000,22
1018,p1111,20110211,10300,10262,10162,10162,10160,10160,10160,-102,-102,4,406440,26
1019,p1111,20110214,10160,10160,0,0,0,10160,10160,0,0,0,0,26
1020,p1111,20110215,10160,10160,0,0,0,10160,10160,0,0,0,0,26
1021,p1111,20110216,10160,10160,9850,9850,9850,9850,9850,-310,-310,2,197000,26
1022,p1111,20110217,9850,9850,9780,9780,9780,9780,9780,-70,-70,2,195600,26
1023,p1111,20110218,9780,9780,9730,9730,9730,9730,9730,-50,-50,2,194600,26
1024,p1111,20110221,9730,9730,0,0,0,9730,9730,0,0,0,0,26
1025,p1111,20110222,9730,9730,9680,9680,9680,9680,9680,-50,-50,2,193600,26
1026,p1111,20110223,9680,9680,9504,9504,9366,9366,9458,-314,-222,6,567480,26
1027,p1111,20110224,9366,9458,9390,9390,9160,9160,9274,-298,-184,4,371000,26
1028,p1111,20110225,9160,9274,0,0,0,9274,9274,0,0,0,0,26
1029,p1111,20110228,9274,9274,0,0,0,9274,9274,0,0,0,0,26
1030,p1111,20110301,9274,9274,9402,9402,9402,9402,9402,128,128,2,188040,26
1031,p1111,20110302,9402,9402,0,0,0,9402,9402,0,0,0,0,26
1032,p1111,20110303,9402,9402,9550,9620,9550,9620,9572,218,170,6,574400,26
1033,p1111,20110304,9620,9572,0,0,0,9572,9572,0,0,0,0,26
1034,p1111,20110307,9572,9572,0,0,0,9572,9572,0,0,0,0,26
1035,p1111,20110308,9572,9572,9530,9530,9500,9500,9514,-72,-58,4,380600,26
1036,p1111,20110309,9500,9514,9450,9450,9450,9450,9450,-64,-64,2,189000,26
1037,p1111,20110310,9450,9450,9260,9260,9260,9260,9260,-190,-190,2,185200,26
1038,p1111,20110311,9260,9260,0,0,0,9260,9260,0,0,0,0,26
1039,p1111,20110314,9260,9260,9090,9106,8990,8990,9062,-270,-198,10,906320,22
1040,p1111,20110315,8990,9062,9030,9030,9030,9030,9030,-32,-32,2,180600,22
1041,p1111,20110316,9030,9030,8860,8890,8860,8890,8874,-140,-156,4,355000,22
1042,p1111,20110317,8890,8874,0,0,0,8874,8874,0,0,0,0,22
1043,p1111,20110318,8874,8874,0,0,0,8874,8874,0,0,0,0,22
1044,p1111,20110321,8874,8874,0,0,0,8874,8874,0,0,0,0,22
1045,p1111,20110322,8874,8874,9222,9222,9190,9190,9206,316,332,4,368240,24
1046,p1111,20110323,9190,9206,9200,9200,9200,9200,9200,-6,-6,2,184000,24
1047,p1111,20110324,9200,9200,9140,9140,9000,9000,9086,-200,-114,8,726920,24
1048,p1111,20110325,9000,9086,0,0,0,9086,9086,0,0,0,0,24
1049,p1111,20110328,9086,9086,9170,9170,9060,9060,9114,-26,28,4,364600,26
1050,p1111,20110329,9060,9114,9030,9060,9030,9060,9050,-54,-64,6,543000,26
1051,p1111,20110330,9060,9050,0,0,0,9050,9050,0,0,0,0,26
1052,p1111,20110331,9050,9050,0,0,0,9050,9050,0,0,0,0,26
1053,p1111,20110401,9050,9050,9248,9300,9248,9300,9274,250,224,4,370960,26
1054,p1111,20110406,9300,9274,0,0,0,9274,9274,0,0,0,0,26
1055,p1111,20110407,9274,9274,9352,9352,9320,9320,9336,46,62,4,373440,26
1056,p1111,20110408,9320,9336,0,0,0,9336,9336,0,0,0,0,26
1057,p1111,20110411,9336,9336,0,0,0,9336,9336,0,0,0,0,26
1058,p1111,20110412,9336,9336,0,0,0,9336,9336,0,0,0,0,26
1059,p1111,20110413,9336,9336,0,0,0,9336,9336,0,0,0,0,26
1060,p1111,20110414,9336,9336,9236,9236,9236,9236,9236,-100,-100,2,184720,26
1061,p1111,20110415,9236,9236,9092,9092,9092,9092,9092,-144,-144,2,181840,26
1062,p1111,20110418,9092,9092,0,0,0,9092,9092,0,0,0,0,26
1063,p1111,20110419,9092,9092,0,0,0,9092,9092,0,0,0,0,26
1064,p1111,20110420,9092,9092,0,0,0,9092,9092,0,0,0,0,26
1065,p1111,20110421,9092,9092,0,0,0,9092,9092,0,0,0,0,26
1066,p1111,20110422,9092,9092,0,0,0,9092,9092,0,0,0,0,26
1067,p1111,20110425,9092,9092,0,0,0,9092,9092,0,0,0,0,26
1068,p1111,20110426,9092,9092,0,0,0,9092,9092,0,0,0,0,26
1069,p1111,20110427,9092,9092,0,0,0,9092,9092,0,0,0,0,26
1070,p1111,20110428,9092,9092,0,0,0,9092,9092,0,0,0,0,26
1071,p1111,20110429,9092,9092,0,0,0,9092,9092,0,0,0,0,26
1072,p1111,20110503,9092,9092,0,0,0,9092,9092,0,0,0,0,26
1073,p1111,20110504,9092,9092,0,0,0,9092,9092,0,0,0,0,26
1074,p1111,20110505,9092,9092,9080,9292,9080,9114,9194,22,102,8,735560,30
1075,p1111,20110506,9114,9194,8982,8982,8982,8982,8982,-212,-212,2,179640,30
1076,p1111,20110509,8982,8982,8910,8910,8910,8910,8910,-72,-72,6,534600,30
1077,p1111,20110510,8910,8910,0,0,0,8910,8910,0,0,0,0,30
1078,p1111,20110511,8910,8910,0,0,0,8910,8910,0,0,0,0,30
1079,p1111,20110512,8910,8910,0,0,0,8910,8910,0,0,0,0,30
1080,p1111,20110513,8910,8910,8930,8930,8930,8930,8930,20,20,8,714400,22
1081,p1111,20110516,8930,8930,0,0,0,8930,8930,0,0,0,0,22
1082,p1111,20110517,8930,8930,8900,8900,8900,8900,8900,-30,-30,2,178000,22
1083,p1111,20110518,8900,8900,0,0,0,8900,8900,0,0,0,0,22
1084,p1111,20110519,8900,8900,0,0,0,8900,8900,0,0,0,0,22
1085,p1111,20110520,8900,8900,0,0,0,8900,8900,0,0,0,0,22
1086,p1111,20110523,8900,8900,0,0,0,8900,8900,0,0,0,0,22
1087,p1111,20110524,8900,8900,0,0,0,8900,8900,0,0,0,0,22
1088,p1111,20110525,8900,8900,0,0,0,8900,8900,0,0,0,0,22
1089,p1111,20110526,8900,8900,9342,9344,9342,9344,9342,444,442,4,373720,18
1090,p1111,20110527,9344,9342,0,0,0,9342,9342,0,0,0,0,18
1091,p1111,20110530,9342,9342,0,0,0,9342,9342,0,0,0,0,18
1092,p1111,20110531,9342,9342,0,0,0,9342,9342,0,0,0,0,18
1093,p1111,20110601,9342,9342,0,0,0,9342,9342,0,0,0,0,18
1094,p1111,20110602,9342,9342,9342,9342,9342,9342,9342,0,0,4,373680,14
1095,p1111,20110603,9342,9342,0,0,0,9342,9342,0,0,0,0,14
1096,p1111,20110607,9342,9342,0,0,0,9342,9342,0,0,0,0,14
1097,p1111,20110608,9342,9342,9302,9302,9302,9302,9302,-40,-40,2,186040,14
1098,p1111,20110609,9302,9302,9418,9478,9418,9478,9448,176,146,4,377920,12
1099,p1111,20110610,9478,9448,9250,9250,9250,9250,9250,-198,-198,4,370000,10
1100,p1111,20110613,9250,9250,9248,9248,9248,9248,9248,-2,-2,2,184960,8
1101,p1111,20110614,9248,9248,0,0,0,9248,9248,0,0,0,0,8
1102,p1111,20110615,9248,9248,0,0,0,9248,9248,0,0,0,0,8
1103,p1111,20110616,9248,9248,0,0,0,9248,9248,0,0,0,0,8
1104,p1111,20110617,9248,9248,9102,9102,9102,9102,9102,-146,-146,2,182040,8
1105,p1111,20110620,9102,9102,0,0,0,9102,9102,0,0,0,0,8
1106,p1111,20110621,9102,9102,0,0,0,9102,9102,0,0,0,0,8
1107,p1111,20110622,9102,9102,0,0,0,9102,9102,0,0,0,0,8
1108,p1111,20110623,9102,9102,0,0,0,9102,9102,0,0,0,0,8
1109,p1111,20110624,9102,9102,9000,9000,9000,9000,9000,-102,-102,2,180000,8
1110,p1111,20110627,9000,9000,8802,8802,8802,8802,8802,-198,-198,2,176040,8
1111,p1111,20110628,8802,8802,0,0,0,8802,8802,0,0,0,0,8
1112,p1111,20110629,8802,8802,0,0,0,8802,8802,0,0,0,0,8
1113,p1111,20110630,8802,8802,0,0,0,8802,8802,0,0,0,0,8
1114,p1111,20110701,8802,8802,0,0,0,8802,8802,0,0,0,0,8
1115,p1111,20110704,8802,8802,0,0,0,8802,8802,0,0,0,0,8
1116,p1111,20110705,8802,8802,0,0,0,8802,8802,0,0,0,0,8
1117,p1111,20110706,8802,8802,0,0,0,8802,8802,0,0,0,0,8
1118,p1111,20110707,8802,8802,0,0,0,8802,8802,0,0,0,0,8
1119,p1111,20110708,8802,8802,0,0,0,8802,8802,0,0,0,0,8
1120,p1111,20110711,8802,8802,0,0,0,8802,8802,0,0,0,0,8
1121,p1111,20110712,8802,8802,9100,9100,8868,8868,8984,66,182,4,359360,8
1122,p1111,20110713,8868,8984,0,0,0,8984,8984,0,0,0,0,8
1123,p1111,20110714,8984,8984,0,0,0,8984,8984,0,0,0,0,8
1124,p1111,20110715,8984,8984,0,0,0,8984,8984,0,0,0,0,8
1125,p1111,20110718,8984,8984,0,0,0,8984,8984,0,0,0,0,8
1126,p1111,20110719,8984,8984,0,0,0,8984,8984,0,0,0,0,8
1127,p1111,20110720,8984,8984,8900,9190,8900,9190,9000,206,16,108,9722080,24
1128,p1111,20110721,9190,9000,0,0,0,9000,9000,0,0,0,0,24
1129,p1111,20110722,9000,9000,9162,9162,9122,9140,9142,140,142,12,1097080,24
1130,p1111,20110725,9140,9142,0,0,0,9142,9142,0,0,0,0,24
1131,p1111,20110726,9142,9142,9082,9090,9082,9090,9086,-52,-56,4,363440,24
1132,p1111,20110727,9090,9086,0,0,0,9086,9086,0,0,0,0,24
1133,p1111,20110728,9086,9086,9160,9160,9128,9128,9144,42,58,4,365760,22
1134,p1111,20110729,9128,9144,0,0,0,9144,9144,0,0,0,0,22
1135,p1111,20110801,9144,9144,9058,9070,9058,9070,9064,-74,-80,4,362560,22
1136,p1111,20110802,9070,9064,0,0,0,9064,9064,0,0,0,0,22
1137,p1111,20110803,9064,9064,0,0,0,9064,9064,0,0,0,0,22
1138,p1111,20110804,9064,9064,9106,9122,9092,9122,9108,58,44,14,1275280,24
1139,p1111,20110805,9122,9108,8824,8872,8824,8872,8840,-236,-268,6,530400,26
1140,p1111,20110808,8872,8840,0,0,0,8840,8840,0,0,0,0,26
1141,p1111,20110809,8840,8840,8452,8620,8452,8620,8536,-220,-304,4,341440,24
1142,p1111,20110810,8620,8536,8734,8734,8734,8734,8734,198,198,2,174680,24
1143,p1111,20110811,8734,8734,8686,8686,8686,8686,8686,-48,-48,2,173720,26
1144,p1111,20110812,8686,8686,0,0,0,8686,8686,0,0,0,0,26
1145,p1111,20110815,8686,8686,0,0,0,8686,8686,0,0,0,0,26
1146,p1111,20110816,8686,8686,8842,8930,8826,8830,8848,144,162,12,1061960,22
1147,p1111,20110817,8830,8848,0,0,0,8848,8848,0,0,0,0,22
1148,p1111,20110818,8848,8848,8880,8880,8832,8832,8856,-16,8,4,354240,22
1149,p1111,20110819,8832,8856,0,0,0,8856,8856,0,0,0,0,22
1150,p1111,20110822,8856,8856,8802,8802,8802,8802,8802,-54,-54,2,176040,22
1151,p1111,20110823,8802,8802,0,0,0,8802,8802,0,0,0,0,22
1152,p1111,20110824,8802,8802,8926,8926,8926,8926,8926,124,124,2,178520,22
1153,p1111,20110825,8926,8926,8836,8836,8836,8836,8836,-90,-90,2,176720,22
1154,p1111,20110826,8836,8836,8848,8848,8848,8848,8848,12,12,2,176960,22
1155,p1111,20110829,8848,8848,0,0,0,8848,8848,0,0,0,0,22
1156,p1111,20110830,8848,8848,8830,8830,8830,8830,8830,-18,-18,4,353200,22
1157,p1111,20110831,8830,8830,0,0,0,8830,8830,0,0,0,0,22
1158,p1111,20110901,8830,8830,0,0,0,8830,8830,0,0,0,0,22
1159,p1111,20110902,8830,8830,0,0,0,8830,8830,0,0,0,0,22
1160,p1111,20110905,8830,8830,0,0,0,8830,8830,0,0,0,0,22
1161,p1111,20110906,8830,8830,8800,8800,8800,8800,8800,-30,-30,2,176000,22
1162,p1111,20110907,8800,8800,0,0,0,8800,8800,0,0,0,0,22
1163,p1111,20110908,8800,8800,0,0,0,8800,8800,0,0,0,0,22
1164,p1111,20110909,8800,8800,0,0,0,8800,8800,0,0,0,0,22
1165,p1111,20110913,8800,8800,8814,8838,8814,8838,8826,38,26,4,353040,22
1166,p1111,20110914,8838,8826,8702,8702,8702,8702,8702,-124,-124,2,174040,22
1167,p1111,20110915,8702,8702,0,0,0,8702,8702,0,0,0,0,22
1168,p1111,20110916,8702,8702,0,0,0,8702,8702,0,0,0,0,22
1169,p1111,20110919,8702,8702,0,0,0,8702,8702,0,0,0,0,22
1170,p1111,20110920,8702,8702,0,0,0,8702,8702,0,0,0,0,22
1171,p1111,20110921,8702,8702,0,0,0,8702,8702,0,0,0,0,22
1172,p1111,20110922,8702,8702,8552,8552,8552,8552,8552,-150,-150,2,171040,22
1173,p1111,20110923,8552,8552,8450,8450,8450,8450,8450,-102,-102,2,169000,22
1174,p1111,20110926,8450,8450,8166,8436,8028,8028,8192,-422,-258,28,2294120,16
1175,p1111,20110927,8028,8192,8088,8088,8088,8088,8088,-104,-104,12,970560,14
1176,p1111,20110928,8088,8088,7940,7940,7940,7940,7940,-148,-148,2,158800,12
1177,p1111,20110929,7940,7940,0,0,0,7940,7940,0,0,0,0,12
1178,p1111,20110930,7940,7940,0,0,0,7940,7940,0,0,0,0,12
1179,p1111,20111010,7940,7940,7750,7840,7700,7708,7754,-232,-186,16,1240720,4
1180,p1111,20111011,7708,7754,0,0,0,7754,7754,0,0,0,0,4
1181,p1111,20111012,7754,7754,0,0,0,7754,7754,0,0,0,0,4
1182,p1111,20111013,7754,7754,0,0,0,7754,7754,0,0,0,0,4
1183,p1111,20111014,7754,7754,0,0,0,7754,7754,0,0,0,0,4
1184,p1111,20111017,7754,7754,0,0,0,7754,7754,0,0,0,0,4
1185,p1111,20111018,7754,7754,0,0,0,7754,7754,0,0,0,0,4
1186,p1111,20111019,7754,7754,0,0,0,7754,7754,0,0,0,0,4
1187,p1111,20111020,7754,7754,8000,8000,7500,7500,7750,-254,-4,4,310000,4
1188,p1111,20111021,7500,7750,0,0,0,7750,7750,0,0,0,0,4
1189,p1111,20111024,7750,7750,0,0,0,7750,7750,0,0,0,0,4
1190,p1111,20111025,7750,7750,0,0,0,7750,7750,0,0,0,0,4
1191,p1111,20111026,7750,7750,7406,7410,7406,7410,7408,-340,-342,4,296320,4
1192,p1111,20111027,7410,7408,7778,7778,7778,7778,7778,370,370,4,311120,0
1193,p1111,20111028,7778,7778,0,0,0,7778,7778,0,0,0,0,0
1194,p1111,20111031,7778,7778,0,0,0,7778,7778,0,0,0,0,0
1195,p1111,20111101,7778,7778,0,0,0,7778,7778,0,0,0,0,0
1196,p1111,20111102,7778,7778,0,0,0,7778,7778,0,0,0,0,0
1197,p1111,20111103,7778,7778,0,0,0,7778,7778,0,0,0,0,0
1198,p1111,20111104,7778,7778,0,0,0,7778,7778,0,0,0,0,0
1199,p1111,20111107,7778,7778,0,0,0,7778,7778,0,0,0,0,0
1200,p1111,20111108,7778,7778,0,0,0,7778,7778,0,0,0,0,0
1201,p1111,20111109,7778,7778,0,0,0,7778,7778,0,0,0,0,0
1202,p1111,20111110,7778,7778,0,0,0,7778,7778,0,0,0,0,0
1203,p1111,20111111,7778,7778,0,0,0,7778,7778,0,0,0,0,0
1204,p1111,20111114,7778,7778,0,0,0,7778,7778,0,0,0,0,0
1205,p1112,20110104,9342,9342,0,0,0,9342,9342,0,0,0,0,0
1206,p1112,20110105,9342,9342,0,0,0,9342,9342,0,0,0,0,0
1207,p1112,20110106,9342,9342,9720,10088,9720,10088,9804,746,462,12,1176600,10
1208,p1112,20110107,10088,9804,10318,10318,9450,9450,9922,-354,118,24,2381600,10
1209,p1112,20110110,9450,9922,10030,10030,10030,10030,10030,108,108,2,200600,8
1210,p1112,20110111,10030,10030,0,0,0,10030,10030,0,0,0,0,8
1211,p1112,20110112,10030,10030,0,0,0,10030,10030,0,0,0,0,8
1212,p1112,20110113,10030,10030,0,0,0,10030,10030,0,0,0,0,8
1213,p1112,20110114,10030,10030,0,0,0,10030,10030,0,0,0,0,8
1214,p1112,20110117,10030,10030,0,0,0,10030,10030,0,0,0,0,8
1215,p1112,20110118,10030,10030,0,0,0,10030,10030,0,0,0,0,8
1216,p1112,20110119,10030,10030,0,0,0,10030,10030,0,0,0,0,8
1217,p1112,20110120,10030,10030,0,0,0,10030,10030,0,0,0,0,8
1218,p1112,20110121,10030,10030,0,0,0,10030,10030,0,0,0,0,8
1219,p1112,20110124,10030,10030,0,0,0,10030,10030,0,0,0,0,8
1220,p1112,20110125,10030,10030,0,0,0,10030,10030,0,0,0,0,8
1221,p1112,20110126,10030,10030,0,0,0,10030,10030,0,0,0,0,8
1222,p1112,20110127,10030,10030,0,0,0,10030,10030,0,0,0,0,8
1223,p1112,20110128,10030,10030,0,0,0,10030,10030,0,0,0,0,8
1224,p1112,20110131,10030,10030,10030,10030,9854,9854,9942,-176,-88,4,397680,10
1225,p1112,20110201,9854,9942,0,0,0,9942,9942,0,0,0,0,10
1226,p1112,20110209,9942,9942,0,0,0,9942,9942,0,0,0,0,10
1227,p1112,20110210,9942,9942,10232,10232,10232,10232,10232,290,290,2,204640,8
1228,p1112,20110211,10232,10232,0,0,0,10232,10232,0,0,0,0,8
1229,p1112,20110214,10232,10232,0,0,0,10232,10232,0,0,0,0,8
1230,p1112,20110215,10232,10232,9812,10214,9812,10214,10012,-18,-220,4,400520,8
1231,p1112,20110216,10214,10012,0,0,0,10012,10012,0,0,0,0,8
1232,p1112,20110217,10012,10012,9784,9900,9784,9900,9842,-112,-170,4,393680,8
1233,p1112,20110218,9900,9842,0,0,0,9842,9842,0,0,0,0,8
1234,p1112,20110221,9842,9842,0,0,0,9842,9842,0,0,0,0,8
1235,p1112,20110222,9842,9842,0,0,0,9842,9842,0,0,0,0,8
1236,p1112,20110223,9842,9842,0,0,0,9842,9842,0,0,0,0,8
1237,p1112,20110224,9842,9842,0,0,0,9842,9842,0,0,0,0,8
1238,p1112,20110225,9842,9842,9256,9430,9252,9394,9314,-448,-528,12,1117720,8
1239,p1112,20110228,9394,9314,0,0,0,9314,9314,0,0,0,0,8
1240,p1112,20110301,9314,9314,0,0,0,9314,9314,0,0,0,0,8
1241,p1112,20110302,9314,9314,0,0,0,9314,9314,0,0,0,0,8
1242,p1112,20110303,9314,9314,9420,9420,9420,9420,9420,106,106,2,188400,8
1243,p1112,20110304,9420,9420,0,0,0,9420,9420,0,0,0,0,8
1244,p1112,20110307,9420,9420,0,0,0,9420,9420,0,0,0,0,8
1245,p1112,20110308,9420,9420,0,0,0,9420,9420,0,0,0,0,8
1246,p1112,20110309,9420,9420,0,0,0,9420,9420,0,0,0,0,8
1247,p1112,20110310,9420,9420,0,0,0,9420,9420,0,0,0,0,8
1248,p1112,20110311,9420,9420,0,0,0,9420,9420,0,0,0,0,8
1249,p1112,20110314,9420,9420,9010,9010,9010,9010,9010,-410,-410,2,180200,8
1250,p1112,20110315,9010,9010,0,0,0,9010,9010,0,0,0,0,8
1251,p1112,20110316,9010,9010,8904,8904,8904,8904,8904,-106,-106,2,178080,8
1252,p1112,20110317,8904,8904,9106,9194,8854,9000,9028,96,124,10,902880,8
1253,p1112,20110318,9000,9028,0,0,0,9028,9028,0,0,0,0,8
1254,p1112,20110321,9028,9028,0,0,0,9028,9028,0,0,0,0,8
1255,p1112,20110322,9028,9028,9166,9166,9166,9166,9166,138,138,2,183320,8
1256,p1112,20110323,9166,9166,0,0,0,9166,9166,0,0,0,0,8
1257,p1112,20110324,9166,9166,0,0,0,9166,9166,0,0,0,0,8
1258,p1112,20110325,9166,9166,0,0,0,9166,9166,0,0,0,0,8
1259,p1112,20110328,9166,9166,9218,9218,9218,9218,9218,52,52,2,184360,8
1260,p1112,20110329,9218,9218,0,0,0,9218,9218,0,0,0,0,8
1261,p1112,20110330,9218,9218,0,0,0,9218,9218,0,0,0,0,8
1262,p1112,20110331,9218,9218,0,0,0,9218,9218,0,0,0,0,8
1263,p1112,20110401,9218,9218,9448,9480,9252,9398,9384,180,166,58,5443120,48
1264,p1112,20110406,9398,9384,9470,9470,9362,9362,9434,-22,50,6,566040,48
1265,p1112,20110407,9362,9434,9450,9450,9416,9416,9432,-18,-2,4,377320,48
1266,p1112,20110408,9416,9432,0,0,0,9432,9432,0,0,0,0,48
1267,p1112,20110411,9432,9432,9610,9700,9610,9656,9658,224,226,34,3283720,28
1268,p1112,20110412,9656,9658,9460,9460,9460,9460,9460,-198,-198,2,189200,28
1269,p1112,20110413,9460,9460,9300,9300,9300,9300,9300,-160,-160,2,186000,28
1270,p1112,20110414,9300,9300,9280,9280,9280,9280,9280,-20,-20,2,185600,28
1271,p1112,20110415,9280,9280,9280,9280,9190,9190,9236,-90,-44,8,738920,28
1272,p1112,20110418,9190,9236,9160,9160,9160,9160,9160,-76,-76,2,183200,28
1273,p1112,20110419,9160,9160,9200,9258,9156,9156,9166,-4,6,26,2383480,6
1274,p1112,20110420,9156,9166,0,0,0,9166,9166,0,0,0,0,6
1275,p1112,20110421,9166,9166,9232,9298,9232,9280,9270,114,104,6,556200,6
1276,p1112,20110422,9280,9270,9300,9428,9300,9428,9364,158,94,8,749120,8
1277,p1112,20110425,9428,9364,9400,9400,9400,9400,9400,36,36,2,188000,6
1278,p1112,20110426,9400,9400,0,0,0,9400,9400,0,0,0,0,6
1279,p1112,20110427,9400,9400,9228,9230,9136,9190,9184,-210,-216,12,1102200,10
1280,p1112,20110428,9190,9184,9324,9324,9242,9300,9288,116,104,6,557320,10
1281,p1112,20110429,9300,9288,0,0,0,9288,9288,0,0,0,0,10
1282,p1112,20110503,9288,9288,0,0,0,9288,9288,0,0,0,0,10
1283,p1112,20110504,9288,9288,9092,9148,9066,9066,9106,-222,-182,16,1457040,14
1284,p1112,20110505,9066,9106,9068,9068,9040,9040,9054,-66,-52,8,724320,10
1285,p1112,20110506,9040,9054,8950,8950,8900,8900,8922,-154,-132,8,713800,6
1286,p1112,20110509,8900,8922,8980,8980,8896,8902,8918,-20,-4,8,713480,10
1287,p1112,20110510,8902,8918,9246,9246,9246,9246,9246,328,328,4,369840,14
1288,p1112,20110511,9246,9246,9020,9040,8982,8982,9014,-264,-232,12,1081680,14
1289,p1112,20110512,8982,9014,8900,8978,8900,8952,8942,-62,-72,28,2503880,22
1290,p1112,20110513,8952,8942,0,0,0,8942,8942,0,0,0,0,22
1291,p1112,20110516,8942,8942,0,0,0,8942,8942,0,0,0,0,22
1292,p1112,20110517,8942,8942,8872,8968,8844,8950,8898,8,-44,30,2669680,16
1293,p1112,20110518,8950,8898,9012,9020,9012,9020,9016,122,118,4,360640,18
1294,p1112,20110519,9020,9016,9100,9100,9100,9100,9100,84,84,2,182000,16
1295,p1112,20110520,9100,9100,0,0,0,9100,9100,0,0,0,0,16
1296,p1112,20110523,9100,9100,9202,9202,9120,9122,9148,22,48,6,548880,16
1297,p1112,20110524,9122,9148,0,0,0,9148,9148,0,0,0,0,16
1298,p1112,20110525,9148,9148,9190,9190,9190,9190,9190,42,42,2,183800,16
1299,p1112,20110526,9190,9190,0,0,0,9190,9190,0,0,0,0,16
1300,p1112,20110527,9190,9190,0,0,0,9190,9190,0,0,0,0,16
1301,p1112,20110530,9190,9190,9388,9388,9360,9360,9374,170,184,4,374960,16
1302,p1112,20110531,9360,9374,0,0,0,9374,9374,0,0,0,0,16
1303,p1112,20110601,9374,9374,9374,9400,9270,9272,9296,-102,-78,56,5206560,22
1304,p1112,20110602,9272,9296,9270,9270,9270,9270,9270,-26,-26,20,1854000,6
1305,p1112,20110603,9270,9270,0,0,0,9270,9270,0,0,0,0,6
1306,p1112,20110607,9270,9270,9400,9400,9400,9400,9400,130,130,2,188000,4
1307,p1112,20110608,9400,9400,9452,9452,9126,9126,9238,-274,-162,36,3326200,36
1308,p1112,20110609,9126,9238,9360,9408,9340,9392,9386,154,148,40,3754400,4
1309,p1112,20110610,9392,9386,9340,9342,9280,9280,9326,-106,-60,8,746080,6
1310,p1112,20110613,9280,9326,9264,9278,9182,9224,9222,-102,-104,86,7931920,4
1311,p1112,20110614,9224,9222,0,0,0,9222,9222,0,0,0,0,4
1312,p1112,20110615,9222,9222,0,0,0,9222,9222,0,0,0,0,4
1313,p1112,20110616,9222,9222,0,0,0,9222,9222,0,0,0,0,4
1314,p1112,20110617,9222,9222,9022,9158,9022,9130,9110,-92,-112,8,728800,6
1315,p1112,20110620,9130,9110,9082,9082,9082,9082,9082,-28,-28,2,181640,4
1316,p1112,20110621,9082,9082,0,0,0,9082,9082,0,0,0,0,4
1317,p1112,20110622,9082,9082,0,0,0,9082,9082,0,0,0,0,4
1318,p1112,20110623,9082,9082,8968,9150,8968,9060,9060,-22,-22,10,906000,4
1319,p1112,20110624,9060,9060,8962,9000,8962,9000,8980,-60,-80,4,359240,4
1320,p1112,20110627,9000,8980,8834,8834,8834,8834,8834,-146,-146,2,176680,4
1321,p1112,20110628,8834,8834,0,0,0,8834,8834,0,0,0,0,4
1322,p1112,20110629,8834,8834,0,0,0,8834,8834,0,0,0,0,4
1323,p1112,20110630,8834,8834,0,0,0,8834,8834,0,0,0,0,4
1324,p1112,20110701,8834,8834,0,0,0,8834,8834,0,0,0,0,4
1325,p1112,20110704,8834,8834,0,0,0,8834,8834,0,0,0,0,4
1326,p1112,20110705,8834,8834,0,0,0,8834,8834,0,0,0,0,4
1327,p1112,20110706,8834,8834,9072,9072,9072,9072,9072,238,238,2,181440,6
1328,p1112,20110707,9072,9072,8902,8902,8902,8902,8902,-170,-170,2,178040,4
1329,p1112,20110708,8902,8902,8972,9062,8972,9040,9024,138,122,6,541480,4
1330,p1112,20110711,9040,9024,0,0,0,9024,9024,0,0,0,0,4
1331,p1112,20110712,9024,9024,0,0,0,9024,9024,0,0,0,0,4
1332,p1112,20110713,9024,9024,0,0,0,9024,9024,0,0,0,0,4
1333,p1112,20110714,9024,9024,0,0,0,9024,9024,0,0,0,0,4
1334,p1112,20110715,9024,9024,0,0,0,9024,9024,0,0,0,0,4
1335,p1112,20110718,9024,9024,8992,9120,8992,9000,9036,-24,12,6,542240,4
1336,p1112,20110719,9000,9036,0,0,0,9036,9036,0,0,0,0,4
1337,p1112,20110720,9036,9036,0,0,0,9036,9036,0,0,0,0,4
1338,p1112,20110721,9036,9036,0,0,0,9036,9036,0,0,0,0,4
1339,p1112,20110722,9036,9036,0,0,0,9036,9036,0,0,0,0,4
1340,p1112,20110725,9036,9036,0,0,0,9036,9036,0,0,0,0,4
1341,p1112,20110726,9036,9036,0,0,0,9036,9036,0,0,0,0,4
1342,p1112,20110727,9036,9036,0,0,0,9036,9036,0,0,0,0,4
1343,p1112,20110728,9036,9036,0,0,0,9036,9036,0,0,0,0,4
1344,p1112,20110729,9036,9036,0,0,0,9036,9036,0,0,0,0,4
1345,p1112,20110801,9036,9036,9080,9080,9010,9010,9044,-26,8,4,361800,6
1346,p1112,20110802,9010,9044,0,0,0,9044,9044,0,0,0,0,6
1347,p1112,20110803,9044,9044,9242,9242,9100,9100,9170,56,126,4,366840,8
1348,p1112,20110804,9100,9170,0,0,0,9170,9170,0,0,0,0,8
1349,p1112,20110805,9170,9170,8712,8904,8712,8838,8822,-332,-348,8,705840,8
1350,p1112,20110808,8838,8822,8742,8742,8742,8742,8742,-80,-80,2,174840,6
1351,p1112,20110809,8742,8742,0,0,0,8742,8742,0,0,0,0,6
1352,p1112,20110810,8742,8742,0,0,0,8742,8742,0,0,0,0,6
1353,p1112,20110811,8742,8742,0,0,0,8742,8742,0,0,0,0,6
1354,p1112,20110812,8742,8742,0,0,0,8742,8742,0,0,0,0,6
1355,p1112,20110815,8742,8742,8890,8890,8890,8890,8890,148,148,2,177800,8
1356,p1112,20110816,8890,8890,8830,8830,8818,8818,8824,-72,-66,4,352960,10
1357,p1112,20110817,8818,8824,0,0,0,8824,8824,0,0,0,0,10
1358,p1112,20110818,8824,8824,8804,8898,8804,8830,8854,6,30,14,1239680,10
1359,p1112,20110819,8830,8854,0,0,0,8854,8854,0,0,0,0,10
1360,p1112,20110822,8854,8854,8636,8890,8636,8890,8752,36,-102,10,875240,10
1361,p1112,20110823,8890,8752,8880,8900,8778,8900,8864,148,112,8,709160,8
1362,p1112,20110824,8900,8864,8866,8968,8820,8914,8894,50,30,22,1957000,10
1363,p1112,20110825,8914,8894,8822,8920,8822,8920,8870,26,-24,4,354840,8
1364,p1112,20110826,8920,8870,0,0,0,8870,8870,0,0,0,0,8
1365,p1112,20110829,8870,8870,0,0,0,8870,8870,0,0,0,0,8
1366,p1112,20110830,8870,8870,0,0,0,8870,8870,0,0,0,0,8
1367,p1112,20110831,8870,8870,0,0,0,8870,8870,0,0,0,0,8
1368,p1112,20110901,8870,8870,8858,9016,8858,9016,8948,146,78,14,1252880,6
1369,p1112,20110902,9016,8948,0,0,0,8948,8948,0,0,0,0,6
1370,p1112,20110905,8948,8948,8936,8936,8936,8936,8936,-12,-12,2,178720,8
1371,p1112,20110906,8936,8936,8840,8840,8840,8840,8840,-96,-96,2,176800,8
1372,p1112,20110907,8840,8840,0,0,0,8840,8840,0,0,0,0,8
1373,p1112,20110908,8840,8840,0,0,0,8840,8840,0,0,0,0,8
1374,p1112,20110909,8840,8840,0,0,0,8840,8840,0,0,0,0,8
1375,p1112,20110913,8840,8840,0,0,0,8840,8840,0,0,0,0,8
1376,p1112,20110914,8840,8840,8700,8700,8700,8700,8700,-140,-140,2,174000,8
1377,p1112,20110915,8700,8700,0,0,0,8700,8700,0,0,0,0,8
1378,p1112,20110916,8700,8700,0,0,0,8700,8700,0,0,0,0,8
1379,p1112,20110919,8700,8700,0,0,0,8700,8700,0,0,0,0,8
1380,p1112,20110920,8700,8700,0,0,0,8700,8700,0,0,0,0,8
1381,p1112,20110921,8700,8700,8748,8748,8606,8686,8676,-14,-24,40,3471120,8
1382,p1112,20110922,8686,8676,0,0,0,8676,8676,0,0,0,0,8
1383,p1112,20110923,8676,8676,8506,8506,8506,8506,8506,-170,-170,2,170120,8
1384,p1112,20110926,8506,8506,0,0,0,8506,8506,0,0,0,0,8
1385,p1112,20110927,8506,8506,0,0,0,8506,8506,0,0,0,0,8
1386,p1112,20110928,8506,8506,8284,8284,8284,8284,8284,-222,-222,4,331360,12
1387,p1112,20110929,8284,8284,0,0,0,8284,8284,0,0,0,0,12
1388,p1112,20110930,8284,8284,0,0,0,8284,8284,0,0,0,0,12
1389,p1112,20111010,8284,8284,8058,8058,7748,7748,7902,-536,-382,4,316120,12
1390,p1112,20111011,7748,7902,7900,7900,7900,7900,7900,-2,-2,4,316000,8
1391,p1112,20111012,7900,7900,0,0,0,7900,7900,0,0,0,0,8
1392,p1112,20111013,7900,7900,0,0,0,7900,7900,0,0,0,0,8
1393,p1112,20111014,7900,7900,0,0,0,7900,7900,0,0,0,0,8
1394,p1112,20111017,7900,7900,0,0,0,7900,7900,0,0,0,0,8
1395,p1112,20111018,7900,7900,0,0,0,7900,7900,0,0,0,0,8
1396,p1112,20111019,7900,7900,0,0,0,7900,7900,0,0,0,0,8
1397,p1112,20111020,7900,7900,0,0,0,7900,7900,0,0,0,0,8
1398,p1112,20111021,7900,7900,0,0,0,7900,7900,0,0,0,0,8
1399,p1112,20111024,7900,7900,0,0,0,7900,7900,0,0,0,0,8
1400,p1112,20111025,7900,7900,0,0,0,7900,7900,0,0,0,0,8
1401,p1112,20111026,7900,7900,8292,8292,8000,8000,8146,100,246,4,325840,8
1402,p1112,20111027,8000,8146,0,0,0,8146,8146,0,0,0,0,8
1403,p1112,20111028,8146,8146,0,0,0,8146,8146,0,0,0,0,8
1404,p1112,20111031,8146,8146,0,0,0,8146,8146,0,0,0,0,8
1405,p1112,20111101,8146,8146,0,0,0,8146,8146,0,0,0,0,8
1406,p1112,20111102,8146,8146,0,0,0,8146,8146,0,0,0,0,8
1407,p1112,20111103,8146,8146,7946,7946,7946,7946,7946,-200,-200,10,794600,10
1408,p1112,20111104,7946,7946,7582,7698,7582,7698,7640,-248,-306,4,305600,10
1409,p1112,20111107,7698,7640,0,0,0,7640,7640,0,0,0,0,10
1410,p1112,20111108,7640,7640,0,0,0,7640,7640,0,0,0,0,10
1411,p1112,20111109,7640,7640,0,0,0,7640,7640,0,0,0,0,10
1412,p1112,20111110,7640,7640,0,0,0,7640,7640,0,0,0,0,10
1413,p1112,20111111,7640,7640,0,0,0,7640,7640,0,0,0,0,10
1414,p1112,20111114,7640,7640,0,0,0,7640,7640,0,0,0,0,10
1415,p1112,20111115,7640,7640,0,0,0,7640,7640,0,0,0,0,10
1416,p1112,20111116,7640,7640,0,0,0,7640,7640,0,0,0,0,10
1417,p1112,20111117,7640,7640,0,0,0,7640,7640,0,0,0,0,10
1418,p1112,20111118,7640,7640,7274,8008,7274,7606,7672,-34,32,20,1534640,12
1419,p1112,20111121,7606,7672,0,0,0,7672,7672,0,0,0,0,12
1420,p1112,20111122,7672,7672,0,0,0,7672,7672,0,0,0,0,12
1421,p1112,20111123,7672,7672,7302,7302,7302,7302,7302,-370,-370,2,146040,10
1422,p1112,20111124,7302,7302,0,0,0,7302,7302,0,0,0,0,10
1423,p1112,20111125,7302,7302,0,0,0,7302,7302,0,0,0,0,10
1424,p1112,20111128,7302,7302,0,0,0,7302,7302,0,0,0,0,10
1425,p1112,20111129,7302,7302,7664,7664,7664,7664,7664,362,362,2,153280,10
1426,p1112,20111130,7664,7664,7282,7282,7282,7282,7282,-382,-382,10,728200,0
1427,p1112,20111201,7282,7282,0,0,0,7282,7282,0,0,0,0,0
1428,p1112,20111202,7282,7282,0,0,0,7282,7282,0,0,0,0,0
1429,p1112,20111205,7282,7282,0,0,0,7282,7282,0,0,0,0,0
1430,p1112,20111206,7282,7282,0,0,0,7282,7282,0,0,0,0,0
1431,p1112,20111207,7282,7282,0,0,0,7282,7282,0,0,0,0,0
1432,p1112,20111208,7282,7282,0,0,0,7282,7282,0,0,0,0,0
1433,p1112,20111209,7282,7282,0,0,0,7282,7282,0,0,0,0,0
1434,p1112,20111212,7282,7282,0,0,0,7282,7282,0,0,0,0,0
1435,p1112,20111213,7282,7282,0,0,0,7282,7282,0,0,0,0,0
1436,p1112,20111214,7282,7282,0,0,0,7282,7282,0,0,0,0,0
1437,p1201,20110119,9678,9592,9718,9812,9700,9800,9694,208,102,336,32576480,250
1438,p1201,20110120,9800,9694,9796,9866,9736,9782,9778,88,84,214,20925320,286
1439,p1201,20110121,9782,9778,9782,9814,9732,9784,9780,6,2,276,26997480,488
1440,p1201,20110124,9784,9780,9850,10062,9846,9936,9986,156,206,1164,116251120,1006
1441,p1201,20110125,9936,9986,9866,9902,9766,9766,9876,-220,-110,238,23509600,1068
1442,p1201,20110126,9766,9876,9566,9772,9416,9544,9512,-332,-364,444,42238240,1106
1443,p1201,20110127,9544,9512,9666,9700,9610,9646,9664,134,152,530,51225240,1192
1444,p1201,20110128,9646,9664,9670,9672,9608,9630,9648,-34,-16,274,26440080,1378
1445,p1201,20110131,9630,9648,9670,9826,9670,9808,9786,160,138,422,41301680,1384
1446,p1201,20110201,9808,9786,9888,9896,9822,9864,9864,78,78,170,16769720,1414
1447,p1201,20110209,9864,9864,9968,10060,9942,10060,10020,196,156,1180,118238760,1758
1448,p1201,20110210,10060,10020,10000,10226,10000,10132,10164,112,144,564,57328720,1868
1449,p1201,20110211,10132,10164,10064,10148,10064,10106,10116,-58,-48,1418,143464080,2464
1450,p1201,20110214,10106,10116,10132,10148,10034,10144,10116,28,0,1874,189577640,3116
1451,p1201,20110215,10144,10116,10000,10064,9942,9990,10024,-126,-92,1916,192087920,3784
1452,p1201,20110216,9990,10024,9900,9900,9688,9740,9788,-284,-236,2816,275650800,5262
1453,p1201,20110217,9740,9788,9788,9800,9570,9570,9700,-218,-88,5740,556798280,7988
1454,p1201,20110218,9570,9700,9690,9724,9508,9508,9600,-192,-100,3520,337975880,9306
1455,p1201,20110221,9508,9600,9500,9518,9426,9462,9488,-138,-112,4340,411840400,11420
1456,p1201,20110222,9462,9488,9550,9604,9440,9536,9516,48,28,6240,593897680,13420
1457,p1201,20110223,9536,9516,9200,9200,8952,9108,9118,-408,-398,5224,476368640,14432
1458,p1201,20110224,9108,9118,9168,9190,8844,8974,9042,-144,-76,3130,283020640,14452
1459,p1201,20110225,8974,9042,9000,9182,9000,9180,9112,138,70,3998,364341160,13060
1460,p1201,20110228,9180,9112,9312,9336,9202,9282,9284,170,172,3572,331625760,14264
1461,p1201,20110301,9282,9284,9260,9300,9200,9266,9254,-18,-30,5432,502737680,15710
1462,p1201,20110302,9266,9254,9280,9434,9260,9410,9352,156,98,3908,365519080,15992
1463,p1201,20110303,9410,9352,9452,9500,9360,9366,9422,14,70,3600,339251560,16106
1464,p1201,20110304,9366,9422,9392,9484,9392,9474,9450,52,28,3278,309789720,16308
1465,p1201,20110307,9474,9450,9468,9524,9450,9510,9490,60,40,2812,266877520,16458
1466,p1201,20110308,9510,9490,9450,9456,9292,9340,9388,-150,-102,4632,434934840,16408
1467,p1201,20110309,9340,9388,9340,9376,9260,9270,9310,-118,-78,2178,202781840,17004
1468,p1201,20110310,9270,9310,9160,9194,9102,9124,9166,-186,-144,3346,306720360,17496
1469,p1201,20110311,9124,9166,9100,9198,9058,9064,9114,-102,-52,4856,442620800,17714
1470,p1201,20110314,9064,9114,8960,9040,8880,8900,8932,-214,-182,9464,845360320,20832
1471,p1201,20110315,8900,8932,8922,8990,8900,8980,8952,48,20,12156,1088338680,26216
1472,p1201,20110316,8980,8952,8822,8860,8682,8852,8776,-100,-176,8890,780291320,26618
1473,p1201,20110317,8852,8776,8816,8968,8796,8922,8902,146,126,8282,737321720,26728
1474,p1201,20110318,8922,8902,9068,9118,9012,9116,9082,214,180,7886,716349600,25368
1475,p1201,20110321,9116,9082,9132,9240,9132,9210,9192,128,110,10404,956538480,25118
1476,p1201,20110322,9210,9192,9188,9188,9090,9094,9132,-98,-60,15482,1414042960,31310
1477,p1201,20110323,9094,9132,9100,9184,9076,9178,9140,46,8,26722,2442780240,44834
1478,p1201,20110324,9178,9140,9130,9150,8920,8920,9044,-220,-96,31956,2890608880,58094
1479,p1201,20110325,8920,9044,9018,9128,9000,9072,9070,28,26,22102,2004847120,58178
1480,p1201,20110328,9072,9070,9100,9180,8998,9106,9110,36,40,37916,3454823240,64962
1481,p1201,20110329,9106,9110,9090,9092,8996,9062,9048,-48,-62,24076,2178773440,67982
1482,p1201,20110330,9062,9048,9100,9208,9094,9188,9154,140,106,29354,2687197200,70466
1483,p1201,20110331,9188,9154,9188,9216,9120,9176,9174,22,20,25700,2358199760,71830
1484,p1201,20110401,9176,9174,9318,9318,9248,9256,9274,82,100,28766,2667920120,73556
1485,p1201,20110406,9256,9274,9256,9380,9248,9376,9342,102,68,37364,3490824280,82698
1486,p1201,20110407,9376,9342,9358,9390,9304,9330,9342,-12,0,38422,3589391120,88392
1487,p1201,20110408,9330,9342,9302,9436,9282,9430,9354,88,12,57786,5406070480,99520
1488,p1201,20110411,9430,9354,9566,9640,9488,9576,9580,222,226,83608,8010468000,114308
1489,p1201,20110412,9576,9580,9500,9530,9360,9370,9430,-210,-150,97584,9202179840,115784
1490,p1201,20110413,9370,9430,9282,9292,9212,9284,9250,-146,-180,94102,8704633400,113414
1491,p1201,20110414,9284,9250,9250,9300,9162,9164,9234,-86,-16,136508,12605454960,114248
1492,p1201,20110415,9164,9234,9216,9238,9100,9108,9176,-126,-58,128964,11835010320,115820
1493,p1201,20110418,9108,9176,9094,9150,9040,9132,9108,-44,-68,100670,9170081560,121820
1494,p1201,20110419,9132,9108,9188,9200,9032,9056,9104,-52,-4,131062,11931980640,128576
1495,p1201,20110420,9056,9104,9108,9248,9102,9246,9186,142,82,134362,12344416280,130250
1496,p1201,20110421,9246,9186,9240,9280,9200,9240,9232,54,46,139942,12921882960,130042
1497,p1201,20110422,9240,9232,9280,9364,9250,9362,9310,130,78,181450,16894347760,143646
1498,p1201,20110425,9362,9310,9380,9398,9304,9320,9344,10,34,168014,15701704600,137058
1499,p1201,20110426,9320,9344,9264,9264,9166,9170,9200,-174,-144,144850,13327620920,131468
1500,p1201,20110427,9170,9200,9216,9242,9124,9142,9188,-58,-12,163014,14978516200,130842
1501,p1201,20110428,9142,9188,9180,9294,9172,9294,9238,106,50,176846,16338351000,137908
1502,p1201,20110429,9294,9238,9150,9164,9054,9070,9090,-168,-148,200766,18251413280,135974
1503,p1201,20110503,9070,9090,9170,9192,9136,9186,9164,96,74,114712,10514357240,132708
1504,p1201,20110504,9186,9164,9140,9140,9046,9086,9080,-78,-84,140850,12791005240,141456
1505,p1201,20110505,9086,9080,9046,9104,8974,9084,9054,4,-26,189884,17192755240,142684
1506,p1201,20110506,9084,9054,8860,8930,8822,8832,8878,-222,-176,251428,22323610040,152888
1507,p1201,20110509,8832,8878,8884,8930,8870,8908,8900,30,22,136148,12118834800,148062
1508,p1201,20110510,8908,8900,8918,9004,8892,8988,8948,88,48,175506,15705063400,137038
1509,p1201,20110511,8988,8948,9030,9040,8974,8984,9002,36,54,141008,12695722520,138308
1510,p1201,20110512,8984,9002,8950,9028,8874,8880,8960,-122,-42,248628,22279583800,153156
1511,p1201,20110513,8880,8960,8952,9036,8934,9022,8982,62,22,178238,16012041520,145222
1512,p1201,20110516,9022,8982,8976,8986,8916,8932,8946,-50,-36,184224,16482193680,152960
1513,p1201,20110517,8932,8946,8920,8940,8830,8924,8882,-22,-64,230124,20440648400,140228
1514,p1201,20110518,8924,8882,8950,9022,8948,8984,8992,102,110,143316,12888140760,137604
1515,p1201,20110519,8984,8992,9100,9108,9042,9056,9072,64,80,114856,10420659400,130618
1516,p1201,20110520,9056,9072,9088,9190,9064,9184,9122,112,50,212194,19359893160,150670
1517,p1201,20110523,9184,9122,9196,9214,9102,9128,9162,6,40,184226,16882219720,141110
1518,p1201,20110524,9128,9162,9162,9262,9120,9246,9182,84,20,183630,16863643720,161832
1519,p1201,20110525,9246,9182,9230,9238,9158,9184,9192,2,10,188030,17286929280,159314
1520,p1201,20110526,9184,9192,9240,9286,9234,9278,9256,86,64,155388,14384037880,148680
1521,p1201,20110527,9278,9256,9298,9304,9252,9290,9276,34,20,128834,11950936400,135822
1522,p1201,20110530,9290,9276,9286,9372,9262,9330,9332,54,56,151460,14136355560,137504
1523,p1201,20110531,9330,9332,9320,9344,9280,9294,9306,-38,-26,130708,12165083520,138008
1524,p1201,20110601,9294,9306,9302,9330,9250,9262,9284,-44,-22,134692,12505666480,141308
1525,p1201,20110602,9262,9284,9252,9294,9214,9292,9248,8,-36,138370,12797704560,146238
1526,p1201,20110603,9292,9248,9350,9476,9328,9470,9394,222,146,167714,15755415960,156708
1527,p1201,20110607,9470,9394,9330,9374,9302,9348,9340,-46,-54,155518,14525871320,154968
1528,p1201,20110608,9348,9340,9350,9386,9262,9298,9324,-42,-16,179450,16735453000,162128
1529,p1201,20110609,9298,9324,9332,9364,9286,9286,9330,-38,6,150814,14071698680,164904
1530,p1201,20110610,9286,9330,9260,9282,9172,9180,9230,-150,-100,203446,18778364200,173734
1531,p1201,20110613,9180,9230,9162,9190,9136,9160,9170,-70,-60,133086,12205040280,182842
1532,p1201,20110614,9160,9170,9170,9220,9160,9200,9190,30,20,124126,11407892080,184178
1533,p1201,20110615,9200,9190,9200,9246,9170,9214,9210,24,20,152002,14000359720,190096
1534,p1201,20110616,9214,9210,9190,9192,9082,9100,9132,-110,-78,182402,16659421640,194420
1535,p1201,20110617,9100,9132,9090,9106,9020,9046,9066,-86,-66,150654,13659180200,200724
1536,p1201,20110620,9046,9066,9030,9090,9016,9040,9058,-26,-8,148784,13478726160,204964
1537,p1201,20110621,9040,9058,9068,9108,9056,9100,9086,42,28,109264,9928954480,206074
1538,p1201,20110622,9100,9086,9110,9118,9048,9062,9084,-24,-2,108218,9830985920,205554
1539,p1201,20110623,9062,9084,9040,9040,8924,8996,8974,-88,-110,167660,15047688720,207886
1540,p1201,20110624,8996,8974,8920,8972,8912,8916,8936,-58,-38,154132,13775444800,212586
1541,p1201,20110627,8916,8936,8890,8890,8716,8720,8800,-216,-136,220718,19426756600,225322
1542,p1201,20110628,8720,8800,8768,8812,8710,8732,8758,-68,-42,184182,16132870720,236568
1543,p1201,20110629,8732,8758,8800,8832,8780,8822,8806,64,48,126590,11148405880,222820
1544,p1201,20110630,8822,8806,8830,8894,8820,8888,8870,82,64,101882,9038235400,212406
1545,p1201,20110701,8888,8870,8780,8790,8722,8788,8764,-82,-106,147960,12968952240,216664
1546,p1201,20110704,8788,8764,8806,8890,8800,8872,8854,108,90,145332,12868885800,225224
1547,p1201,20110705,8872,8854,8876,8914,8818,8842,8860,-12,6,181288,16062187520,243156
1548,p1201,20110706,8842,8860,8848,8876,8790,8828,8828,-32,-32,161690,14276329480,254802
1549,p1201,20110707,8828,8828,8826,8860,8806,8842,8832,14,4,137018,12102386680,256426
1550,p1201,20110708,8842,8832,8904,8980,8904,8940,8948,108,116,157116,14059580920,240554
1551,p1201,20110711,8940,8948,8932,8984,8922,8932,8962,-16,14,103878,9311026440,232676
1552,p1201,20110712,8932,8962,8916,8936,8804,8844,8860,-118,-102,140460,12445000240,235274
1553,p1201,20110713,8844,8860,8880,8956,8880,8954,8928,94,68,118936,10619595440,227652
1554,p1201,20110714,8954,8928,9030,9030,8946,8984,8978,56,50,91868,8249444080,214562
1555,p1201,20110715,8984,8978,8972,8988,8902,8976,8946,-2,-32,88304,7901432160,198606
1556,p1201,20110718,8976,8946,8962,9022,8932,8934,8980,-12,34,68800,6179578880,179322
1557,p1201,20110719,8934,8980,8950,8968,8930,8968,8948,-12,-32,37398,3346572080,171670
1558,p1201,20110720,8968,8948,8960,9046,8912,9024,8986,76,38,69850,6276817520,147642
1559,p1201,20110721,9024,8986,9000,9078,9000,9060,9046,74,60,44216,4000592560,140444
1560,p1201,20110722,9060,9046,9030,9068,9030,9062,9050,16,4,19912,1802424720,137068
1561,p1201,20110725,9062,9050,9030,9040,8936,8940,8988,-110,-62,31162,2800876960,132198
1562,p1201,20110726,8940,8988,8950,8994,8936,8990,8960,2,-28,17114,1533583440,128336
1563,p1201,20110727,8990,8960,9010,9060,9010,9044,9038,84,78,25926,2343518240,122216
1564,p1201,20110728,9044,9038,9020,9024,8962,8966,8984,-72,-54,24642,2214306360,116516
1565,p1201,20110729,8966,8984,8950,8990,8912,8920,8948,-64,-36,26896,2406977240,114546
1566,p1201,20110801,8920,8948,8960,9040,8956,9036,8992,88,44,24924,2241362200,104618
1567,p1201,20110802,9036,8992,9020,9098,9016,9034,9054,42,62,27106,2454352320,99264
1568,p1201,20110803,9034,9054,9090,9100,9050,9052,9064,-2,10,24226,2196008760,92208
1569,p1201,20110804,9052,9064,9038,9038,8964,8976,8996,-88,-68,23724,2134472760,86086
1570,p1201,20110805,8976,8996,8840,8850,8624,8734,8748,-262,-248,40132,3511281680,79398
1571,p1201,20110808,8734,8748,8700,8758,8672,8704,8716,-44,-32,17686,1541747480,80738
1572,p1201,20110809,8704,8716,8522,8542,8352,8528,8478,-188,-238,25150,2132521200,77518
1573,p1201,20110810,8528,8478,8560,8620,8556,8590,8580,112,102,14596,1252623840,73512
1574,p1201,20110811,8590,8580,8550,8608,8532,8606,8562,26,-18,13728,1175396280,70148
1575,p1201,20110812,8606,8562,8652,8700,8620,8626,8650,64,88,9140,790659960,71058
1576,p1201,20110815,8626,8650,8662,8736,8662,8720,8710,70,60,7906,688721560,68128
1577,p1201,20110816,8720,8710,8750,8768,8670,8680,8714,-30,4,12954,1129014440,67232
1578,p1201,20110817,8680,8714,8712,8736,8702,8712,8720,-2,6,5688,496091040,67162
1579,p1201,20110818,8712,8720,8790,8790,8702,8710,8722,-10,2,6062,528754120,67346
1580,p1201,20110819,8710,8722,8660,8684,8622,8684,8650,-38,-72,7386,639004240,66162
1581,p1201,20110822,8684,8650,8700,8730,8672,8680,8710,30,60,4490,391150080,65146
1582,p1201,20110823,8680,8710,8728,8790,8714,8790,8752,80,42,6250,547045440,64120
1583,p1201,20110824,8790,8752,8770,8804,8750,8770,8778,18,26,3134,275102920,63336
1584,p1201,20110825,8770,8778,8760,8782,8726,8740,8744,-38,-34,3222,281746840,62696
1585,p1201,20110826,8740,8744,8746,8746,8652,8666,8690,-78,-54,6828,593412720,61258
1586,p1201,20110829,8666,8690,8750,8810,8750,8796,8776,106,86,11384,999248400,57256
1587,p1201,20110830,8796,8776,8850,8852,8788,8802,8818,26,42,8882,783279640,52470
1588,p1201,20110831,8802,8818,8850,8894,8822,8880,8858,62,40,10662,944597800,45828
1589,p1201,20110901,8880,8858,8866,8912,8850,8868,8880,10,22,3370,299280400,44440
1590,p1201,20110902,8868,8880,8848,8872,8832,8866,8856,-14,-24,3224,285571440,42958
1591,p1201,20110905,8866,8856,8860,8934,8826,8842,8882,-14,26,5458,484820600,41646
1592,p1201,20110906,8842,8882,8822,8822,8724,8788,8778,-94,-104,4498,394835760,42196
1593,p1201,20110907,8788,8778,8782,8878,8774,8878,8818,100,40,4346,383311880,40214
1594,p1201,20110908,8878,8818,8872,8888,8810,8870,8858,52,40,4004,354683160,40150
1595,p1201,20110909,8870,8858,8858,8920,8832,8920,8886,62,28,4194,372731160,39550
1596,p1201,20110913,8920,8886,8890,8890,8782,8796,8804,-90,-82,8108,713931800,38790
1597,p1201,20110914,8796,8804,8806,8830,8682,8710,8748,-94,-56,6030,527593320,39330
1598,p1201,20110915,8710,8748,8748,8764,8702,8732,8742,-16,-6,5088,444834120,37256
1599,p1201,20110916,8732,8742,8712,8730,8684,8710,8704,-32,-38,1730,150608240,36962
1600,p1201,20110919,8710,8704,8694,8694,8574,8574,8620,-130,-84,3580,308649080,37242
1601,p1201,20110920,8574,8620,8600,8652,8570,8636,8634,16,14,2920,252125720,36230
1602,p1201,20110921,8636,8634,8620,8640,8568,8624,8610,-10,-24,2600,223902880,35322
1603,p1201,20110922,8624,8610,8510,8524,8460,8466,8492,-144,-118,2040,173271760,34552
1604,p1201,20110923,8466,8492,8370,8374,8068,8184,8252,-308,-240,6652,549032280,32672
1605,p1201,20110926,8184,8252,8178,8196,7840,7840,8016,-412,-236,3084,247239360,31288
1606,p1201,20110927,7840,8016,7966,8120,7966,7990,8036,-26,20,12202,980618320,25788
1607,p1201,20110928,7990,8036,8020,8020,7880,7912,7944,-124,-92,3006,238834760,25280
1608,p1201,20110929,7912,7944,7548,7722,7548,7696,7678,-248,-266,4290,329451480,22828
1609,p1201,20110930,7696,7678,7732,7930,7728,7930,7850,252,172,4580,359551520,19834
1610,p1201,20111010,7930,7850,7680,7730,7652,7722,7742,-128,-108,3048,235996880,18382
1611,p1201,20111011,7722,7742,7750,7810,7698,7710,7754,-32,12,2106,163319520,17452
1612,p1201,20111012,7710,7754,7800,7900,7800,7880,7864,126,110,1474,115944360,16678
1613,p1201,20111013,7880,7864,7880,7888,7842,7872,7870,8,6,1530,120424840,15500
1614,p1201,20111014,7872,7870,7920,7924,7884,7910,7902,40,32,1782,140843200,15314
1615,p1201,20111017,7910,7902,7962,7988,7952,7960,7970,58,68,854,68066000,14942
1616,p1201,20111018,7960,7970,7870,7876,7808,7814,7846,-156,-124,1910,149877040,15070
1617,p1201,20111019,7814,7846,7892,7900,7824,7850,7872,4,26,1288,101403640,14196
1618,p1201,20111020,7850,7872,7712,7712,7570,7650,7646,-222,-226,1014,77549560,13506
1619,p1201,20111021,7650,7646,7680,7746,7680,7746,7720,100,74,2056,158756040,12830
1620,p1201,20111024,7746,7720,7760,7890,7702,7840,7804,120,84,2706,211189160,12782
1621,p1201,20111025,7840,7804,7850,7920,7842,7882,7880,78,76,736,58010120,12676
1622,p1201,20111026,7882,7880,7788,7900,7788,7832,7836,-48,-44,240,18808200,12672
1623,p1201,20111027,7832,7836,7810,7938,7808,7934,7904,98,68,494,39046720,12440
1624,p1201,20111028,7934,7904,7998,8010,7916,7920,7948,16,44,1030,81871520,11778
1625,p1201,20111031,7920,7948,7920,7920,7806,7840,7842,-108,-106,136,10665280,11734
1626,p1201,20111101,7840,7842,7870,7884,7752,7808,7820,-34,-22,312,24402080,11698
1627,p1201,20111102,7808,7820,7808,7850,7684,7848,7786,28,-34,784,61050560,11538
1628,p1201,20111103,7848,7786,7870,7870,7772,7788,7810,2,24,280,21870440,11398
1629,p1201,20111104,7788,7810,7788,7906,7788,7898,7888,88,78,174,13726360,11400
1630,p1201,20111107,7898,7888,7898,7898,7810,7810,7832,-78,-56,66,5169360,11380
1631,p1201,20111108,7810,7832,7800,7836,7734,7818,7798,-14,-34,98,7642680,11308
1632,p1201,20111109,7818,7798,7860,7914,7842,7858,7870,60,72,1168,91936040,10822
1633,p1201,20111110,7858,7870,7780,7784,7682,7762,7750,-108,-120,156,12091320,10850
1634,p1201,20111111,7762,7750,7778,7900,7778,7862,7854,112,104,1834,144056920,10420
1635,p1201,20111114,7862,7854,7950,8006,7932,7964,7964,110,110,1114,88729000,9626
1636,p1201,20111115,7964,7964,7912,8002,7910,7990,7954,26,-10,610,48530360,9112
1637,p1201,20111116,7990,7954,8028,8068,7898,7910,7948,-44,-6,850,67561720,8330
1638,p1201,20111117,7910,7948,7956,8040,7934,8004,8008,56,60,1278,102349840,8716
1639,p1201,20111118,8004,8008,7818,8030,7810,7920,7930,-88,-78,1230,97553280,8876
1640,p1201,20111121,7920,7930,7900,7946,7884,7884,7902,-46,-28,322,25444840,8624
1641,p1201,20111122,7884,7902,7850,7860,7786,7786,7822,-116,-80,234,18304240,8450
1642,p1201,20111123,7786,7822,7810,7820,7740,7756,7772,-66,-50,936,72761880,7766
1643,p1201,20111124,7756,7772,7654,7740,7550,7578,7582,-194,-190,344,26085400,7682
1644,p1201,20111125,7578,7582,7578,7596,7520,7542,7558,-40,-24,292,22074680,7554
1645,p1201,20111128,7542,7558,7558,7600,7558,7592,7594,34,36,176,13367000,7484
1646,p1201,20111129,7592,7594,7582,7622,7574,7622,7602,28,8,400,30412680,7208
1647,p1201,20111130,7622,7602,7630,7630,7540,7540,7560,-62,-42,140,10585440,7156
1648,p1201,20111201,7540,7560,7598,7720,7598,7692,7666,132,106,872,66849400,6692
1649,p1201,20111202,7692,7666,7730,7730,7638,7700,7680,34,14,76,5837280,6634
1650,p1201,20111205,7700,7680,7702,7740,7702,7740,7730,60,50,50,3865000,6606
1651,p1201,20111206,7740,7730,7666,7700,7662,7700,7688,-30,-42,30,2306400,6594
1652,p1201,20111207,7700,7688,7742,7742,7710,7710,7710,22,22,22,1696280,6590
1653,p1201,20111208,7710,7710,7700,7700,7632,7662,7660,-48,-50,100,7660240,6534
1654,p1201,20111209,7662,7660,7650,7708,7650,7690,7684,30,24,132,10145160,6536
1655,p1201,20111212,7690,7684,7650,7680,7610,7610,7652,-74,-32,254,19438440,6552
1656,p1201,20111213,7610,7652,7648,7648,7600,7600,7620,-52,-32,32,2438520,6544
1657,p1201,20111214,7600,7620,7600,7600,7510,7540,7554,-80,-66,1180,89139240,5522
1658,p1201,20111215,7540,7554,7432,7500,7432,7442,7462,-112,-92,168,12538840,5512
1659,p1201,20111216,7442,7462,7460,7500,7456,7500,7488,38,26,38,2845800,5512
1660,p1201,20111219,7500,7488,7458,7534,7458,7528,7500,40,12,114,8551680,5428
1661,p1201,20111220,7528,7500,7470,7522,7400,7500,7498,0,-2,1388,104077880,4078
1662,p1201,20111221,7500,7498,7522,7538,7500,7512,7520,14,22,440,33090600,3856
1663,p1201,20111222,7512,7520,7512,7550,7512,7534,7540,14,20,208,15683360,3732
1664,p1201,20111223,7534,7540,7566,7582,7560,7566,7570,26,30,88,6661680,3732
1665,p1201,20111226,7566,7570,7566,7590,7548,7548,7580,-22,10,66,5003400,3732
1666,p1201,20111227,7548,7580,7514,7542,7500,7512,7532,-68,-48,126,9492520,3728
1667,p1201,20111228,7512,7532,7580,7600,7514,7552,7554,20,22,188,14202200,3722
1668,p1201,20111229,7552,7554,7530,7558,7530,7558,7542,4,-12,100,7543360,3710
1669,p1201,20111230,7558,7542,7548,7552,7394,7548,7536,6,-6,120,9043960,3702
1670,p1202,20110223,9600,9600,0,0,0,9600,9600,0,0,0,0,0
1671,p1202,20110224,9600,9600,0,0,0,9600,9600,0,0,0,0,0
1672,p1202,20110225,9600,9600,8964,9346,8962,9220,9116,-380,-484,38,3464120,8
1673,p1202,20110228,9220,9116,9300,9300,9300,9300,9300,184,184,2,186000,6
1674,p1202,20110301,9300,9300,0,0,0,9300,9300,0,0,0,0,6
1675,p1202,20110302,9300,9300,0,0,0,9300,9300,0,0,0,0,6
1676,p1202,20110303,9300,9300,9388,9468,9388,9468,9428,168,128,4,377120,6
1677,p1202,20110304,9468,9428,9458,9458,9458,9458,9458,30,30,4,378320,6
1678,p1202,20110307,9458,9458,9512,9512,9512,9512,9512,54,54,2,190240,4
1679,p1202,20110308,9512,9512,0,0,0,9512,9512,0,0,0,0,4
1680,p1202,20110309,9512,9512,0,0,0,9512,9512,0,0,0,0,4
1681,p1202,20110310,9512,9512,0,0,0,9512,9512,0,0,0,0,4
1682,p1202,20110311,9512,9512,0,0,0,9512,9512,0,0,0,0,4
1683,p1202,20110314,9512,9512,9150,9150,9100,9100,9132,-412,-380,6,547960,2
1684,p1202,20110315,9100,9132,9056,9056,9056,9056,9056,-76,-76,20,1811200,22
1685,p1202,20110316,9056,9056,0,0,0,9056,9056,0,0,0,0,22
1686,p1202,20110317,9056,9056,8960,8990,8940,8970,8966,-86,-90,14,1255440,24
1687,p1202,20110318,8970,8966,9106,9106,9106,9106,9106,140,140,2,182120,22
1688,p1202,20110321,9106,9106,9272,9272,9272,9272,9272,166,166,2,185440,20
1689,p1202,20110322,9272,9272,0,0,0,9272,9272,0,0,0,0,20
1690,p1202,20110323,9272,9272,0,0,0,9272,9272,0,0,0,0,20
1691,p1202,20110324,9272,9272,0,0,0,9272,9272,0,0,0,0,20
1692,p1202,20110325,9272,9272,0,0,0,9272,9272,0,0,0,0,20
1693,p1202,20110328,9272,9272,9230,9230,9134,9160,9174,-112,-98,12,1100960,20
1694,p1202,20110329,9160,9174,0,0,0,9174,9174,0,0,0,0,20
1695,p1202,20110330,9174,9174,9260,9260,9184,9200,9214,26,40,12,1105760,20
1696,p1202,20110331,9200,9214,0,0,0,9214,9214,0,0,0,0,20
1697,p1202,20110401,9214,9214,0,0,0,9214,9214,0,0,0,0,20
1698,p1202,20110406,9214,9214,0,0,0,9214,9214,0,0,0,0,20
1699,p1202,20110407,9214,9214,0,0,0,9214,9214,0,0,0,0,20
1700,p1202,20110408,9214,9214,0,0,0,9214,9214,0,0,0,0,20
1701,p1202,20110411,9214,9214,9674,9674,9674,9674,9674,460,460,6,580440,20
1702,p1202,20110412,9674,9674,0,0,0,9674,9674,0,0,0,0,20
1703,p1202,20110413,9674,9674,0,0,0,9674,9674,0,0,0,0,20
1704,p1202,20110414,9674,9674,9270,9498,9260,9260,9342,-414,-332,6,560560,20
1705,p1202,20110415,9260,9342,0,0,0,9342,9342,0,0,0,0,20
1706,p1202,20110418,9342,9342,9186,9248,9084,9248,9164,-94,-178,12,1099680,20
1707,p1202,20110419,9248,9164,0,0,0,9164,9164,0,0,0,0,20
1708,p1202,20110420,9164,9164,0,0,0,9164,9164,0,0,0,0,20
1709,p1202,20110421,9164,9164,0,0,0,9164,9164,0,0,0,0,20
1710,p1202,20110422,9164,9164,9306,9474,9306,9442,9410,278,246,48,4517320,22
1711,p1202,20110425,9442,9410,0,0,0,9410,9410,0,0,0,0,22
1712,p1202,20110426,9410,9410,9322,9322,9300,9300,9310,-110,-100,4,372440,22
1713,p1202,20110427,9300,9310,9290,9290,9290,9290,9290,-20,-20,2,185800,22
1714,p1202,20110428,9290,9290,9280,9280,9280,9280,9280,-10,-10,2,185600,20
1715,p1202,20110429,9280,9280,9120,9120,9120,9120,9120,-160,-160,4,364800,20
1716,p1202,20110503,9120,9120,9166,9320,9166,9230,9248,110,128,18,1664680,20
1717,p1202,20110504,9230,9248,0,0,0,9248,9248,0,0,0,0,20
1718,p1202,20110505,9248,9248,0,0,0,9248,9248,0,0,0,0,20
1719,p1202,20110506,9248,9248,8902,8902,8828,8828,8846,-420,-402,46,4069880,48
1720,p1202,20110509,8828,8846,9216,9216,8902,8970,8950,124,104,34,3043440,60
1721,p1202,20110510,8970,8950,8952,9048,8866,9010,8980,60,30,18,1616400,60
1722,p1202,20110511,9010,8980,0,0,0,8980,8980,0,0,0,0,60
1723,p1202,20110512,8980,8980,8960,9056,8852,8930,8976,-50,-4,40,3590400,62
1724,p1202,20110513,8930,8976,9018,9018,9018,9018,9018,42,42,2,180360,62
1725,p1202,20110516,9018,9018,0,0,0,9018,9018,0,0,0,0,62
1726,p1202,20110517,9018,9018,8872,8872,8822,8822,8856,-196,-162,14,1240080,56
1727,p1202,20110518,8822,8856,0,0,0,8856,8856,0,0,0,0,56
1728,p1202,20110519,8856,8856,9118,9118,9100,9100,9108,244,252,8,728720,52
1729,p1202,20110520,9100,9108,8924,9210,8924,9210,9066,102,-42,4,362680,54
1730,p1202,20110523,9210,9066,0,0,0,9066,9066,0,0,0,0,54
1731,p1202,20110524,9066,9066,9152,9228,9152,9156,9188,90,122,14,1286560,54
1732,p1202,20110525,9156,9188,9214,9230,9122,9198,9184,10,-4,22,2020600,54
1733,p1202,20110526,9198,9184,9290,9290,9290,9290,9290,106,106,4,371600,54
1734,p1202,20110527,9290,9290,0,0,0,9290,9290,0,0,0,0,54
1735,p1202,20110530,9290,9290,9340,9388,9340,9388,9368,98,78,10,936920,54
1736,p1202,20110531,9388,9368,9376,9376,9376,9376,9376,8,8,22,2062720,70
1737,p1202,20110601,9376,9376,9320,9320,9282,9300,9314,-76,-62,36,3353280,52
1738,p1202,20110602,9300,9314,9242,9360,9242,9360,9300,46,-14,4,372040,52
1739,p1202,20110603,9360,9300,0,0,0,9300,9300,0,0,0,0,52
1740,p1202,20110607,9300,9300,9340,9340,9340,9340,9340,40,40,2,186800,54
1741,p1202,20110608,9340,9340,9334,9340,9300,9340,9322,0,-18,8,745880,54
1742,p1202,20110609,9340,9322,9378,9378,9330,9330,9348,8,26,16,1495680,48
1743,p1202,20110610,9330,9348,9300,9300,9300,9300,9300,-48,-48,2,186000,46
1744,p1202,20110613,9300,9300,9142,9246,9142,9200,9186,-100,-114,10,918600,48
1745,p1202,20110614,9200,9186,9300,9300,9194,9240,9240,54,54,58,5359560,28
1746,p1202,20110615,9240,9240,9242,9242,9242,9242,9242,2,2,2,184840,28
1747,p1202,20110616,9242,9242,9220,9230,9160,9160,9216,-82,-26,32,2949320,26
1748,p1202,20110617,9160,9216,9142,9142,9142,9142,9142,-74,-74,4,365680,26
1749,p1202,20110620,9142,9142,0,0,0,9142,9142,0,0,0,0,26
1750,p1202,20110621,9142,9142,9132,9186,9108,9146,9140,4,-2,16,1462480,20
1751,p1202,20110622,9146,9140,9150,9150,9150,9150,9150,10,10,2,183000,20
1752,p1202,20110623,9150,9150,9052,9052,9000,9000,9024,-150,-126,6,541480,20
1753,p1202,20110624,9000,9024,0,0,0,9024,9024,0,0,0,0,20
1754,p1202,20110627,9024,9024,8892,8892,8892,8892,8892,-132,-132,2,177840,20
1755,p1202,20110628,8892,8892,8802,8802,8802,8802,8802,-90,-90,2,176040,20
1756,p1202,20110629,8802,8802,0,0,0,8802,8802,0,0,0,0,20
1757,p1202,20110630,8802,8802,0,0,0,8802,8802,0,0,0,0,20
1758,p1202,20110701,8802,8802,8820,8820,8820,8820,8820,18,18,2,176400,20
1759,p1202,20110704,8820,8820,0,0,0,8820,8820,0,0,0,0,20
1760,p1202,20110705,8820,8820,9160,9160,8910,8910,9000,90,180,18,1620040,22
1761,p1202,20110706,8910,9000,8890,8916,8890,8890,8898,-110,-102,6,533920,20
1762,p1202,20110707,8890,8898,0,0,0,8898,8898,0,0,0,0,20
1763,p1202,20110708,8898,8898,9052,9052,8968,9010,9006,112,108,10,900760,20
1764,p1202,20110711,9010,9006,0,0,0,9006,9006,0,0,0,0,20
1765,p1202,20110712,9006,9006,8980,8980,8950,8950,8964,-56,-42,8,717200,20
1766,p1202,20110713,8950,8964,0,0,0,8964,8964,0,0,0,0,20
1767,p1202,20110714,8964,8964,0,0,0,8964,8964,0,0,0,0,20
1768,p1202,20110715,8964,8964,0,0,0,8964,8964,0,0,0,0,20
1769,p1202,20110718,8964,8964,0,0,0,8964,8964,0,0,0,0,20
1770,p1202,20110719,8964,8964,9024,9024,9024,9024,9024,60,60,4,360960,20
1771,p1202,20110720,9024,9024,9054,9082,9032,9082,9058,58,34,18,1630760,20
1772,p1202,20110721,9082,9058,9180,9200,9140,9140,9184,82,126,10,918400,20
1773,p1202,20110722,9140,9184,0,0,0,9184,9184,0,0,0,0,20
1774,p1202,20110725,9184,9184,9060,9060,9060,9060,9060,-124,-124,6,543600,20
1775,p1202,20110726,9060,9060,0,0,0,9060,9060,0,0,0,0,20
1776,p1202,20110727,9060,9060,9180,9180,9122,9122,9150,62,90,4,366040,20
1777,p1202,20110728,9122,9150,0,0,0,9150,9150,0,0,0,0,20
1778,p1202,20110729,9150,9150,0,0,0,9150,9150,0,0,0,0,20
1779,p1202,20110801,9150,9150,0,0,0,9150,9150,0,0,0,0,20
1780,p1202,20110802,9150,9150,0,0,0,9150,9150,0,0,0,0,20
1781,p1202,20110803,9150,9150,0,0,0,9150,9150,0,0,0,0,20
1782,p1202,20110804,9150,9150,0,0,0,9150,9150,0,0,0,0,20
1783,p1202,20110805,9150,9150,8874,8874,8802,8822,8830,-328,-320,24,2119560,8
1784,p1202,20110808,8822,8830,8698,8916,8696,8780,8800,-50,-30,20,1760240,6
1785,p1202,20110809,8780,8800,8590,8700,8464,8600,8588,-200,-212,8,687080,6
1786,p1202,20110810,8600,8588,0,0,0,8588,8588,0,0,0,0,6
1787,p1202,20110811,8588,8588,0,0,0,8588,8588,0,0,0,0,6
1788,p1202,20110812,8588,8588,8740,8740,8740,8740,8740,152,152,2,174800,6
1789,p1202,20110815,8740,8740,0,0,0,8740,8740,0,0,0,0,6
1790,p1202,20110816,8740,8740,0,0,0,8740,8740,0,0,0,0,6
1791,p1202,20110817,8740,8740,0,0,0,8740,8740,0,0,0,0,6
1792,p1202,20110818,8740,8740,0,0,0,8740,8740,0,0,0,0,6
1793,p1202,20110819,8740,8740,0,0,0,8740,8740,0,0,0,0,6
1794,p1202,20110822,8740,8740,0,0,0,8740,8740,0,0,0,0,6
1795,p1202,20110823,8740,8740,8790,8900,8790,8900,8844,160,104,4,353800,8
1796,p1202,20110824,8900,8844,8876,8876,8876,8876,8876,32,32,2,177520,6
1797,p1202,20110825,8876,8876,0,0,0,8876,8876,0,0,0,0,6
1798,p1202,20110826,8876,8876,0,0,0,8876,8876,0,0,0,0,6
1799,p1202,20110829,8876,8876,0,0,0,8876,8876,0,0,0,0,6
1800,p1202,20110830,8876,8876,0,0,0,8876,8876,0,0,0,0,6
1801,p1202,20110831,8876,8876,0,0,0,8876,8876,0,0,0,0,6
1802,p1202,20110901,8876,8876,0,0,0,8876,8876,0,0,0,0,6
1803,p1202,20110902,8876,8876,0,0,0,8876,8876,0,0,0,0,6
1804,p1202,20110905,8876,8876,0,0,0,8876,8876,0,0,0,0,6
1805,p1202,20110906,8876,8876,0,0,0,8876,8876,0,0,0,0,6
1806,p1202,20110907,8876,8876,0,0,0,8876,8876,0,0,0,0,6
1807,p1202,20110908,8876,8876,8876,9180,8876,9180,9028,304,152,4,361120,8
1808,p1202,20110909,9180,9028,9030,9030,9030,9030,9030,2,2,2,180600,6
1809,p1202,20110913,9030,9030,8956,8956,8956,8956,8956,-74,-74,2,179120,6
1810,p1202,20110914,8956,8956,0,0,0,8956,8956,0,0,0,0,6
1811,p1202,20110915,8956,8956,0,0,0,8956,8956,0,0,0,0,6
1812,p1202,20110916,8956,8956,0,0,0,8956,8956,0,0,0,0,6
1813,p1202,20110919,8956,8956,8706,8760,8706,8760,8732,-196,-224,8,698640,6
1814,p1202,20110920,8760,8732,0,0,0,8732,8732,0,0,0,0,6
1815,p1202,20110921,8732,8732,0,0,0,8732,8732,0,0,0,0,6
1816,p1202,20110922,8732,8732,0,0,0,8732,8732,0,0,0,0,6
1817,p1202,20110923,8732,8732,0,0,0,8732,8732,0,0,0,0,6
1818,p1202,20110926,8732,8732,0,0,0,8732,8732,0,0,0,0,6
1819,p1202,20110927,8732,8732,0,0,0,8732,8732,0,0,0,0,6
1820,p1202,20110928,8732,8732,0,0,0,8732,8732,0,0,0,0,6
1821,p1202,20110929,8732,8732,0,0,0,8732,8732,0,0,0,0,6
1822,p1202,20110930,8732,8732,0,0,0,8732,8732,0,0,0,0,6
1823,p1202,20111010,8732,8732,0,0,0,8732,8732,0,0,0,0,6
1824,p1202,20111011,8732,8732,0,0,0,8732,8732,0,0,0,0,6
1825,p1202,20111012,8732,8732,8034,8034,8034,8034,8034,-698,-698,2,160680,6
1826,p1202,20111013,8034,8034,8168,8168,7980,7980,8074,-54,40,4,322960,8
1827,p1202,20111014,7980,8074,0,0,0,8074,8074,0,0,0,0,8
1828,p1202,20111017,8074,8074,0,0,0,8074,8074,0,0,0,0,8
1829,p1202,20111018,8074,8074,7970,7970,7970,7970,7970,-104,-104,2,159400,6
1830,p1202,20111019,7970,7970,0,0,0,7970,7970,0,0,0,0,6
1831,p1202,20111020,7970,7970,0,0,0,7970,7970,0,0,0,0,6
1832,p1202,20111021,7970,7970,0,0,0,7970,7970,0,0,0,0,6
1833,p1202,20111024,7970,7970,0,0,0,7970,7970,0,0,0,0,6
1834,p1202,20111025,7970,7970,0,0,0,7970,7970,0,0,0,0,6
1835,p1202,20111026,7970,7970,0,0,0,7970,7970,0,0,0,0,6
1836,p1202,20111027,7970,7970,0,0,0,7970,7970,0,0,0,0,6
1837,p1202,20111028,7970,7970,8088,8088,8088,8088,8088,118,118,4,323520,2
1838,p1202,20111031,8088,8088,0,0,0,8088,8088,0,0,0,0,2
1839,p1202,20111101,8088,8088,7850,8048,7850,8048,7948,-40,-140,12,953880,4
1840,p1202,20111102,8048,7948,0,0,0,7948,7948,0,0,0,0,4
1841,p1202,20111103,7948,7948,7838,7930,7838,7930,7886,-18,-62,6,473160,2
1842,p1202,20111104,7930,7886,0,0,0,7886,7886,0,0,0,0,2
1843,p1202,20111107,7886,7886,0,0,0,7886,7886,0,0,0,0,2
1844,p1202,20111108,7886,7886,7968,7968,7968,7968,7968,82,82,2,159360,0
1845,p1202,20111109,7968,7968,0,0,0,7968,7968,0,0,0,0,0
1846,p1202,20111110,7968,7968,0,0,0,7968,7968,0,0,0,0,0
1847,p1202,20111111,7968,7968,8364,8364,8016,8132,8184,164,216,22,1800880,6
1848,p1202,20111114,8132,8184,8050,8050,8050,8050,8050,-134,-134,2,161000,4
1849,p1202,20111115,8050,8050,0,0,0,8050,8050,0,0,0,0,4
1850,p1202,20111116,8050,8050,0,0,0,8050,8050,0,0,0,0,4
1851,p1202,20111117,8050,8050,8250,8290,8180,8264,8250,214,200,38,3135640,4
1852,p1202,20111118,8264,8250,0,0,0,8250,8250,0,0,0,0,4
1853,p1202,20111121,8250,8250,0,0,0,8250,8250,0,0,0,0,4
1854,p1202,20111122,8250,8250,0,0,0,8250,8250,0,0,0,0,4
1855,p1202,20111123,8250,8250,0,0,0,8250,8250,0,0,0,0,4
1856,p1202,20111124,8250,8250,0,0,0,8250,8250,0,0,0,0,4
1857,p1202,20111125,8250,8250,0,0,0,8250,8250,0,0,0,0,4
1858,p1202,20111128,8250,8250,0,0,0,8250,8250,0,0,0,0,4
1859,p1202,20111129,8250,8250,0,0,0,8250,8250,0,0,0,0,4
1860,p1202,20111130,8250,8250,0,0,0,8250,8250,0,0,0,0,4
1861,p1202,20111201,8250,8250,7962,8046,7900,7900,8008,-350,-242,14,1121160,10
1862,p1202,20111202,7900,8008,0,0,0,8008,8008,0,0,0,0,10
1863,p1202,20111205,8008,8008,7910,7910,7910,7910,7910,-98,-98,4,316400,10
1864,p1202,20111206,7910,7910,8068,8068,7746,8004,7940,94,30,20,1588160,8
1865,p1202,20111207,8004,7940,8076,8076,7970,7970,8022,30,82,4,320920,4
1866,p1202,20111208,7970,8022,0,0,0,8022,8022,0,0,0,0,4
1867,p1202,20111209,8022,8022,0,0,0,8022,8022,0,0,0,0,4
1868,p1202,20111212,8022,8022,0,0,0,8022,8022,0,0,0,0,4
1869,p1202,20111213,8022,8022,0,0,0,8022,8022,0,0,0,0,4
1870,p1202,20111214,8022,8022,0,0,0,8022,8022,0,0,0,0,4
1871,p1202,20111215,8022,8022,0,0,0,8022,8022,0,0,0,0,4
1872,p1202,20111216,8022,8022,0,0,0,8022,8022,0,0,0,0,4
1873,p1202,20111219,8022,8022,8076,8076,8076,8076,8076,54,54,4,323040,4
1874,p1202,20111220,8076,8076,0,0,0,8076,8076,0,0,0,0,4
1875,p1202,20111221,8076,8076,0,0,0,8076,8076,0,0,0,0,4
1876,p1202,20111222,8076,8076,0,0,0,8076,8076,0,0,0,0,4
1877,p1202,20111223,8076,8076,0,0,0,8076,8076,0,0,0,0,4
1878,p1202,20111226,8076,8076,0,0,0,8076,8076,0,0,0,0,4
1879,p1202,20111227,8076,8076,7676,7678,7674,7674,7674,-402,-402,24,1842160,18
1880,p1202,20111228,7674,7674,7728,7728,7728,7728,7728,54,54,2,154560,18
1881,p1202,20111229,7728,7728,0,0,0,7728,7728,0,0,0,0,18
1882,p1202,20111230,7728,7728,0,0,0,7728,7728,0,0,0,0,18
1883,p1203,20110316,9114,9114,0,0,0,9114,9114,0,0,0,0,0
1884,p1203,20110317,9114,9114,0,0,0,9114,9114,0,0,0,0,0
1885,p1203,20110318,9114,9114,0,0,0,9114,9114,0,0,0,0,0
1886,p1203,20110321,9114,9114,0,0,0,9114,9114,0,0,0,0,0
1887,p1203,20110322,9114,9114,0,0,0,9114,9114,0,0,0,0,0
1888,p1203,20110323,9114,9114,0,0,0,9114,9114,0,0,0,0,0
1889,p1203,20110324,9114,9114,0,0,0,9114,9114,0,0,0,0,0
1890,p1203,20110325,9114,9114,0,0,0,9114,9114,0,0,0,0,0
1891,p1203,20110328,9114,9114,0,0,0,9114,9114,0,0,0,0,0
1892,p1203,20110329,9114,9114,0,0,0,9114,9114,0,0,0,0,0
1893,p1203,20110330,9114,9114,0,0,0,9114,9114,0,0,0,0,0
1894,p1203,20110331,9114,9114,0,0,0,9114,9114,0,0,0,0,0
1895,p1203,20110401,9114,9114,0,0,0,9114,9114,0,0,0,0,0
1896,p1203,20110406,9114,9114,0,0,0,9114,9114,0,0,0,0,0
1897,p1203,20110407,9114,9114,0,0,0,9114,9114,0,0,0,0,0
1898,p1203,20110408,9114,9114,0,0,0,9114,9114,0,0,0,0,0
1899,p1203,20110411,9114,9114,9834,9834,9650,9650,9734,536,620,30,2920760,6
1900,p1203,20110412,9650,9734,9488,9488,9488,9488,9488,-246,-246,2,189760,4
1901,p1203,20110413,9488,9488,0,0,0,9488,9488,0,0,0,0,4
1902,p1203,20110414,9488,9488,0,0,0,9488,9488,0,0,0,0,4
1903,p1203,20110415,9488,9488,0,0,0,9488,9488,0,0,0,0,4
1904,p1203,20110418,9488,9488,0,0,0,9488,9488,0,0,0,0,4
1905,p1203,20110419,9488,9488,0,0,0,9488,9488,0,0,0,0,4
1906,p1203,20110420,9488,9488,0,0,0,9488,9488,0,0,0,0,4
1907,p1203,20110421,9488,9488,9338,9338,9338,9338,9338,-150,-150,2,186760,2
1908,p1203,20110422,9338,9338,0,0,0,9338,9338,0,0,0,0,2
1909,p1203,20110425,9338,9338,0,0,0,9338,9338,0,0,0,0,2
1910,p1203,20110426,9338,9338,0,0,0,9338,9338,0,0,0,0,2
1911,p1203,20110427,9338,9338,9322,9322,9322,9322,9322,-16,-16,2,186440,2
1912,p1203,20110428,9322,9322,0,0,0,9322,9322,0,0,0,0,2
1913,p1203,20110429,9322,9322,0,0,0,9322,9322,0,0,0,0,2
1914,p1203,20110503,9322,9322,9176,9230,9176,9230,9202,-92,-120,4,368120,2
1915,p1203,20110504,9230,9202,0,0,0,9202,9202,0,0,0,0,2
1916,p1203,20110505,9202,9202,0,0,0,9202,9202,0,0,0,0,2
1917,p1203,20110506,9202,9202,0,0,0,9202,9202,0,0,0,0,2
1918,p1203,20110509,9202,9202,8880,8990,8880,8990,8928,-212,-274,20,1785800,10
1919,p1203,20110510,8990,8928,0,0,0,8928,8928,0,0,0,0,10
1920,p1203,20110511,8928,8928,0,0,0,8928,8928,0,0,0,0,10
1921,p1203,20110512,8928,8928,9168,9168,8952,8980,9076,52,148,54,4901440,8
1922,p1203,20110513,8980,9076,9106,9106,9106,9106,9106,30,30,2,182120,6
1923,p1203,20110516,9106,9106,9080,9080,9080,9080,9080,-26,-26,2,181600,4
1924,p1203,20110517,9080,9080,0,0,0,9080,9080,0,0,0,0,4
1925,p1203,20110518,9080,9080,0,0,0,9080,9080,0,0,0,0,4
1926,p1203,20110519,9080,9080,0,0,0,9080,9080,0,0,0,0,4
1927,p1203,20110520,9080,9080,0,0,0,9080,9080,0,0,0,0,4
1928,p1203,20110523,9080,9080,0,0,0,9080,9080,0,0,0,0,4
1929,p1203,20110524,9080,9080,9318,9340,9318,9340,9324,260,244,6,559520,2
1930,p1203,20110525,9340,9324,0,0,0,9324,9324,0,0,0,0,2
1931,p1203,20110526,9324,9324,0,0,0,9324,9324,0,0,0,0,2
1932,p1203,20110527,9324,9324,0,0,0,9324,9324,0,0,0,0,2
1933,p1203,20110530,9324,9324,0,0,0,9324,9324,0,0,0,0,2
1934,p1203,20110531,9324,9324,0,0,0,9324,9324,0,0,0,0,2
1935,p1203,20110601,9324,9324,0,0,0,9324,9324,0,0,0,0,2
1936,p1203,20110602,9324,9324,0,0,0,9324,9324,0,0,0,0,2
1937,p1203,20110603,9324,9324,0,0,0,9324,9324,0,0,0,0,2
1938,p1203,20110607,9324,9324,0,0,0,9324,9324,0,0,0,0,2
1939,p1203,20110608,9324,9324,0,0,0,9324,9324,0,0,0,0,2
1940,p1203,20110609,9324,9324,0,0,0,9324,9324,0,0,0,0,2
1941,p1203,20110610,9324,9324,0,0,0,9324,9324,0,0,0,0,2
1942,p1203,20110613,9324,9324,0,0,0,9324,9324,0,0,0,0,2
1943,p1203,20110614,9324,9324,0,0,0,9324,9324,0,0,0,0,2
1944,p1203,20110615,9324,9324,0,0,0,9324,9324,0,0,0,0,2
1945,p1203,20110616,9324,9324,0,0,0,9324,9324,0,0,0,0,2
1946,p1203,20110617,9324,9324,0,0,0,9324,9324,0,0,0,0,2
1947,p1203,20110620,9324,9324,0,0,0,9324,9324,0,0,0,0,2
1948,p1203,20110621,9324,9324,0,0,0,9324,9324,0,0,0,0,2
1949,p1203,20110622,9324,9324,9094,9130,9094,9130,9112,-194,-212,4,364480,2
1950,p1203,20110623,9130,9112,0,0,0,9112,9112,0,0,0,0,2
1951,p1203,20110624,9112,9112,0,0,0,9112,9112,0,0,0,0,2
1952,p1203,20110627,9112,9112,0,0,0,9112,9112,0,0,0,0,2
1953,p1203,20110628,9112,9112,0,0,0,9112,9112,0,0,0,0,2
1954,p1203,20110629,9112,9112,0,0,0,9112,9112,0,0,0,0,2
1955,p1203,20110630,9112,9112,0,0,0,9112,9112,0,0,0,0,2
1956,p1203,20110701,9112,9112,0,0,0,9112,9112,0,0,0,0,2
1957,p1203,20110704,9112,9112,0,0,0,9112,9112,0,0,0,0,2
1958,p1203,20110705,9112,9112,0,0,0,9112,9112,0,0,0,0,2
1959,p1203,20110706,9112,9112,0,0,0,9112,9112,0,0,0,0,2
1960,p1203,20110707,9112,9112,0,0,0,9112,9112,0,0,0,0,2
1961,p1203,20110708,9112,9112,0,0,0,9112,9112,0,0,0,0,2
1962,p1203,20110711,9112,9112,0,0,0,9112,9112,0,0,0,0,2
1963,p1203,20110712,9112,9112,0,0,0,9112,9112,0,0,0,0,2
1964,p1203,20110713,9112,9112,0,0,0,9112,9112,0,0,0,0,2
1965,p1203,20110714,9112,9112,0,0,0,9112,9112,0,0,0,0,2
1966,p1203,20110715,9112,9112,0,0,0,9112,9112,0,0,0,0,2
1967,p1203,20110718,9112,9112,0,0,0,9112,9112,0,0,0,0,2
1968,p1203,20110719,9112,9112,9070,9070,9070,9070,9070,-42,-42,2,181400,4
1969,p1203,20110720,9070,9070,8904,9136,8904,9136,9076,66,6,8,726080,6
1970,p1203,20110721,9136,9076,9192,9342,9192,9342,9318,266,242,22,2050000,24
1971,p1203,20110722,9342,9318,0,0,0,9318,9318,0,0,0,0,24
1972,p1203,20110725,9318,9318,9080,9080,9080,9080,9080,-238,-238,2,181600,24
1973,p1203,20110726,9080,9080,9066,9066,9066,9066,9066,-14,-14,20,1813200,6
1974,p1203,20110727,9066,9066,0,0,0,9066,9066,0,0,0,0,6
1975,p1203,20110728,9066,9066,0,0,0,9066,9066,0,0,0,0,6
1976,p1203,20110729,9066,9066,0,0,0,9066,9066,0,0,0,0,6
1977,p1203,20110801,9066,9066,0,0,0,9066,9066,0,0,0,0,6
1978,p1203,20110802,9066,9066,0,0,0,9066,9066,0,0,0,0,6
1979,p1203,20110803,9066,9066,0,0,0,9066,9066,0,0,0,0,6
1980,p1203,20110804,9066,9066,9290,9290,9158,9158,9224,92,158,4,368960,6
1981,p1203,20110805,9158,9224,8870,8870,8870,8870,8870,-354,-354,2,177400,6
1982,p1203,20110808,8870,8870,0,0,0,8870,8870,0,0,0,0,6
1983,p1203,20110809,8870,8870,8650,8650,8650,8650,8650,-220,-220,2,173000,4
1984,p1203,20110810,8650,8650,0,0,0,8650,8650,0,0,0,0,4
1985,p1203,20110811,8650,8650,0,0,0,8650,8650,0,0,0,0,4
1986,p1203,20110812,8650,8650,0,0,0,8650,8650,0,0,0,0,4
1987,p1203,20110815,8650,8650,8828,8828,8828,8828,8828,178,178,2,176560,4
1988,p1203,20110816,8828,8828,0,0,0,8828,8828,0,0,0,0,4
1989,p1203,20110817,8828,8828,8678,8934,8678,8934,8806,106,-22,4,352240,4
1990,p1203,20110818,8934,8806,8986,8986,8846,8846,8950,40,144,8,716080,10
1991,p1203,20110819,8846,8950,0,0,0,8950,8950,0,0,0,0,10
1992,p1203,20110822,8950,8950,0,0,0,8950,8950,0,0,0,0,10
1993,p1203,20110823,8950,8950,8900,8900,8828,8828,8876,-122,-74,6,532560,8
1994,p1203,20110824,8828,8876,8950,8950,8950,8950,8950,74,74,2,179000,6
1995,p1203,20110825,8950,8950,0,0,0,8950,8950,0,0,0,0,6
1996,p1203,20110826,8950,8950,8840,8840,8840,8840,8840,-110,-110,2,176800,4
1997,p1203,20110829,8840,8840,0,0,0,8840,8840,0,0,0,0,4
1998,p1203,20110830,8840,8840,0,0,0,8840,8840,0,0,0,0,4
1999,p1203,20110831,8840,8840,0,0,0,8840,8840,0,0,0,0,4
2000,p1203,20110901,8840,8840,0,0,0,8840,8840,0,0,0,0,4
2001,p1203,20110902,8840,8840,0,0,0,8840,8840,0,0,0,0,4
2002,p1203,20110905,8840,8840,0,0,0,8840,8840,0,0,0,0,4
2003,p1203,20110906,8840,8840,0,0,0,8840,8840,0,0,0,0,4
2004,p1203,20110907,8840,8840,8866,8866,8866,8866,8866,26,26,2,177320,6
2005,p1203,20110908,8866,8866,8966,9070,8966,9064,9032,198,166,6,542000,4
2006,p1203,20110909,9064,9032,0,0,0,9032,9032,0,0,0,0,4
2007,p1203,20110913,9032,9032,0,0,0,9032,9032,0,0,0,0,4
2008,p1203,20110914,9032,9032,8928,8928,8928,8928,8928,-104,-104,2,178560,4
2009,p1203,20110915,8928,8928,0,0,0,8928,8928,0,0,0,0,4
2010,p1203,20110916,8928,8928,0,0,0,8928,8928,0,0,0,0,4
2011,p1203,20110919,8928,8928,0,0,0,8928,8928,0,0,0,0,4
2012,p1203,20110920,8928,8928,0,0,0,8928,8928,0,0,0,0,4
2013,p1203,20110921,8928,8928,0,0,0,8928,8928,0,0,0,0,4
2014,p1203,20110922,8928,8928,0,0,0,8928,8928,0,0,0,0,4
2015,p1203,20110923,8928,8928,0,0,0,8928,8928,0,0,0,0,4
2016,p1203,20110926,8928,8928,0,0,0,8928,8928,0,0,0,0,4
2017,p1203,20110927,8928,8928,0,0,0,8928,8928,0,0,0,0,4
2018,p1203,20110928,8928,8928,0,0,0,8928,8928,0,0,0,0,4
2019,p1203,20110929,8928,8928,0,0,0,8928,8928,0,0,0,0,4
2020,p1203,20110930,8928,8928,0,0,0,8928,8928,0,0,0,0,4
2021,p1203,20111010,8928,8928,8928,8928,8928,8928,8928,0,0,2,178560,4
2022,p1203,20111011,8928,8928,0,0,0,8928,8928,0,0,0,0,4
2023,p1203,20111012,8928,8928,8214,8214,8214,8214,8214,-714,-714,4,328560,2
2024,p1203,20111013,8214,8214,0,0,0,8214,8214,0,0,0,0,2
2025,p1203,20111014,8214,8214,0,0,0,8214,8214,0,0,0,0,2
2026,p1203,20111017,8214,8214,0,0,0,8214,8214,0,0,0,0,2
2027,p1203,20111018,8214,8214,0,0,0,8214,8214,0,0,0,0,2
2028,p1203,20111019,8214,8214,0,0,0,8214,8214,0,0,0,0,2
2029,p1203,20111020,8214,8214,0,0,0,8214,8214,0,0,0,0,2
2030,p1203,20111021,8214,8214,0,0,0,8214,8214,0,0,0,0,2
2031,p1203,20111024,8214,8214,0,0,0,8214,8214,0,0,0,0,2
2032,p1203,20111025,8214,8214,0,0,0,8214,8214,0,0,0,0,2
2033,p1203,20111026,8214,8214,0,0,0,8214,8214,0,0,0,0,2
2034,p1203,20111027,8214,8214,0,0,0,8214,8214,0,0,0,0,2
2035,p1203,20111028,8214,8214,0,0,0,8214,8214,0,0,0,0,2
2036,p1203,20111031,8214,8214,0,0,0,8214,8214,0,0,0,0,2
2037,p1203,20111101,8214,8214,0,0,0,8214,8214,0,0,0,0,2
2038,p1203,20111102,8214,8214,0,0,0,8214,8214,0,0,0,0,2
2039,p1203,20111103,8214,8214,0,0,0,8214,8214,0,0,0,0,2
2040,p1203,20111104,8214,8214,0,0,0,8214,8214,0,0,0,0,2
2041,p1203,20111107,8214,8214,0,0,0,8214,8214,0,0,0,0,2
2042,p1203,20111108,8214,8214,0,0,0,8214,8214,0,0,0,0,2
2043,p1203,20111109,8214,8214,0,0,0,8214,8214,0,0,0,0,2
2044,p1203,20111110,8214,8214,0,0,0,8214,8214,0,0,0,0,2
2045,p1203,20111111,8214,8214,0,0,0,8214,8214,0,0,0,0,2
2046,p1203,20111114,8214,8214,0,0,0,8214,8214,0,0,0,0,2
2047,p1203,20111115,8214,8214,0,0,0,8214,8214,0,0,0,0,2
2048,p1203,20111116,8214,8214,8400,8400,8182,8220,8280,6,66,8,662400,2
2049,p1203,20111117,8220,8280,8424,8424,8100,8300,8286,20,6,14,1160080,2
2050,p1203,20111118,8300,8286,0,0,0,8286,8286,0,0,0,0,2
2051,p1203,20111121,8286,8286,0,0,0,8286,8286,0,0,0,0,2
2052,p1203,20111122,8286,8286,0,0,0,8286,8286,0,0,0,0,2
2053,p1203,20111123,8286,8286,0,0,0,8286,8286,0,0,0,0,2
2054,p1203,20111124,8286,8286,0,0,0,8286,8286,0,0,0,0,2
2055,p1203,20111125,8286,8286,7908,7908,7908,7908,7908,-378,-378,2,158160,2
2056,p1203,20111128,7908,7908,7990,7990,7990,7990,7990,82,82,2,159800,4
2057,p1203,20111129,7990,7990,0,0,0,7990,7990,0,0,0,0,4
2058,p1203,20111130,7990,7990,0,0,0,7990,7990,0,0,0,0,4
2059,p1203,20111201,7990,7990,7942,7942,7942,7942,7942,-48,-48,2,158840,2
2060,p1203,20111202,7942,7942,0,0,0,7942,7942,0,0,0,0,2
2061,p1203,20111205,7942,7942,0,0,0,7942,7942,0,0,0,0,2
2062,p1203,20111206,7942,7942,0,0,0,7942,7942,0,0,0,0,2
2063,p1203,20111207,7942,7942,0,0,0,7942,7942,0,0,0,0,2
2064,p1203,20111208,7942,7942,0,0,0,7942,7942,0,0,0,0,2
2065,p1203,20111209,7942,7942,0,0,0,7942,7942,0,0,0,0,2
2066,p1203,20111212,7942,7942,7822,7950,7820,7902,7900,-40,-42,32,2528440,2
2067,p1203,20111213,7902,7900,0,0,0,7900,7900,0,0,0,0,2
2068,p1203,20111214,7900,7900,0,0,0,7900,7900,0,0,0,0,2
2069,p1203,20111215,7900,7900,0,0,0,7900,7900,0,0,0,0,2
2070,p1203,20111216,7900,7900,0,0,0,7900,7900,0,0,0,0,2
2071,p1203,20111219,7900,7900,7840,7840,7840,7840,7840,-60,-60,2,156800,2
2072,p1203,20111220,7840,7840,0,0,0,7840,7840,0,0,0,0,2
2073,p1203,20111221,7840,7840,0,0,0,7840,7840,0,0,0,0,2
2074,p1203,20111222,7840,7840,0,0,0,7840,7840,0,0,0,0,2
2075,p1203,20111223,7840,7840,0,0,0,7840,7840,0,0,0,0,2
2076,p1203,20111226,7840,7840,7954,7954,7822,7822,7888,-18,48,4,315520,4
2077,p1203,20111227,7822,7888,7892,7892,7804,7820,7826,-68,-62,10,782600,8
2078,p1203,20111228,7820,7826,7812,7812,7810,7810,7810,-16,-16,6,468680,14
2079,p1203,20111229,7810,7810,0,0,0,7810,7810,0,0,0,0,14
2080,p1203,20111230,7810,7810,0,0,0,7810,7810,0,0,0,0,14
2081,p1204,20110420,9176,9176,9498,9498,9074,9184,9288,8,112,8,743080,0
2082,p1204,20110421,9184,9288,0,0,0,9288,9288,0,0,0,0,0
2083,p1204,20110422,9288,9288,0,0,0,9288,9288,0,0,0,0,0
2084,p1204,20110425,9288,9288,0,0,0,9288,9288,0,0,0,0,0
2085,p1204,20110426,9288,9288,0,0,0,9288,9288,0,0,0,0,0
2086,p1204,20110427,9288,9288,0,0,0,9288,9288,0,0,0,0,0
2087,p1204,20110428,9288,9288,0,0,0,9288,9288,0,0,0,0,0
2088,p1204,20110429,9288,9288,0,0,0,9288,9288,0,0,0,0,0
2089,p1204,20110503,9288,9288,0,0,0,9288,9288,0,0,0,0,0
2090,p1204,20110504,9288,9288,0,0,0,9288,9288,0,0,0,0,0
2091,p1204,20110505,9288,9288,8994,9408,8994,9144,9146,-144,-142,44,4024440,0
2092,p1204,20110506,9144,9146,0,0,0,9146,9146,0,0,0,0,0
2093,p1204,20110509,9146,9146,0,0,0,9146,9146,0,0,0,0,0
2094,p1204,20110510,9146,9146,0,0,0,9146,9146,0,0,0,0,0
2095,p1204,20110511,9146,9146,0,0,0,9146,9146,0,0,0,0,0
2096,p1204,20110512,9146,9146,0,0,0,9146,9146,0,0,0,0,0
2097,p1204,20110513,9146,9146,0,0,0,9146,9146,0,0,0,0,0
2098,p1204,20110516,9146,9146,0,0,0,9146,9146,0,0,0,0,0
2099,p1204,20110517,9146,9146,0,0,0,9146,9146,0,0,0,0,0
2100,p1204,20110518,9146,9146,0,0,0,9146,9146,0,0,0,0,0
2101,p1204,20110519,9146,9146,0,0,0,9146,9146,0,0,0,0,0
2102,p1204,20110520,9146,9146,0,0,0,9146,9146,0,0,0,0,0
2103,p1204,20110523,9146,9146,0,0,0,9146,9146,0,0,0,0,0
2104,p1204,20110524,9146,9146,0,0,0,9146,9146,0,0,0,0,0
2105,p1204,20110525,9146,9146,0,0,0,9146,9146,0,0,0,0,0
2106,p1204,20110526,9146,9146,9240,9500,9240,9320,9352,174,206,6,561200,0
2107,p1204,20110527,9320,9352,0,0,0,9352,9352,0,0,0,0,0
2108,p1204,20110530,9352,9352,0,0,0,9352,9352,0,0,0,0,0
2109,p1204,20110531,9352,9352,0,0,0,9352,9352,0,0,0,0,0
2110,p1204,20110601,9352,9352,0,0,0,9352,9352,0,0,0,0,0
2111,p1204,20110602,9352,9352,0,0,0,9352,9352,0,0,0,0,0
2112,p1204,20110603,9352,9352,0,0,0,9352,9352,0,0,0,0,0
2113,p1204,20110607,9352,9352,0,0,0,9352,9352,0,0,0,0,0
2114,p1204,20110608,9352,9352,0,0,0,9352,9352,0,0,0,0,0
2115,p1204,20110609,9352,9352,9498,9500,9400,9400,9466,48,114,6,567960,2
2116,p1204,20110610,9400,9466,0,0,0,9466,9466,0,0,0,0,2
2117,p1204,20110613,9466,9466,0,0,0,9466,9466,0,0,0,0,2
2118,p1204,20110614,9466,9466,0,0,0,9466,9466,0,0,0,0,2
2119,p1204,20110615,9466,9466,0,0,0,9466,9466,0,0,0,0,2
2120,p1204,20110616,9466,9466,0,0,0,9466,9466,0,0,0,0,2
2121,p1204,20110617,9466,9466,0,0,0,9466,9466,0,0,0,0,2
2122,p1204,20110620,9466,9466,0,0,0,9466,9466,0,0,0,0,2
2123,p1204,20110621,9466,9466,0,0,0,9466,9466,0,0,0,0,2
2124,p1204,20110622,9466,9466,0,0,0,9466,9466,0,0,0,0,2
2125,p1204,20110623,9466,9466,0,0,0,9466,9466,0,0,0,0,2
2126,p1204,20110624,9466,9466,9054,9054,8996,8996,9024,-470,-442,20,1805040,2
2127,p1204,20110627,8996,9024,9464,9464,8858,8858,9060,-166,36,6,543680,2
2128,p1204,20110628,8858,9060,8840,8840,8830,8830,8834,-230,-226,4,353400,2
2129,p1204,20110629,8830,8834,0,0,0,8834,8834,0,0,0,0,2
2130,p1204,20110630,8834,8834,0,0,0,8834,8834,0,0,0,0,2
2131,p1204,20110701,8834,8834,0,0,0,8834,8834,0,0,0,0,2
2132,p1204,20110704,8834,8834,0,0,0,8834,8834,0,0,0,0,2
2133,p1204,20110705,8834,8834,0,0,0,8834,8834,0,0,0,0,2
2134,p1204,20110706,8834,8834,0,0,0,8834,8834,0,0,0,0,2
2135,p1204,20110707,8834,8834,0,0,0,8834,8834,0,0,0,0,2
2136,p1204,20110708,8834,8834,9060,9114,9060,9114,9080,280,246,6,544880,2
2137,p1204,20110711,9114,9080,0,0,0,9080,9080,0,0,0,0,2
2138,p1204,20110712,9080,9080,0,0,0,9080,9080,0,0,0,0,2
2139,p1204,20110713,9080,9080,0,0,0,9080,9080,0,0,0,0,2
2140,p1204,20110714,9080,9080,0,0,0,9080,9080,0,0,0,0,2
2141,p1204,20110715,9080,9080,0,0,0,9080,9080,0,0,0,0,2
2142,p1204,20110718,9080,9080,0,0,0,9080,9080,0,0,0,0,2
2143,p1204,20110719,9080,9080,0,0,0,9080,9080,0,0,0,0,2
2144,p1204,20110720,9080,9080,0,0,0,9080,9080,0,0,0,0,2
2145,p1204,20110721,9080,9080,9114,9248,9114,9248,9168,168,88,6,550160,2
2146,p1204,20110722,9248,9168,9236,9236,9236,9236,9236,68,68,2,184720,4
2147,p1204,20110725,9236,9236,9114,9114,9114,9114,9114,-122,-122,2,182280,2
2148,p1204,20110726,9114,9114,0,0,0,9114,9114,0,0,0,0,2
2149,p1204,20110727,9114,9114,0,0,0,9114,9114,0,0,0,0,2
2150,p1204,20110728,9114,9114,0,0,0,9114,9114,0,0,0,0,2
2151,p1204,20110729,9114,9114,0,0,0,9114,9114,0,0,0,0,2
2152,p1204,20110801,9114,9114,0,0,0,9114,9114,0,0,0,0,2
2153,p1204,20110802,9114,9114,0,0,0,9114,9114,0,0,0,0,2
2154,p1204,20110803,9114,9114,0,0,0,9114,9114,0,0,0,0,2
2155,p1204,20110804,9114,9114,0,0,0,9114,9114,0,0,0,0,2
2156,p1204,20110805,9114,9114,0,0,0,9114,9114,0,0,0,0,2
2157,p1204,20110808,9114,9114,0,0,0,9114,9114,0,0,0,0,2
2158,p1204,20110809,9114,9114,0,0,0,9114,9114,0,0,0,0,2
2159,p1204,20110810,9114,9114,0,0,0,9114,9114,0,0,0,0,2
2160,p1204,20110811,9114,9114,0,0,0,9114,9114,0,0,0,0,2
2161,p1204,20110812,9114,9114,0,0,0,9114,9114,0,0,0,0,2
2162,p1204,20110815,9114,9114,0,0,0,9114,9114,0,0,0,0,2
2163,p1204,20110816,9114,9114,0,0,0,9114,9114,0,0,0,0,2
2164,p1204,20110817,9114,9114,0,0,0,9114,9114,0,0,0,0,2
2165,p1204,20110818,9114,9114,0,0,0,9114,9114,0,0,0,0,2
2166,p1204,20110819,9114,9114,8722,8844,8722,8844,8782,-270,-332,4,351320,2
2167,p1204,20110822,8844,8782,0,0,0,8782,8782,0,0,0,0,2
2168,p1204,20110823,8782,8782,0,0,0,8782,8782,0,0,0,0,2
2169,p1204,20110824,8782,8782,0,0,0,8782,8782,0,0,0,0,2
2170,p1204,20110825,8782,8782,0,0,0,8782,8782,0,0,0,0,2
2171,p1204,20110826,8782,8782,0,0,0,8782,8782,0,0,0,0,2
2172,p1204,20110829,8782,8782,0,0,0,8782,8782,0,0,0,0,2
2173,p1204,20110830,8782,8782,0,0,0,8782,8782,0,0,0,0,2
2174,p1204,20110831,8782,8782,0,0,0,8782,8782,0,0,0,0,2
2175,p1204,20110901,8782,8782,0,0,0,8782,8782,0,0,0,0,2
2176,p1204,20110902,8782,8782,0,0,0,8782,8782,0,0,0,0,2
2177,p1204,20110905,8782,8782,0,0,0,8782,8782,0,0,0,0,2
2178,p1204,20110906,8782,8782,0,0,0,8782,8782,0,0,0,0,2
2179,p1204,20110907,8782,8782,0,0,0,8782,8782,0,0,0,0,2
2180,p1204,20110908,8782,8782,0,0,0,8782,8782,0,0,0,0,2
2181,p1204,20110909,8782,8782,0,0,0,8782,8782,0,0,0,0,2
2182,p1204,20110913,8782,8782,0,0,0,8782,8782,0,0,0,0,2
2183,p1204,20110914,8782,8782,9044,9044,9044,9044,9044,262,262,2,180880,4
2184,p1204,20110915,9044,9044,8942,8942,8942,8942,8942,-102,-102,2,178840,4
2185,p1204,20110916,8942,8942,0,0,0,8942,8942,0,0,0,0,4
2186,p1204,20110919,8942,8942,0,0,0,8942,8942,0,0,0,0,4
2187,p1204,20110920,8942,8942,0,0,0,8942,8942,0,0,0,0,4
2188,p1204,20110921,8942,8942,8922,8922,8590,8810,8788,-132,-154,14,1230320,6
2189,p1204,20110922,8810,8788,8460,8580,8460,8580,8520,-208,-268,4,340800,6
2190,p1204,20110923,8580,8520,8500,8500,8500,8500,8500,-20,-20,2,170000,4
2191,p1204,20110926,8500,8500,8076,8216,8076,8076,8108,-424,-392,18,1459760,6
2192,p1204,20110927,8076,8108,8324,8324,7974,8144,8170,36,62,30,2451200,8
2193,p1204,20110928,8144,8170,8106,8106,8106,8106,8106,-64,-64,4,324240,4
2194,p1204,20110929,8106,8106,0,0,0,8106,8106,0,0,0,0,4
2195,p1204,20110930,8106,8106,8238,8238,7952,7952,8094,-154,-12,4,323800,4
2196,p1204,20111010,7952,8094,0,0,0,8094,8094,0,0,0,0,4
2197,p1204,20111011,8094,8094,0,0,0,8094,8094,0,0,0,0,4
2198,p1204,20111012,8094,8094,8098,8098,7858,7960,7970,-134,-124,8,637720,4
2199,p1204,20111013,7960,7970,0,0,0,7970,7970,0,0,0,0,4
2200,p1204,20111014,7970,7970,0,0,0,7970,7970,0,0,0,0,4
2201,p1204,20111017,7970,7970,0,0,0,7970,7970,0,0,0,0,4
2202,p1204,20111018,7970,7970,0,0,0,7970,7970,0,0,0,0,4
2203,p1204,20111019,7970,7970,0,0,0,7970,7970,0,0,0,0,4
2204,p1204,20111020,7970,7970,7914,7914,7744,7744,7828,-226,-142,4,313160,6
2205,p1204,20111021,7744,7828,0,0,0,7828,7828,0,0,0,0,6
2206,p1204,20111024,7828,7828,7880,7890,7880,7890,7884,62,56,4,315400,4
2207,p1204,20111025,7890,7884,0,0,0,7884,7884,0,0,0,0,4
2208,p1204,20111026,7884,7884,0,0,0,7884,7884,0,0,0,0,4
2209,p1204,20111027,7884,7884,0,0,0,7884,7884,0,0,0,0,4
2210,p1204,20111028,7884,7884,0,0,0,7884,7884,0,0,0,0,4
2211,p1204,20111031,7884,7884,8100,8100,8000,8000,8050,116,166,8,644000,0
2212,p1204,20111101,8000,8050,8050,8070,7830,8070,7946,20,-104,44,3496800,0
2213,p1204,20111102,8070,7946,0,0,0,7946,7946,0,0,0,0,0
2214,p1204,20111103,7946,7946,7900,8122,7900,7920,7960,-26,14,16,1273680,0
2215,p1204,20111104,7920,7960,8244,8244,8060,8060,8152,100,192,4,326080,0
2216,p1204,20111107,8060,8152,0,0,0,8152,8152,0,0,0,0,0
2217,p1204,20111108,8152,8152,0,0,0,8152,8152,0,0,0,0,0
2218,p1204,20111109,8152,8152,0,0,0,8152,8152,0,0,0,0,0
2219,p1204,20111110,8152,8152,0,0,0,8152,8152,0,0,0,0,0
2220,p1204,20111111,8152,8152,0,0,0,8152,8152,0,0,0,0,0
2221,p1204,20111114,8152,8152,8310,8310,8080,8080,8210,-72,58,6,492600,2
2222,p1204,20111115,8080,8210,8058,8346,8058,8346,8202,136,-8,4,328080,2
2223,p1204,20111116,8346,8202,8476,8476,8210,8260,8314,58,112,6,498920,0
2224,p1204,20111117,8260,8314,0,0,0,8314,8314,0,0,0,0,0
2225,p1204,20111118,8314,8314,8374,8374,8200,8216,8256,-98,-58,28,2312080,2
2226,p1204,20111121,8216,8256,0,0,0,8256,8256,0,0,0,0,2
2227,p1204,20111122,8256,8256,0,0,0,8256,8256,0,0,0,0,2
2228,p1204,20111123,8256,8256,8250,8250,8018,8018,8072,-238,-184,10,807200,2
2229,p1204,20111124,8018,8072,0,0,0,8072,8072,0,0,0,0,2
2230,p1204,20111125,8072,8072,0,0,0,8072,8072,0,0,0,0,2
2231,p1204,20111128,8072,8072,0,0,0,8072,8072,0,0,0,0,2
2232,p1204,20111129,8072,8072,0,0,0,8072,8072,0,0,0,0,2
2233,p1204,20111130,8072,8072,7676,7964,7676,7780,7806,-292,-266,6,468400,2
2234,p1204,20111201,7780,7806,0,0,0,7806,7806,0,0,0,0,2
2235,p1204,20111202,7806,7806,0,0,0,7806,7806,0,0,0,0,2
2236,p1204,20111205,7806,7806,8008,8038,8006,8006,8018,200,212,20,1603760,0
2237,p1204,20111206,8006,8018,0,0,0,8018,8018,0,0,0,0,0
2238,p1204,20111207,8018,8018,8188,8188,7978,8002,8042,-16,24,8,643440,0
2239,p1204,20111208,8002,8042,0,0,0,8042,8042,0,0,0,0,0
2240,p1204,20111209,8042,8042,0,0,0,8042,8042,0,0,0,0,0
2241,p1204,20111212,8042,8042,0,0,0,8042,8042,0,0,0,0,0
2242,p1204,20111213,8042,8042,0,0,0,8042,8042,0,0,0,0,0
2243,p1204,20111214,8042,8042,0,0,0,8042,8042,0,0,0,0,0
2244,p1204,20111215,8042,8042,0,0,0,8042,8042,0,0,0,0,0
2245,p1204,20111216,8042,8042,7988,7988,7988,7988,7988,-54,-54,2,159760,2
2246,p1204,20111219,7988,7988,0,0,0,7988,7988,0,0,0,0,2
2247,p1204,20111220,7988,7988,0,0,0,7988,7988,0,0,0,0,2
2248,p1204,20111221,7988,7988,7840,7840,7840,7840,7840,-148,-148,2,156800,0
2249,p1204,20111222,7840,7840,0,0,0,7840,7840,0,0,0,0,0
2250,p1204,20111223,7840,7840,8140,8140,7944,7944,8042,104,202,4,321680,0
2251,p1204,20111226,7944,8042,0,0,0,8042,8042,0,0,0,0,0
2252,p1204,20111227,8042,8042,0,0,0,8042,8042,0,0,0,0,0
2253,p1204,20111228,8042,8042,0,0,0,8042,8042,0,0,0,0,0
2254,p1204,20111229,8042,8042,0,0,0,8042,8042,0,0,0,0,0
2255,p1204,20111230,8042,8042,0,0,0,8042,8042,0,0,0,0,0
2256,p1205,20110518,9056,9038,9104,9120,9060,9070,9096,32,58,2924,266017840,3250
2257,p1205,20110519,9070,9096,9168,9200,9132,9150,9178,54,82,1020,93627000,3732
2258,p1205,20110520,9150,9178,9172,9224,9172,9224,9202,46,24,3842,353554400,6808
2259,p1205,20110523,9224,9202,9224,9250,9164,9184,9208,-18,6,5440,500926160,10490
2260,p1205,20110524,9184,9208,9208,9300,9196,9296,9224,88,16,5058,466569480,13486
2261,p1205,20110525,9296,9224,9262,9292,9220,9244,9270,20,46,3826,354698880,14824
2262,p1205,20110526,9244,9270,9314,9350,9310,9350,9330,80,60,1492,139217000,15640
2263,p1205,20110527,9350,9330,9364,9386,9344,9366,9364,36,34,6684,625897920,18768
2264,p1205,20110530,9366,9364,9338,9468,9292,9432,9424,68,60,5216,491656400,20422
2265,p1205,20110531,9432,9424,9436,9450,9362,9366,9388,-58,-36,5070,476045480,23492
2266,p1205,20110601,9366,9388,9376,9420,9354,9360,9386,-28,-2,9542,895781520,27766
2267,p1205,20110602,9360,9386,9354,9382,9336,9380,9358,-6,-28,9830,919892760,34140
2268,p1205,20110603,9380,9358,9440,9558,9430,9550,9466,192,108,17960,1700393000,45984
2269,p1205,20110607,9550,9466,9430,9462,9400,9436,9436,-30,-30,12170,1148422280,52806
2270,p1205,20110608,9436,9436,9450,9468,9356,9356,9396,-80,-40,33668,3163944400,64236
2271,p1205,20110609,9356,9396,9396,9426,9356,9366,9396,-30,0,13374,1256836040,71848
2272,p1205,20110610,9366,9396,9350,9350,9252,9256,9314,-140,-82,14446,1345720400,78200
2273,p1205,20110613,9256,9314,9204,9266,9204,9226,9244,-88,-70,18202,1682909120,87960
2274,p1205,20110614,9226,9244,9230,9274,9216,9236,9234,-8,-10,11976,1106008720,91772
2275,p1205,20110615,9236,9234,9220,9264,9212,9230,9240,-4,6,11298,1044013520,94670
2276,p1205,20110616,9230,9240,9200,9206,9114,9128,9168,-112,-72,5874,538623480,93942
2277,p1205,20110617,9128,9168,9104,9146,9060,9080,9112,-88,-56,9962,907752480,95496
2278,p1205,20110620,9080,9112,9060,9140,9006,9080,9100,-32,-12,20430,1859155640,100348
2279,p1205,20110621,9080,9100,9102,9140,9094,9120,9122,20,22,17038,1554280840,112070
2280,p1205,20110622,9120,9122,9128,9134,9066,9076,9104,-46,-18,24794,2257649720,110150
2281,p1205,20110623,9076,9104,9060,9060,8948,9014,9004,-90,-100,16474,1483361400,112492
2282,p1205,20110624,9014,9004,8914,9002,8914,8954,8968,-50,-36,13668,1225803720,116374
2283,p1205,20110627,8954,8968,8820,8914,8756,8756,8826,-212,-142,38034,3357254280,107598
2284,p1205,20110628,8756,8826,8802,8844,8750,8764,8806,-62,-20,14600,1285828000,105832
2285,p1205,20110629,8764,8806,8838,8862,8816,8854,8842,48,36,9198,813340960,105938
2286,p1205,20110630,8854,8842,8898,8930,8870,8930,8902,88,60,5550,494141440,106246
2287,p1205,20110701,8930,8902,8850,8850,8752,8826,8804,-76,-98,14502,1276782560,111174
2288,p1205,20110704,8826,8804,8830,8936,8830,8920,8880,116,76,34266,3042833640,117488
2289,p1205,20110705,8920,8880,8932,8950,8844,8872,8884,-8,4,49414,4390809280,114364
2290,p1205,20110706,8872,8884,8862,8908,8828,8862,8850,-22,-34,39438,3490967920,113800
2291,p1205,20110707,8862,8850,8856,8890,8838,8870,8860,20,10,22092,1957463480,115366
2292,p1205,20110708,8870,8860,8930,9026,8930,8986,8986,126,126,39442,3544717760,120008
2293,p1205,20110711,8986,8986,8978,9080,8966,9026,9044,40,58,59666,5397025680,136024
2294,p1205,20110712,9026,9044,8980,9040,8906,8944,8958,-100,-86,55422,4965651840,149306
2295,p1205,20110713,8944,8958,9000,9090,9000,9088,9054,130,96,78406,7099728920,172634
2296,p1205,20110714,9088,9054,9134,9166,9088,9148,9120,94,66,84590,7715107960,175940
2297,p1205,20110715,9148,9120,9120,9170,9080,9154,9128,34,8,104148,9507236040,182584
2298,p1205,20110718,9154,9128,9156,9218,9096,9096,9162,-32,34,161664,14813483040,196936
2299,p1205,20110719,9096,9162,9132,9132,9082,9126,9106,-36,-56,135424,12333643840,216548
2300,p1205,20110720,9126,9106,9136,9240,9062,9208,9172,102,66,322478,29583734560,247394
2301,p1205,20110721,9208,9172,9200,9276,9188,9252,9236,80,64,299608,27675330800,270228
2302,p1205,20110722,9252,9236,9240,9254,9214,9246,9234,10,-2,147978,13666338640,273212
2303,p1205,20110725,9246,9234,9202,9214,9092,9100,9158,-134,-76,202478,18544287280,266904
2304,p1205,20110726,9100,9158,9100,9178,9100,9172,9148,14,-10,139676,12778801480,277752
2305,p1205,20110727,9172,9148,9202,9256,9200,9222,9226,74,78,179086,16526015240,282370
2306,p1205,20110728,9222,9226,9200,9202,9122,9122,9154,-104,-72,182542,16710501280,275332
2307,p1205,20110729,9122,9154,9090,9174,9044,9058,9112,-96,-42,254578,23199125280,269536
2308,p1205,20110801,9058,9112,9092,9224,9092,9222,9162,110,50,213032,19518119120,273200
2309,p1205,20110802,9222,9162,9200,9288,9196,9228,9242,66,80,306582,28340007440,288464
2310,p1205,20110803,9228,9242,9292,9298,9230,9230,9252,-12,10,175950,16279527680,289176
2311,p1205,20110804,9230,9252,9210,9222,9132,9142,9170,-110,-82,180892,16589562480,290826
2312,p1205,20110805,9142,9170,9000,9000,8770,8876,8876,-294,-294,329370,29239385680,263018
2313,p1205,20110808,8876,8876,8800,8900,8800,8834,8850,-42,-26,239042,21157803160,293294
2314,p1205,20110809,8834,8850,8610,8670,8464,8636,8586,-214,-264,303186,26033712400,287272
2315,p1205,20110810,8636,8586,8700,8754,8680,8718,8722,132,136,210300,18343289320,293612
2316,p1205,20110811,8718,8722,8670,8766,8662,8764,8718,42,-4,227052,19798214520,319754
2317,p1205,20110812,8764,8718,8848,8868,8764,8774,8808,56,90,140548,12381911640,311604
2318,p1205,20110815,8774,8808,8848,8896,8834,8866,8866,58,58,177018,15696811200,318268
2319,p1205,20110816,8866,8866,8906,8914,8804,8814,8860,-52,-6,259390,22986255880,292902
2320,p1205,20110817,8814,8860,8850,8886,8834,8864,8864,4,4,151994,13475704200,300412
2321,p1205,20110818,8864,8864,8904,8908,8840,8856,8870,-8,6,133688,11860551920,300390
2322,p1205,20110819,8856,8870,8800,8826,8758,8820,8798,-50,-72,141966,12490278800,306186
2323,p1205,20110822,8820,8798,8858,8888,8810,8820,8858,22,60,122244,10828980160,304840
2324,p1205,20110823,8820,8858,8860,8946,8860,8942,8906,84,48,160852,14327614280,311320
2325,p1205,20110824,8942,8906,8936,8962,8898,8914,8928,8,22,142772,12749514000,316366
2326,p1205,20110825,8914,8928,8896,8924,8862,8880,8888,-48,-40,111818,9938912600,321090
2327,p1205,20110826,8880,8888,8872,8886,8788,8800,8828,-88,-60,222760,19665902920,360404
2328,p1205,20110829,8800,8828,8904,8970,8894,8964,8930,136,102,239944,21429103200,377070
2329,p1205,20110830,8964,8930,8986,9020,8942,8968,8978,38,48,185934,16694241440,375942
2330,p1205,20110831,8968,8978,9000,9076,8982,9056,9036,78,58,244026,22053477360,382418
2331,p1205,20110901,9056,9036,9050,9094,9022,9044,9058,8,22,172622,15636907680,386546
2332,p1205,20110902,9044,9058,9010,9056,9004,9044,9030,-14,-28,185510,16754283320,392966
2333,p1205,20110905,9044,9030,9032,9120,8978,8996,9052,-34,22,247988,22449892720,403232
2334,p1205,20110906,8996,9052,8980,8980,8860,8938,8916,-114,-136,183004,16317933040,393772
2335,p1205,20110907,8938,8916,8952,9042,8930,9038,8978,122,62,157460,14137423360,410406
2336,p1205,20110908,9038,8978,9028,9050,8960,9022,9010,44,32,204476,18424899640,407678
2337,p1205,20110909,9022,9010,9000,9088,8992,9078,9040,68,30,183376,16577915840,418684
2338,p1205,20110913,9078,9040,8980,9006,8910,8920,8946,-120,-94,189858,16987555160,407284
2339,p1205,20110914,8920,8946,8936,8958,8780,8820,8866,-126,-80,185784,16471928920,405780
2340,p1205,20110915,8820,8866,8866,8884,8816,8840,8862,-26,-4,177380,15720099920,411246
2341,p1205,20110916,8840,8862,8800,8844,8772,8822,8812,-40,-50,148336,13073315480,411572
2342,p1205,20110919,8822,8812,8780,8780,8652,8656,8702,-156,-110,150434,13091182880,401658
2343,p1205,20110920,8656,8702,8680,8750,8666,8724,8720,22,18,132512,11555245600,398116
2344,p1205,20110921,8724,8720,8688,8738,8640,8712,8698,-8,-22,176556,15359086120,402580
2345,p1205,20110922,8712,8698,8592,8606,8526,8544,8574,-154,-124,146250,12539903480,389588
2346,p1205,20110923,8544,8574,8416,8460,8146,8280,8330,-294,-244,266738,22220271280,363762
2347,p1205,20110926,8280,8330,8268,8298,7914,7914,8134,-416,-196,232122,18882917680,338900
2348,p1205,20110927,7914,8134,8102,8166,8058,8132,8126,-2,-8,188768,15342051600,339370
2349,p1205,20110928,8132,8126,8100,8100,7982,8030,8048,-96,-78,175420,14119547600,314132
2350,p1205,20110929,8030,8048,7700,7870,7674,7846,7802,-202,-246,162836,12707599400,276418
2351,p1205,20110930,7846,7802,7876,8078,7810,8070,8012,268,210,108634,8705197760,276236
2352,p1205,20111010,8070,8012,7800,7856,7760,7792,7818,-220,-194,171250,13390570280,303142
2353,p1205,20111011,7792,7818,7860,7914,7780,7798,7846,-20,28,136136,10682068320,303566
2354,p1205,20111012,7798,7846,7952,8016,7898,7974,7958,128,112,187972,14961892800,287552
2355,p1205,20111013,7974,7958,7962,7996,7936,7988,7970,30,12,117770,9388113480,289418
2356,p1205,20111014,7988,7970,8030,8050,7988,8024,8012,54,42,120330,9641642720,279296
2357,p1205,20111017,8024,8012,8100,8108,8042,8072,8076,60,64,134536,10866701360,258686
2358,p1205,20111018,8072,8076,8000,8016,7866,7892,7930,-184,-146,97154,7705631040,255614
2359,p1205,20111019,7892,7930,7950,7984,7894,7924,7942,-6,12,98368,7814014560,253294
2360,p1205,20111020,7924,7942,7750,7768,7636,7736,7714,-206,-228,190124,14669137200,247628
2361,p1205,20111021,7736,7714,7780,7858,7780,7858,7830,144,116,116750,9142022760,232840
2362,p1205,20111024,7858,7830,7880,8056,7790,7986,7922,156,92,179548,14227043000,225746
2363,p1205,20111025,7986,7922,7998,8060,7946,7994,8000,72,78,176734,14141694120,223058
2364,p1205,20111026,7994,8000,7920,7986,7904,7964,7940,-36,-60,107648,8548737840,213610
2365,p1205,20111027,7964,7940,7940,8088,7924,8084,8030,144,90,167802,13477430680,221122
2366,p1205,20111028,8084,8030,8150,8180,8040,8052,8100,22,70,121470,9840065680,218534
2367,p1205,20111031,8052,8100,8046,8056,7932,7950,7974,-150,-126,97438,7769806840,214980
2368,p1205,20111101,7950,7974,7968,8000,7910,7930,7956,-44,-18,123014,9788803520,215378
2369,p1205,20111102,7930,7956,7890,8020,7844,8010,7914,54,-42,119908,9491498080,220248
2370,p1205,20111103,8010,7914,7962,7970,7894,7900,7928,-14,14,91222,7233223280,217100
2371,p1205,20111104,7900,7928,8010,8080,8010,8052,8046,124,118,133710,10759877560,226960
2372,p1205,20111107,8052,8046,8058,8058,7972,7980,8006,-66,-40,96542,7729358360,227318
2373,p1205,20111108,7980,8006,7974,8006,7896,7974,7952,-32,-54,120404,9576374520,229580
2374,p1205,20111109,7974,7952,8044,8110,8006,8044,8058,92,106,161360,13004465240,235016
2375,p1205,20111110,8044,8058,7912,7986,7830,7956,7926,-102,-132,218318,17307476440,240610
2376,p1205,20111111,7956,7926,8030,8168,8000,8130,8084,204,158,285030,23046667560,249880
2377,p1205,20111114,8130,8084,8180,8298,8172,8240,8238,156,154,326752,26921922840,261400
2378,p1205,20111115,8240,8238,8220,8276,8164,8252,8220,14,-18,238990,19649221080,251894
2379,p1205,20111116,8252,8220,8354,8354,8158,8170,8234,-50,14,209500,17252231960,230892
2380,p1205,20111117,8170,8234,8224,8340,8190,8292,8274,58,40,277910,22996659880,244228
2381,p1205,20111118,8292,8274,8130,8230,8070,8216,8178,-58,-96,215168,17597439320,232882
2382,p1205,20111121,8216,8178,8162,8212,8126,8152,8170,-26,-8,161888,13228757160,214274
2383,p1205,20111122,8152,8170,8070,8134,7996,8022,8058,-148,-112,235666,18992155040,195886
2384,p1205,20111123,8022,8058,8070,8084,7924,7938,8004,-120,-54,176812,14153859480,197660
2385,p1205,20111124,7938,8004,7880,7900,7706,7792,7800,-212,-204,266802,20815188160,197808
2386,p1205,20111125,7792,7800,7720,7854,7704,7760,7782,-40,-18,228476,17782830600,201106
2387,p1205,20111128,7760,7782,7780,7860,7780,7814,7824,32,42,155760,12188683680,186784
2388,p1205,20111129,7814,7824,7836,7880,7780,7864,7826,40,2,153026,11977659040,186990
2389,p1205,20111130,7864,7826,7882,7890,7758,7768,7816,-58,-10,133636,10446907120,187868
2390,p1205,20111201,7768,7816,7990,8022,7910,7970,7960,154,144,158514,12618919760,188132
2391,p1205,20111202,7970,7960,7980,7980,7924,7958,7948,-2,-12,89494,7113161080,188086
2392,p1205,20111205,7958,7948,8018,8028,7970,8008,8004,60,56,93056,7449496320,190276
2393,p1205,20111206,8008,8004,7978,7988,7938,7972,7966,-32,-38,88592,7058502200,187666
2394,p1205,20111207,7972,7966,8000,8030,7952,8028,7996,62,30,83060,6642374240,189120
2395,p1205,20111208,8028,7996,8006,8010,7916,7980,7962,-16,-34,127884,10183991160,190592
2396,p1205,20111209,7980,7962,7968,8010,7930,7968,7982,6,20,89622,7154377440,190656
2397,p1205,20111212,7968,7982,7868,7922,7838,7860,7876,-122,-106,124010,9767693240,184750
2398,p1205,20111213,7860,7876,7830,7896,7820,7824,7862,-52,-14,100994,7941352920,191728
2399,p1205,20111214,7824,7862,7842,7846,7690,7792,7798,-70,-64,147220,11480658960,190266
2400,p1205,20111215,7792,7798,7700,7804,7696,7784,7756,-14,-42,148232,11499798080,179914
2401,p1205,20111216,7784,7756,7812,7850,7770,7838,7812,82,56,109142,8528272720,178062
2402,p1205,20111219,7838,7812,7860,7882,7790,7828,7826,16,14,118534,9277588600,180910
2403,p1205,20111220,7828,7826,7818,7826,7766,7790,7798,-36,-28,105934,8261573000,174022
2404,p1205,20111221,7790,7798,7844,7844,7810,7826,7828,28,30,51536,4034418280,170488
2405,p1205,20111222,7826,7828,7826,7894,7826,7882,7870,54,42,96910,7627101040,166374
2406,p1205,20111223,7882,7870,7910,7956,7900,7936,7936,66,66,79670,6323850120,166106
2407,p1205,20111226,7936,7936,7996,7996,7906,7926,7938,-10,2,60202,4779093480,168196
2408,p1205,20111227,7926,7938,7922,7928,7872,7882,7896,-56,-42,52766,4167253680,168948
2409,p1205,20111228,7882,7896,7950,7994,7940,7986,7972,90,76,62632,4993491000,170166
2410,p1205,20111229,7986,7972,7950,7986,7940,7966,7962,-6,-10,40116,3194357160,169066
2411,p1205,20111230,7966,7962,7952,8016,7952,8002,7982,40,20,49432,3946222400,163986
2412,p1206,20110617,9234,9234,0,0,0,9234,9234,0,0,0,0,0
2413,p1206,20110620,9234,9234,0,0,0,9234,9234,0,0,0,0,0
2414,p1206,20110621,9234,9234,0,0,0,9234,9234,0,0,0,0,0
2415,p1206,20110622,9234,9234,0,0,0,9234,9234,0,0,0,0,0
2416,p1206,20110623,9234,9234,8948,8948,8948,8948,8948,-286,-286,4,357920,4
2417,p1206,20110624,8948,8948,0,0,0,8948,8948,0,0,0,0,4
2418,p1206,20110627,8948,8948,8860,8860,8860,8860,8860,-88,-88,4,354400,0
2419,p1206,20110628,8860,8860,0,0,0,8860,8860,0,0,0,0,0
2420,p1206,20110629,8860,8860,0,0,0,8860,8860,0,0,0,0,0
2421,p1206,20110630,8860,8860,0,0,0,8860,8860,0,0,0,0,0
2422,p1206,20110701,8860,8860,0,0,0,8860,8860,0,0,0,0,0
2423,p1206,20110704,8860,8860,0,0,0,8860,8860,0,0,0,0,0
2424,p1206,20110705,8860,8860,0,0,0,8860,8860,0,0,0,0,0
2425,p1206,20110706,8860,8860,0,0,0,8860,8860,0,0,0,0,0
2426,p1206,20110707,8860,8860,0,0,0,8860,8860,0,0,0,0,0
2427,p1206,20110708,8860,8860,0,0,0,8860,8860,0,0,0,0,0
2428,p1206,20110711,8860,8860,9020,9090,9020,9090,9066,230,206,6,544000,0
2429,p1206,20110712,9090,9066,9016,9040,8988,9000,9012,-66,-54,10,901200,0
2430,p1206,20110713,9000,9012,0,0,0,9012,9012,0,0,0,0,0
2431,p1206,20110714,9012,9012,0,0,0,9012,9012,0,0,0,0,0
2432,p1206,20110715,9012,9012,9152,9152,9152,9152,9152,140,140,2,183040,2
2433,p1206,20110718,9152,9152,0,0,0,9152,9152,0,0,0,0,2
2434,p1206,20110719,9152,9152,9170,9170,9170,9170,9170,18,18,2,183400,4
2435,p1206,20110720,9170,9170,9196,9318,9196,9260,9256,90,86,8,740520,2
2436,p1206,20110721,9260,9256,0,0,0,9256,9256,0,0,0,0,2
2437,p1206,20110722,9256,9256,0,0,0,9256,9256,0,0,0,0,2
2438,p1206,20110725,9256,9256,9254,9254,9152,9198,9202,-58,-54,38,3497040,0
2439,p1206,20110726,9198,9202,0,0,0,9202,9202,0,0,0,0,0
2440,p1206,20110727,9202,9202,9290,9290,9290,9290,9290,88,88,2,185800,2
2441,p1206,20110728,9290,9290,0,0,0,9290,9290,0,0,0,0,2
2442,p1206,20110729,9290,9290,0,0,0,9290,9290,0,0,0,0,2
2443,p1206,20110801,9290,9290,9250,9250,9200,9200,9216,-90,-74,6,553000,2
2444,p1206,20110802,9200,9216,0,0,0,9216,9216,0,0,0,0,2
2445,p1206,20110803,9216,9216,9244,9380,9244,9300,9308,84,92,6,558480,2
2446,p1206,20110804,9300,9308,0,0,0,9308,9308,0,0,0,0,2
2447,p1206,20110805,9308,9308,8844,8970,8844,8970,8928,-338,-380,6,535680,2
2448,p1206,20110808,8970,8928,0,0,0,8928,8928,0,0,0,0,2
2449,p1206,20110809,8928,8928,8600,8700,8600,8700,8632,-228,-296,6,518000,2
2450,p1206,20110810,8700,8632,8912,8914,8762,8780,8828,148,196,20,1765920,0
2451,p1206,20110811,8780,8828,0,0,0,8828,8828,0,0,0,0,0
2452,p1206,20110812,8828,8828,0,0,0,8828,8828,0,0,0,0,0
2453,p1206,20110815,8828,8828,0,0,0,8828,8828,0,0,0,0,0
2454,p1206,20110816,8828,8828,0,0,0,8828,8828,0,0,0,0,0
2455,p1206,20110817,8828,8828,0,0,0,8828,8828,0,0,0,0,0
2456,p1206,20110818,8828,8828,0,0,0,8828,8828,0,0,0,0,0
2457,p1206,20110819,8828,8828,8802,8998,8802,8868,8880,40,52,10,888120,0
2458,p1206,20110822,8868,8880,0,0,0,8880,8880,0,0,0,0,0
2459,p1206,20110823,8880,8880,0,0,0,8880,8880,0,0,0,0,0
2460,p1206,20110824,8880,8880,0,0,0,8880,8880,0,0,0,0,0
2461,p1206,20110825,8880,8880,8878,8878,8878,8878,8878,-2,-2,2,177560,2
2462,p1206,20110826,8878,8878,0,0,0,8878,8878,0,0,0,0,2
2463,p1206,20110829,8878,8878,9164,9164,8942,9064,9056,186,178,12,1086880,4
2464,p1206,20110830,9064,9056,9012,9012,9012,9012,9012,-44,-44,4,360480,2
2465,p1206,20110831,9012,9012,9060,9154,9054,9054,9088,42,76,6,545360,2
2466,p1206,20110901,9054,9088,0,0,0,9088,9088,0,0,0,0,2
2467,p1206,20110902,9088,9088,0,0,0,9088,9088,0,0,0,0,2
2468,p1206,20110905,9088,9088,9294,9294,9054,9068,9146,-20,58,20,1829360,4
2469,p1206,20110906,9068,9146,0,0,0,9146,9146,0,0,0,0,4
2470,p1206,20110907,9146,9146,9050,9050,9050,9050,9050,-96,-96,2,181000,2
2471,p1206,20110908,9050,9050,9042,9042,9020,9020,9030,-30,-20,4,361240,2
2472,p1206,20110909,9020,9030,0,0,0,9030,9030,0,0,0,0,2
2473,p1206,20110913,9030,9030,8840,9158,8840,8950,8982,-80,-48,12,1077920,2
2474,p1206,20110914,8950,8982,8880,9034,8840,8840,8900,-142,-82,10,890080,2
2475,p1206,20110915,8840,8900,0,0,0,8900,8900,0,0,0,0,2
2476,p1206,20110916,8900,8900,8950,8950,8848,8848,8880,-52,-20,14,1243440,0
2477,p1206,20110919,8848,8880,8766,8766,8766,8766,8766,-114,-114,2,175320,2
2478,p1206,20110920,8766,8766,8932,8932,8660,8750,8788,-16,22,56,4921360,2
2479,p1206,20110921,8750,8788,0,0,0,8788,8788,0,0,0,0,2
2480,p1206,20110922,8788,8788,0,0,0,8788,8788,0,0,0,0,2
2481,p1206,20110923,8788,8788,8452,8674,8452,8628,8584,-160,-204,6,515080,6
2482,p1206,20110926,8628,8584,8158,8158,8156,8156,8156,-428,-428,4,326280,6
2483,p1206,20110927,8156,8156,8210,8238,8200,8228,8218,72,62,8,657520,4
2484,p1206,20110928,8228,8218,7964,8210,7964,8210,8086,-8,-132,4,323480,4
2485,p1206,20110929,8210,8086,0,0,0,8086,8086,0,0,0,0,4
2486,p1206,20110930,8086,8086,0,0,0,8086,8086,0,0,0,0,4
2487,p1206,20111010,8086,8086,7996,7996,7996,7996,7996,-90,-90,2,159920,6
2488,p1206,20111011,7996,7996,7834,7840,7834,7840,7836,-156,-160,4,313480,4
2489,p1206,20111012,7840,7836,8002,8118,8002,8118,8060,282,224,4,322400,6
2490,p1206,20111013,8118,8060,0,0,0,8060,8060,0,0,0,0,6
2491,p1206,20111014,8060,8060,8036,8040,8036,8040,8038,-20,-22,4,321520,4
2492,p1206,20111017,8040,8038,7966,8208,7966,8092,8090,54,52,28,2265680,4
2493,p1206,20111018,8092,8090,8010,8010,8010,8010,8010,-80,-80,2,160200,4
2494,p1206,20111019,8010,8010,0,0,0,8010,8010,0,0,0,0,4
2495,p1206,20111020,8010,8010,7750,7750,7750,7750,7750,-260,-260,2,155000,4
2496,p1206,20111021,7750,7750,7846,7846,7846,7846,7846,96,96,2,156920,4
2497,p1206,20111024,7846,7846,0,0,0,7846,7846,0,0,0,0,4
2498,p1206,20111025,7846,7846,0,0,0,7846,7846,0,0,0,0,4
2499,p1206,20111026,7846,7846,0,0,0,7846,7846,0,0,0,0,4
2500,p1206,20111027,7846,7846,0,0,0,7846,7846,0,0,0,0,4
2501,p1206,20111028,7846,7846,8238,8238,8238,8238,8238,392,392,2,164760,2
2502,p1206,20111031,8238,8238,0,0,0,8238,8238,0,0,0,0,2
2503,p1206,20111101,8238,8238,8194,8194,7876,8032,8058,-206,-180,44,3545880,24
2504,p1206,20111102,8032,8058,7920,8028,7900,8028,7920,-30,-138,36,2851360,4
2505,p1206,20111103,8028,7920,0,0,0,7920,7920,0,0,0,0,4
2506,p1206,20111104,7920,7920,0,0,0,7920,7920,0,0,0,0,4
2507,p1206,20111107,7920,7920,0,0,0,7920,7920,0,0,0,0,4
2508,p1206,20111108,7920,7920,0,0,0,7920,7920,0,0,0,0,4
2509,p1206,20111109,7920,7920,0,0,0,7920,7920,0,0,0,0,4
2510,p1206,20111110,7920,7920,7836,8000,7836,8000,7934,80,14,6,476120,8
2511,p1206,20111111,8000,7934,8176,8176,7942,8170,8076,236,142,50,4038680,14
2512,p1206,20111114,8170,8076,8260,8260,8260,8260,8260,184,184,2,165200,12
2513,p1206,20111115,8260,8260,0,0,0,8260,8260,0,0,0,0,12
2514,p1206,20111116,8260,8260,0,0,0,8260,8260,0,0,0,0,12
2515,p1206,20111117,8260,8260,0,0,0,8260,8260,0,0,0,0,12
2516,p1206,20111118,8260,8260,8140,8304,8140,8230,8226,-30,-34,18,1480680,14
2517,p1206,20111121,8230,8226,8228,8250,8206,8206,8230,-20,4,20,1646120,8
2518,p1206,20111122,8206,8230,8128,8128,8128,8128,8128,-102,-102,2,162560,8
2519,p1206,20111123,8128,8128,7982,7982,7982,7982,7982,-146,-146,2,159640,10
2520,p1206,20111124,7982,7982,7824,7848,7760,7848,7788,-134,-194,12,934640,8
2521,p1206,20111125,7848,7788,7824,7920,7786,7786,7838,-2,50,14,1097360,8
2522,p1206,20111128,7786,7838,0,0,0,7838,7838,0,0,0,0,8
2523,p1206,20111129,7838,7838,0,0,0,7838,7838,0,0,0,0,8
2524,p1206,20111130,7838,7838,0,0,0,7838,7838,0,0,0,0,8
2525,p1206,20111201,7838,7838,0,0,0,7838,7838,0,0,0,0,8
2526,p1206,20111202,7838,7838,0,0,0,7838,7838,0,0,0,0,8
2527,p1206,20111205,7838,7838,8078,8078,8018,8018,8048,180,210,4,321920,10
2528,p1206,20111206,8018,8048,8008,8008,7980,7980,7984,-68,-64,14,1117960,20
2529,p1206,20111207,7980,7984,8002,8030,8000,8030,8008,46,24,10,800960,22
2530,p1206,20111208,8030,8008,8030,8030,7952,8026,7982,18,-26,22,1756440,14
2531,p1206,20111209,8026,7982,8040,8040,8040,8040,8040,58,58,2,160800,14
2532,p1206,20111212,8040,8040,7960,7960,7734,7910,7868,-130,-172,10,786800,12
2533,p1206,20111213,7910,7868,7926,7926,7840,7860,7882,-8,14,8,630680,14
2534,p1206,20111214,7860,7882,7780,7826,7780,7826,7812,-56,-70,18,1406360,12
2535,p1206,20111215,7826,7812,7710,7812,7710,7812,7770,0,-42,8,621640,10
2536,p1206,20111216,7812,7770,0,0,0,7770,7770,0,0,0,0,10
2537,p1206,20111219,7770,7770,7850,7850,7828,7828,7838,58,68,6,470280,10
2538,p1206,20111220,7828,7838,7838,7838,7826,7828,7830,-10,-8,6,469840,6
2539,p1206,20111221,7828,7830,7832,7860,7832,7838,7842,8,12,6,470600,4
2540,p1206,20111222,7838,7842,7856,7906,7856,7894,7872,52,30,12,944720,10
2541,p1206,20111223,7894,7872,0,0,0,7872,7872,0,0,0,0,10
2542,p1206,20111226,7872,7872,7980,7980,7978,7978,7978,106,106,4,319160,10
2543,p1206,20111227,7978,7978,7906,7930,7900,7900,7908,-78,-70,12,949080,4
2544,p1206,20111228,7900,7908,7966,7966,7966,7966,7966,58,58,2,159320,4
2545,p1206,20111229,7966,7966,0,0,0,7966,7966,0,0,0,0,4
2546,p1206,20111230,7966,7966,0,0,0,7966,7966,0,0,0,0,4
2547,p1207,20110718,9054,9054,0,0,0,9054,9054,0,0,0,0,0
2548,p1207,20110719,9054,9054,0,0,0,9054,9054,0,0,0,0,0
2549,p1207,20110720,9054,9054,0,0,0,9054,9054,0,0,0,0,0
2550,p1207,20110721,9054,9054,0,0,0,9054,9054,0,0,0,0,0
2551,p1207,20110722,9054,9054,0,0,0,9054,9054,0,0,0,0,0
2552,p1207,20110725,9054,9054,0,0,0,9054,9054,0,0,0,0,0
2553,p1207,20110726,9054,9054,0,0,0,9054,9054,0,0,0,0,0
2554,p1207,20110727,9054,9054,0,0,0,9054,9054,0,0,0,0,0
2555,p1207,20110728,9054,9054,0,0,0,9054,9054,0,0,0,0,0
2556,p1207,20110729,9054,9054,0,0,0,9054,9054,0,0,0,0,0
2557,p1207,20110801,9054,9054,0,0,0,9054,9054,0,0,0,0,0
2558,p1207,20110802,9054,9054,0,0,0,9054,9054,0,0,0,0,0
2559,p1207,20110803,9054,9054,0,0,0,9054,9054,0,0,0,0,0
2560,p1207,20110804,9054,9054,0,0,0,9054,9054,0,0,0,0,0
2561,p1207,20110805,9054,9054,0,0,0,9054,9054,0,0,0,0,0
2562,p1207,20110808,9054,9054,0,0,0,9054,9054,0,0,0,0,0
2563,p1207,20110809,9054,9054,0,0,0,9054,9054,0,0,0,0,0
2564,p1207,20110810,9054,9054,8794,8802,8794,8802,8798,-252,-256,4,351920,4
2565,p1207,20110811,8802,8798,8784,8784,8784,8784,8784,-14,-14,2,175680,2
2566,p1207,20110812,8784,8784,0,0,0,8784,8784,0,0,0,0,2
2567,p1207,20110815,8784,8784,0,0,0,8784,8784,0,0,0,0,2
2568,p1207,20110816,8784,8784,8898,8898,8898,8898,8898,114,114,2,177960,2
2569,p1207,20110817,8898,8898,0,0,0,8898,8898,0,0,0,0,2
2570,p1207,20110818,8898,8898,0,0,0,8898,8898,0,0,0,0,2
2571,p1207,20110819,8898,8898,0,0,0,8898,8898,0,0,0,0,2
2572,p1207,20110822,8898,8898,0,0,0,8898,8898,0,0,0,0,2
2573,p1207,20110823,8898,8898,8952,8952,8952,8952,8952,54,54,2,179040,2
2574,p1207,20110824,8952,8952,0,0,0,8952,8952,0,0,0,0,2
2575,p1207,20110825,8952,8952,0,0,0,8952,8952,0,0,0,0,2
2576,p1207,20110826,8952,8952,0,0,0,8952,8952,0,0,0,0,2
2577,p1207,20110829,8952,8952,0,0,0,8952,8952,0,0,0,0,2
2578,p1207,20110830,8952,8952,0,0,0,8952,8952,0,0,0,0,2
2579,p1207,20110831,8952,8952,9062,9062,9062,9062,9062,110,110,2,181240,4
2580,p1207,20110901,9062,9062,9058,9080,9058,9080,9068,18,6,4,362760,4
2581,p1207,20110902,9080,9068,0,0,0,9068,9068,0,0,0,0,4
2582,p1207,20110905,9068,9068,9256,9272,9074,9134,9176,66,108,22,2018960,2
2583,p1207,20110906,9134,9176,0,0,0,9176,9176,0,0,0,0,2
2584,p1207,20110907,9176,9176,0,0,0,9176,9176,0,0,0,0,2
2585,p1207,20110908,9176,9176,0,0,0,9176,9176,0,0,0,0,2
2586,p1207,20110909,9176,9176,0,0,0,9176,9176,0,0,0,0,2
2587,p1207,20110913,9176,9176,0,0,0,9176,9176,0,0,0,0,2
2588,p1207,20110914,9176,9176,0,0,0,9176,9176,0,0,0,0,2
2589,p1207,20110915,9176,9176,0,0,0,9176,9176,0,0,0,0,2
2590,p1207,20110916,9176,9176,0,0,0,9176,9176,0,0,0,0,2
2591,p1207,20110919,9176,9176,0,0,0,9176,9176,0,0,0,0,2
2592,p1207,20110920,9176,9176,0,0,0,9176,9176,0,0,0,0,2
2593,p1207,20110921,9176,9176,0,0,0,9176,9176,0,0,0,0,2
2594,p1207,20110922,9176,9176,0,0,0,9176,9176,0,0,0,0,2
2595,p1207,20110923,9176,9176,8718,8718,8718,8718,8718,-458,-458,2,174360,4
2596,p1207,20110926,8718,8718,8306,8306,8198,8198,8252,-520,-466,4,330080,6
2597,p1207,20110927,8198,8252,8200,8200,8200,8200,8200,-52,-52,2,164000,6
2598,p1207,20110928,8200,8200,0,0,0,8200,8200,0,0,0,0,6
2599,p1207,20110929,8200,8200,7796,7796,7796,7796,7796,-404,-404,2,155920,4
2600,p1207,20110930,7796,7796,0,0,0,7796,7796,0,0,0,0,4
2601,p1207,20111010,7796,7796,0,0,0,7796,7796,0,0,0,0,4
2602,p1207,20111011,7796,7796,0,0,0,7796,7796,0,0,0,0,4
2603,p1207,20111012,7796,7796,0,0,0,7796,7796,0,0,0,0,4
2604,p1207,20111013,7796,7796,0,0,0,7796,7796,0,0,0,0,4
2605,p1207,20111014,7796,7796,0,0,0,7796,7796,0,0,0,0,4
2606,p1207,20111017,7796,7796,0,0,0,7796,7796,0,0,0,0,4
2607,p1207,20111018,7796,7796,0,0,0,7796,7796,0,0,0,0,4
2608,p1207,20111019,7796,7796,0,0,0,7796,7796,0,0,0,0,4
2609,p1207,20111020,7796,7796,0,0,0,7796,7796,0,0,0,0,4
2610,p1207,20111021,7796,7796,0,0,0,7796,7796,0,0,0,0,4
2611,p1207,20111024,7796,7796,0,0,0,7796,7796,0,0,0,0,4
2612,p1207,20111025,7796,7796,0,0,0,7796,7796,0,0,0,0,4
2613,p1207,20111026,7796,7796,0,0,0,7796,7796,0,0,0,0,4
2614,p1207,20111027,7796,7796,8160,8160,7990,8130,8102,334,306,8,648200,4
2615,p1207,20111028,8130,8102,0,0,0,8102,8102,0,0,0,0,4
2616,p1207,20111031,8102,8102,0,0,0,8102,8102,0,0,0,0,4
2617,p1207,20111101,8102,8102,0,0,0,8102,8102,0,0,0,0,4
2618,p1207,20111102,8102,8102,0,0,0,8102,8102,0,0,0,0,4
2619,p1207,20111103,8102,8102,0,0,0,8102,8102,0,0,0,0,4
2620,p1207,20111104,8102,8102,0,0,0,8102,8102,0,0,0,0,4
2621,p1207,20111107,8102,8102,0,0,0,8102,8102,0,0,0,0,4
2622,p1207,20111108,8102,8102,0,0,0,8102,8102,0,0,0,0,4
2623,p1207,20111109,8102,8102,0,0,0,8102,8102,0,0,0,0,4
2624,p1207,20111110,8102,8102,0,0,0,8102,8102,0,0,0,0,4
2625,p1207,20111111,8102,8102,0,0,0,8102,8102,0,0,0,0,4
2626,p1207,20111114,8102,8102,8132,8326,8130,8326,8198,224,96,32,2623800,14
2627,p1207,20111115,8326,8198,8308,8308,8308,8308,8308,110,110,10,830800,4
2628,p1207,20111116,8308,8308,0,0,0,8308,8308,0,0,0,0,4
2629,p1207,20111117,8308,8308,0,0,0,8308,8308,0,0,0,0,4
2630,p1207,20111118,8308,8308,0,0,0,8308,8308,0,0,0,0,4
2631,p1207,20111121,8308,8308,8096,8278,8096,8184,8168,-124,-140,10,816800,4
2632,p1207,20111122,8184,8168,0,0,0,8168,8168,0,0,0,0,4
2633,p1207,20111123,8168,8168,8020,8020,8020,8020,8020,-148,-148,2,160400,4
2634,p1207,20111124,8020,8020,7838,7838,7838,7838,7838,-182,-182,2,156760,6
2635,p1207,20111125,7838,7838,0,0,0,7838,7838,0,0,0,0,6
2636,p1207,20111128,7838,7838,0,0,0,7838,7838,0,0,0,0,6
2637,p1207,20111129,7838,7838,0,0,0,7838,7838,0,0,0,0,6
2638,p1207,20111130,7838,7838,0,0,0,7838,7838,0,0,0,0,6
2639,p1207,20111201,7838,7838,7988,7988,7988,7988,7988,150,150,2,159760,6
2640,p1207,20111202,7988,7988,0,0,0,7988,7988,0,0,0,0,6
2641,p1207,20111205,7988,7988,0,0,0,7988,7988,0,0,0,0,6
2642,p1207,20111206,7988,7988,0,0,0,7988,7988,0,0,0,0,6
2643,p1207,20111207,7988,7988,0,0,0,7988,7988,0,0,0,0,6
2644,p1207,20111208,7988,7988,0,0,0,7988,7988,0,0,0,0,6
2645,p1207,20111209,7988,7988,7860,7860,7860,7860,7860,-128,-128,2,157200,6
2646,p1207,20111212,7860,7860,0,0,0,7860,7860,0,0,0,0,6
2647,p1207,20111213,7860,7860,0,0,0,7860,7860,0,0,0,0,6
2648,p1207,20111214,7860,7860,0,0,0,7860,7860,0,0,0,0,6
2649,p1207,20111215,7860,7860,0,0,0,7860,7860,0,0,0,0,6
2650,p1207,20111216,7860,7860,0,0,0,7860,7860,0,0,0,0,6
2651,p1207,20111219,7860,7860,0,0,0,7860,7860,0,0,0,0,6
2652,p1207,20111220,7860,7860,0,0,0,7860,7860,0,0,0,0,6
2653,p1207,20111221,7860,7860,0,0,0,7860,7860,0,0,0,0,6
2654,p1207,20111222,7860,7860,0,0,0,7860,7860,0,0,0,0,6
2655,p1207,20111223,7860,7860,0,0,0,7860,7860,0,0,0,0,6
2656,p1207,20111226,7860,7860,0,0,0,7860,7860,0,0,0,0,6
2657,p1207,20111227,7860,7860,0,0,0,7860,7860,0,0,0,0,6
2658,p1207,20111228,7860,7860,0,0,0,7860,7860,0,0,0,0,6
2659,p1207,20111229,7860,7860,0,0,0,7860,7860,0,0,0,0,6
2660,p1207,20111230,7860,7860,0,0,0,7860,7860,0,0,0,0,6
2661,p1208,20110816,8718,8718,0,0,0,8718,8718,0,0,0,0,0
2662,p1208,20110817,8718,8718,0,0,0,8718,8718,0,0,0,0,0
2663,p1208,20110818,8718,8718,0,0,0,8718,8718,0,0,0,0,0
2664,p1208,20110819,8718,8718,0,0,0,8718,8718,0,0,0,0,0
2665,p1208,20110822,8718,8718,0,0,0,8718,8718,0,0,0,0,0
2666,p1208,20110823,8718,8718,0,0,0,8718,8718,0,0,0,0,0
2667,p1208,20110824,8718,8718,8900,9100,8882,8882,8980,164,262,14,1257240,4
2668,p1208,20110825,8882,8980,8950,8950,8950,8950,8950,-30,-30,2,179000,2
2669,p1208,20110826,8950,8950,0,0,0,8950,8950,0,0,0,0,2
2670,p1208,20110829,8950,8950,0,0,0,8950,8950,0,0,0,0,2
2671,p1208,20110830,8950,8950,0,0,0,8950,8950,0,0,0,0,2
2672,p1208,20110831,8950,8950,9126,9126,9126,9126,9126,176,176,2,182520,4
2673,p1208,20110901,9126,9126,0,0,0,9126,9126,0,0,0,0,4
2674,p1208,20110902,9126,9126,0,0,0,9126,9126,0,0,0,0,4
2675,p1208,20110905,9126,9126,0,0,0,9126,9126,0,0,0,0,4
2676,p1208,20110906,9126,9126,8980,8980,8980,8980,8980,-146,-146,2,179600,4
2677,p1208,20110907,8980,8980,9010,9010,9010,9010,9010,30,30,2,180200,2
2678,p1208,20110908,9010,9010,0,0,0,9010,9010,0,0,0,0,2
2679,p1208,20110909,9010,9010,0,0,0,9010,9010,0,0,0,0,2
2680,p1208,20110913,9010,9010,0,0,0,9010,9010,0,0,0,0,2
2681,p1208,20110914,9010,9010,0,0,0,9010,9010,0,0,0,0,2
2682,p1208,20110915,9010,9010,0,0,0,9010,9010,0,0,0,0,2
2683,p1208,20110916,9010,9010,0,0,0,9010,9010,0,0,0,0,2
2684,p1208,20110919,9010,9010,0,0,0,9010,9010,0,0,0,0,2
2685,p1208,20110920,9010,9010,0,0,0,9010,9010,0,0,0,0,2
2686,p1208,20110921,9010,9010,0,0,0,9010,9010,0,0,0,0,2
2687,p1208,20110922,9010,9010,0,0,0,9010,9010,0,0,0,0,2
2688,p1208,20110923,9010,9010,8560,8560,8560,8560,8560,-450,-450,2,171200,4
2689,p1208,20110926,8560,8560,0,0,0,8560,8560,0,0,0,0,4
2690,p1208,20110927,8560,8560,8058,8358,8012,8298,8162,-262,-398,30,2448920,10
2691,p1208,20110928,8298,8162,8120,8120,8120,8120,8120,-42,-42,8,649600,2
2692,p1208,20110929,8120,8120,0,0,0,8120,8120,0,0,0,0,2
2693,p1208,20110930,8120,8120,7960,8238,7960,8060,8088,-60,-32,12,970720,2
2694,p1208,20111010,8060,8088,0,0,0,8088,8088,0,0,0,0,2
2695,p1208,20111011,8088,8088,0,0,0,8088,8088,0,0,0,0,2
2696,p1208,20111012,8088,8088,0,0,0,8088,8088,0,0,0,0,2
2697,p1208,20111013,8088,8088,0,0,0,8088,8088,0,0,0,0,2
2698,p1208,20111014,8088,8088,0,0,0,8088,8088,0,0,0,0,2
2699,p1208,20111017,8088,8088,0,0,0,8088,8088,0,0,0,0,2
2700,p1208,20111018,8088,8088,7776,7776,7776,7776,7776,-312,-312,2,155520,4
2701,p1208,20111019,7776,7776,7990,8000,7990,8000,7994,224,218,4,319800,2
2702,p1208,20111020,8000,7994,7950,7950,7702,7924,7858,-70,-136,12,943040,6
2703,p1208,20111021,7924,7858,7844,7860,7844,7860,7852,2,-6,8,628160,2
2704,p1208,20111024,7860,7852,0,0,0,7852,7852,0,0,0,0,2
2705,p1208,20111025,7852,7852,8040,8040,8040,8040,8040,188,188,2,160800,4
2706,p1208,20111026,8040,8040,8000,8000,8000,8000,8000,-40,-40,2,160000,2
2707,p1208,20111027,8000,8000,0,0,0,8000,8000,0,0,0,0,2
2708,p1208,20111028,8000,8000,0,0,0,8000,8000,0,0,0,0,2
2709,p1208,20111031,8000,8000,0,0,0,8000,8000,0,0,0,0,2
2710,p1208,20111101,8000,8000,0,0,0,8000,8000,0,0,0,0,2
2711,p1208,20111102,8000,8000,8030,8030,8030,8030,8030,30,30,2,160600,2
2712,p1208,20111103,8030,8030,0,0,0,8030,8030,0,0,0,0,2
2713,p1208,20111104,8030,8030,0,0,0,8030,8030,0,0,0,0,2
2714,p1208,20111107,8030,8030,0,0,0,8030,8030,0,0,0,0,2
2715,p1208,20111108,8030,8030,0,0,0,8030,8030,0,0,0,0,2
2716,p1208,20111109,8030,8030,0,0,0,8030,8030,0,0,0,0,2
2717,p1208,20111110,8030,8030,0,0,0,8030,8030,0,0,0,0,2
2718,p1208,20111111,8030,8030,8322,8322,8150,8200,8224,170,194,6,493440,2
2719,p1208,20111114,8200,8224,8264,8300,8264,8300,8282,76,58,4,331280,0
2720,p1208,20111115,8300,8282,0,0,0,8282,8282,0,0,0,0,0
2721,p1208,20111116,8282,8282,0,0,0,8282,8282,0,0,0,0,0
2722,p1208,20111117,8282,8282,0,0,0,8282,8282,0,0,0,0,0
2723,p1208,20111118,8282,8282,0,0,0,8282,8282,0,0,0,0,0
2724,p1208,20111121,8282,8282,0,0,0,8282,8282,0,0,0,0,0
2725,p1208,20111122,8282,8282,0,0,0,8282,8282,0,0,0,0,0
2726,p1208,20111123,8282,8282,0,0,0,8282,8282,0,0,0,0,0
2727,p1208,20111124,8282,8282,8014,8014,8014,8014,8014,-268,-268,2,160280,2
2728,p1208,20111125,8014,8014,7732,7820,7732,7820,7782,-194,-232,8,622680,0
2729,p1208,20111128,7820,7782,0,0,0,7782,7782,0,0,0,0,0
2730,p1208,20111129,7782,7782,0,0,0,7782,7782,0,0,0,0,0
2731,p1208,20111130,7782,7782,0,0,0,7782,7782,0,0,0,0,0
2732,p1208,20111201,7782,7782,0,0,0,7782,7782,0,0,0,0,0
2733,p1208,20111202,7782,7782,0,0,0,7782,7782,0,0,0,0,0
2734,p1208,20111205,7782,7782,0,0,0,7782,7782,0,0,0,0,0
2735,p1208,20111206,7782,7782,0,0,0,7782,7782,0,0,0,0,0
2736,p1208,20111207,7782,7782,0,0,0,7782,7782,0,0,0,0,0
2737,p1208,20111208,7782,7782,0,0,0,7782,7782,0,0,0,0,0
2738,p1208,20111209,7782,7782,0,0,0,7782,7782,0,0,0,0,0
2739,p1208,20111212,7782,7782,0,0,0,7782,7782,0,0,0,0,0
2740,p1208,20111213,7782,7782,0,0,0,7782,7782,0,0,0,0,0
2741,p1208,20111214,7782,7782,0,0,0,7782,7782,0,0,0,0,0
2742,p1208,20111215,7782,7782,0,0,0,7782,7782,0,0,0,0,0
2743,p1208,20111216,7782,7782,0,0,0,7782,7782,0,0,0,0,0
2744,p1208,20111219,7782,7782,0,0,0,7782,7782,0,0,0,0,0
2745,p1208,20111220,7782,7782,7998,7998,7802,7852,7884,70,102,32,2523080,2
2746,p1208,20111221,7852,7884,0,0,0,7884,7884,0,0,0,0,2
2747,p1208,20111222,7884,7884,0,0,0,7884,7884,0,0,0,0,2
2748,p1208,20111223,7884,7884,0,0,0,7884,7884,0,0,0,0,2
2749,p1208,20111226,7884,7884,0,0,0,7884,7884,0,0,0,0,2
2750,p1208,20111227,7884,7884,0,0,0,7884,7884,0,0,0,0,2
2751,p1208,20111228,7884,7884,8200,8200,7788,7980,7984,96,100,18,1437360,0
2752,p1208,20111229,7980,7984,0,0,0,7984,7984,0,0,0,0,0
2753,p1208,20111230,7984,7984,0,0,0,7984,7984,0,0,0,0,0
2754,p1209,20110919,8924,8908,8852,8852,8738,8738,8794,-170,-114,252,22161560,274
2755,p1209,20110920,8738,8794,8730,8818,8730,8790,8790,-4,-4,98,8614720,282
2756,p1209,20110921,8790,8790,8790,8790,8710,8788,8770,-2,-20,76,6666160,310
2757,p1209,20110922,8788,8770,8700,8700,8600,8610,8640,-160,-130,176,15208280,364
2758,p1209,20110923,8610,8640,8510,8512,8208,8294,8408,-346,-232,1368,115029400,1090
2759,p1209,20110926,8294,8408,8294,8296,7988,7988,8180,-420,-228,686,56115840,1156
2760,p1209,20110927,7988,8180,8170,8190,8110,8170,8152,-10,-28,428,34892760,1136
2761,p1209,20110928,8170,8152,8144,8144,8030,8054,8072,-98,-80,278,22444680,1114
2762,p1209,20110929,8054,8072,7872,7890,7722,7868,7800,-204,-272,308,24027200,1146
2763,p1209,20110930,7868,7800,7886,8110,7886,8110,8014,310,214,122,9778360,1144
2764,p1209,20111010,8110,8014,7894,7912,7760,7780,7810,-234,-204,7978,623109520,6432
2765,p1209,20111011,7780,7810,7850,7904,7786,7800,7860,-10,50,2300,180781280,6858
2766,p1209,20111012,7800,7860,7950,8030,7902,8016,7976,156,116,2788,222425440,7526
2767,p1209,20111013,8016,7976,8000,8028,7960,8006,7992,30,16,2934,234542520,7656
2768,p1209,20111014,8006,7992,8050,8088,8006,8046,8020,54,28,3638,291803480,9292
2769,p1209,20111017,8046,8020,8098,8122,8070,8088,8050,68,30,2972,239281320,11074
2770,p1209,20111018,8088,8050,8020,8024,7902,7920,7956,-130,-94,2010,159947440,11800
2771,p1209,20111019,7920,7956,7998,8008,7930,7964,7974,8,18,1318,105110640,12176
2772,p1209,20111020,7964,7974,7820,7834,7722,7804,7788,-170,-186,3530,274975040,13398
2773,p1209,20111021,7804,7788,7850,7920,7850,7916,7880,128,92,2316,182545400,14308
2774,p1209,20111024,7916,7880,7950,8070,7860,8026,7968,146,88,3312,263922400,15360
2775,p1209,20111025,8026,7968,8040,8094,7996,8026,8018,58,50,1990,159576960,16104
2776,p1209,20111026,8026,8018,7988,8018,7940,8002,7978,-16,-40,1778,141882640,16236
2777,p1209,20111027,8002,7978,7970,8162,7964,8156,8060,178,82,6606,532572840,19204
2778,p1209,20111028,8156,8060,8170,8248,8112,8118,8166,58,106,6086,497102760,20014
2779,p1209,20111031,8118,8166,8120,8124,7998,8012,8054,-154,-112,5362,431893960,21302
2780,p1209,20111101,8012,8054,8036,8084,8000,8022,8036,-32,-18,3546,285011880,22406
2781,p1209,20111102,8022,8036,7970,8110,7952,8106,8010,70,-26,5222,418360080,23850
2782,p1209,20111103,8106,8010,8060,8066,7998,7998,8030,-12,20,3712,298113840,23796
2783,p1209,20111104,7998,8030,8110,8184,8110,8162,8152,132,122,3250,264960560,24392
2784,p1209,20111107,8162,8152,8160,8160,8080,8092,8116,-60,-36,2640,214263160,24632
2785,p1209,20111108,8092,8116,8082,8122,8020,8088,8072,-28,-44,4080,329360760,24788
2786,p1209,20111109,8088,8072,8130,8228,8130,8178,8176,106,104,11308,924574040,28570
2787,p1209,20111110,8178,8176,8090,8100,7970,8070,8056,-106,-120,14836,1195281040,27948
2788,p1209,20111111,8070,8056,8144,8268,8110,8242,8186,186,130,26472,2167519440,40016
2789,p1209,20111114,8242,8186,8290,8400,8276,8352,8318,166,132,37390,3110718960,50854
2790,p1209,20111115,8352,8318,8350,8394,8284,8364,8328,46,10,29918,2492155240,55358
2791,p1209,20111116,8364,8328,8420,8434,8264,8278,8350,-50,22,32884,2745905640,53632
2792,p1209,20111117,8278,8350,8370,8426,8294,8378,8368,28,18,42968,3595753360,68780
2793,p1209,20111118,8378,8368,8168,8292,8162,8284,8242,-84,-126,22906,1888129880,72310
2794,p1209,20111121,8284,8242,8218,8268,8198,8224,8236,-18,-6,12704,1046476040,72000
2795,p1209,20111122,8224,8236,8144,8196,8040,8068,8114,-168,-122,20394,1654773640,72182
2796,p1209,20111123,8068,8114,8102,8124,7952,7962,8036,-152,-78,27394,2201796640,76088
2797,p1209,20111124,7962,8036,7902,7932,7738,7824,7844,-212,-192,28498,2235471880,73466
2798,p1209,20111125,7824,7844,7800,7884,7738,7794,7818,-50,-26,20886,1633051920,73128
2799,p1209,20111128,7794,7818,7890,7910,7836,7870,7874,52,56,19274,1517653480,74310
2800,p1209,20111129,7870,7874,7890,7918,7826,7900,7870,26,-4,16494,1298181160,76496
2801,p1209,20111130,7900,7870,7928,7928,7784,7786,7850,-84,-20,15366,1206252120,79586
2802,p1209,20111201,7786,7850,7966,8052,7934,8002,7986,152,136,21348,1704946440,76026
2803,p1209,20111202,8002,7986,8002,8010,7962,7992,7984,6,-2,9288,741576720,76664
2804,p1209,20111205,7992,7984,8030,8058,8006,8044,8038,60,54,11212,901420920,76782
2805,p1209,20111206,8044,8038,8046,8046,7974,8016,8002,-22,-36,13734,1099045160,77392
2806,p1209,20111207,8016,8002,8030,8068,8000,8068,8036,66,34,8344,670653080,77162
2807,p1209,20111208,8068,8036,8040,8050,7952,8014,7996,-22,-40,15440,1234647880,77432
2808,p1209,20111209,8014,7996,7984,8042,7976,7998,8010,2,14,15484,1240544600,77396
2809,p1209,20111212,7998,8010,7976,7976,7874,7890,7912,-120,-98,17758,1405049600,77004
2810,p1209,20111213,7890,7912,7910,7926,7828,7832,7874,-80,-38,28632,2255012920,78416
2811,p1209,20111214,7832,7874,7832,7856,7708,7798,7806,-76,-68,31464,2456507480,80796
2812,p1209,20111215,7798,7806,7728,7792,7702,7764,7744,-42,-62,37532,2907077320,85322
2813,p1209,20111216,7764,7744,7812,7826,7752,7822,7792,78,48,23236,1810709680,85784
2814,p1209,20111219,7822,7792,7860,7878,7816,7866,7852,74,60,47030,3693218680,88358
2815,p1209,20111220,7866,7852,7872,7872,7822,7846,7848,-6,-4,29484,2314237840,87500
2816,p1209,20111221,7846,7848,7890,7896,7852,7860,7868,12,20,23904,1880826720,87596
2817,p1209,20111222,7860,7868,7870,7934,7868,7920,7906,52,38,32428,2564192000,89922
2818,p1209,20111223,7920,7906,7950,7984,7940,7966,7968,60,62,25128,2002412680,92628
2819,p1209,20111226,7966,7968,8022,8026,7924,7936,7966,-32,-2,33342,2656493800,94360
2820,p1209,20111227,7936,7966,7938,7938,7880,7888,7906,-78,-60,29266,2314226200,95440
2821,p1209,20111228,7888,7906,7950,8004,7946,8002,7982,96,76,38728,3091310040,102564
2822,p1209,20111229,8002,7982,7976,8002,7958,7984,7980,2,-2,31616,2523504080,102044
2823,p1209,20111230,7984,7980,7986,8046,7976,8038,8014,58,34,43776,3509072720,99826
2824,p1210,20111025,7788,7788,0,0,0,7788,7788,0,0,0,0,0
2825,p1210,20111026,7788,7788,0,0,0,7788,7788,0,0,0,0,0
2826,p1210,20111027,7788,7788,0,0,0,7788,7788,0,0,0,0,0
2827,p1210,20111028,7788,7788,0,0,0,7788,7788,0,0,0,0,0
2828,p1210,20111031,7788,7788,0,0,0,7788,7788,0,0,0,0,0
2829,p1210,20111101,7788,7788,0,0,0,7788,7788,0,0,0,0,0
2830,p1210,20111102,7788,7788,0,0,0,7788,7788,0,0,0,0,0
2831,p1210,20111103,7788,7788,0,0,0,7788,7788,0,0,0,0,0
2832,p1210,20111104,7788,7788,0,0,0,7788,7788,0,0,0,0,0
2833,p1210,20111107,7788,7788,0,0,0,7788,7788,0,0,0,0,0
2834,p1210,20111108,7788,7788,0,0,0,7788,7788,0,0,0,0,0
2835,p1210,20111109,7788,7788,0,0,0,7788,7788,0,0,0,0,0
2836,p1210,20111110,7788,7788,0,0,0,7788,7788,0,0,0,0,0
2837,p1210,20111111,7788,7788,8408,8408,8312,8312,8344,524,556,14,1168160,14
2838,p1210,20111114,8312,8344,8378,8380,8378,8380,8378,36,34,10,837960,4
2839,p1210,20111115,8380,8378,8334,8334,8334,8334,8334,-44,-44,2,166680,4
2840,p1210,20111116,8334,8334,0,0,0,8334,8334,0,0,0,0,4
2841,p1210,20111117,8334,8334,8446,8446,8446,8446,8446,112,112,2,168920,2
2842,p1210,20111118,8446,8446,8320,8320,8320,8320,8320,-126,-126,2,166400,2
2843,p1210,20111121,8320,8320,0,0,0,8320,8320,0,0,0,0,2
2844,p1210,20111122,8320,8320,0,0,0,8320,8320,0,0,0,0,2
2845,p1210,20111123,8320,8320,7970,7970,7970,7970,7970,-350,-350,2,159400,2
2846,p1210,20111124,7970,7970,0,0,0,7970,7970,0,0,0,0,2
2847,p1210,20111125,7970,7970,7788,7788,7788,7788,7788,-182,-182,2,155760,0
2848,p1210,20111128,7788,7788,0,0,0,7788,7788,0,0,0,0,0
2849,p1210,20111129,7788,7788,0,0,0,7788,7788,0,0,0,0,0
2850,p1210,20111130,7788,7788,0,0,0,7788,7788,0,0,0,0,0
2851,p1210,20111201,7788,7788,0,0,0,7788,7788,0,0,0,0,0
2852,p1210,20111202,7788,7788,0,0,0,7788,7788,0,0,0,0,0
2853,p1210,20111205,7788,7788,0,0,0,7788,7788,0,0,0,0,0
2854,p1210,20111206,7788,7788,0,0,0,7788,7788,0,0,0,0,0
2855,p1210,20111207,7788,7788,0,0,0,7788,7788,0,0,0,0,0
2856,p1210,20111208,7788,7788,0,0,0,7788,7788,0,0,0,0,0
2857,p1210,20111209,7788,7788,0,0,0,7788,7788,0,0,0,0,0
2858,p1210,20111212,7788,7788,0,0,0,7788,7788,0,0,0,0,0
2859,p1210,20111213,7788,7788,0,0,0,7788,7788,0,0,0,0,0
2860,p1210,20111214,7788,7788,0,0,0,7788,7788,0,0,0,0,0
2861,p1210,20111215,7788,7788,7622,7814,7622,7780,7742,-8,-46,30,2323080,0
2862,p1210,20111216,7780,7742,0,0,0,7742,7742,0,0,0,0,0
2863,p1210,20111219,7742,7742,0,0,0,7742,7742,0,0,0,0,0
2864,p1210,20111220,7742,7742,0,0,0,7742,7742,0,0,0,0,0
2865,p1210,20111221,7742,7742,0,0,0,7742,7742,0,0,0,0,0
2866,p1210,20111222,7742,7742,0,0,0,7742,7742,0,0,0,0,0
2867,p1210,20111223,7742,7742,0,0,0,7742,7742,0,0,0,0,0
2868,p1210,20111226,7742,7742,7870,8116,7870,8036,8006,294,264,6,480440,0
2869,p1210,20111227,8036,8006,0,0,0,8006,8006,0,0,0,0,0
2870,p1210,20111228,8006,8006,0,0,0,8006,8006,0,0,0,0,0
2871,p1210,20111229,8006,8006,0,0,0,8006,8006,0,0,0,0,0
2872,p1210,20111230,8006,8006,0,0,0,8006,8006,0,0,0,0,0
2873,p1211,20111116,8186,8186,0,0,0,8186,8186,0,0,0,0,0
2874,p1211,20111117,8186,8186,0,0,0,8186,8186,0,0,0,0,0
2875,p1211,20111118,8186,8186,0,0,0,8186,8186,0,0,0,0,0
2876,p1211,20111121,8186,8186,0,0,0,8186,8186,0,0,0,0,0
2877,p1211,20111122,8186,8186,0,0,0,8186,8186,0,0,0,0,0
2878,p1211,20111123,8186,8186,0,0,0,8186,8186,0,0,0,0,0
2879,p1211,20111124,8186,8186,8064,8064,7886,7886,8034,-300,-152,12,964120,12
2880,p1211,20111125,7886,8034,7872,7872,7822,7822,7860,-212,-174,12,943360,6
2881,p1211,20111128,7822,7860,7892,7892,7892,7892,7892,32,32,2,157840,4
2882,p1211,20111129,7892,7892,0,0,0,7892,7892,0,0,0,0,4
2883,p1211,20111130,7892,7892,0,0,0,7892,7892,0,0,0,0,4
2884,p1211,20111201,7892,7892,7962,8138,7962,7980,8010,88,118,8,640840,0
2885,p1211,20111202,7980,8010,0,0,0,8010,8010,0,0,0,0,0
2886,p1211,20111205,8010,8010,0,0,0,8010,8010,0,0,0,0,0
2887,p1211,20111206,8010,8010,0,0,0,8010,8010,0,0,0,0,0
2888,p1211,20111207,8010,8010,0,0,0,8010,8010,0,0,0,0,0
2889,p1211,20111208,8010,8010,0,0,0,8010,8010,0,0,0,0,0
2890,p1211,20111209,8010,8010,0,0,0,8010,8010,0,0,0,0,0
2891,p1211,20111212,8010,8010,0,0,0,8010,8010,0,0,0,0,0
2892,p1211,20111213,8010,8010,0,0,0,8010,8010,0,0,0,0,0
2893,p1211,20111214,8010,8010,7642,7852,7642,7852,7782,-158,-228,6,466920,0
2894,p1211,20111215,7852,7782,0,0,0,7782,7782,0,0,0,0,0
2895,p1211,20111216,7782,7782,0,0,0,7782,7782,0,0,0,0,0
2896,p1211,20111219,7782,7782,0,0,0,7782,7782,0,0,0,0,0
2897,p1211,20111220,7782,7782,0,0,0,7782,7782,0,0,0,0,0
2898,p1211,20111221,7782,7782,0,0,0,7782,7782,0,0,0,0,0
2899,p1211,20111222,7782,7782,0,0,0,7782,7782,0,0,0,0,0
2900,p1211,20111223,7782,7782,0,0,0,7782,7782,0,0,0,0,0
2901,p1211,20111226,7782,7782,0,0,0,7782,7782,0,0,0,0,0
2902,p1211,20111227,7782,7782,0,0,0,7782,7782,0,0,0,0,0
2903,p1211,20111228,7782,7782,0,0,0,7782,7782,0,0,0,0,0
2904,p1211,20111229,7782,7782,0,0,0,7782,7782,0,0,0,0,0
2905,p1211,20111230,7782,7782,0,0,0,7782,7782,0,0,0,0,0
2906,p1212,20111216,7874,7874,0,0,0,7874,7874,0,0,0,0,0
2907,p1212,20111219,7874,7874,0,0,0,7874,7874,0,0,0,0,0
2908,p1212,20111220,7874,7874,0,0,0,7874,7874,0,0,0,0,0
2909,p1212,20111221,7874,7874,0,0,0,7874,7874,0,0,0,0,0
2910,p1212,20111222,7874,7874,0,0,0,7874,7874,0,0,0,0,0
2911,p1212,20111223,7874,7874,0,0,0,7874,7874,0,0,0,0,0
2912,p1212,20111226,7874,7874,0,0,0,7874,7874,0,0,0,0,0
2913,p1212,20111227,7874,7874,0,0,0,7874,7874,0,0,0,0,0
2914,p1212,20111228,7874,7874,0,0,0,7874,7874,0,0,0,0,0
2915,p1212,20111229,7874,7874,0,0,0,7874,7874,0,0,0,0,0
2916,p1212,20111230,7874,7874,0,0,0,7874,7874,0,0,0,0,0