   ,合约,日期,前收盘价,前结算价,开盘价,最高价,最低价,收盘价,结算价,涨跌1,涨跌2,成交量,成交金额,持仓量
1,p1001,20100104,6318,6662,6264,6830,6264,6830,6712,168,50,50,335.63,4680
2,p1001,20100105,6830,6712,6830,6830,6830,6830,6830,118,118,40,273.2,4640
3,p1001,20100106,6830,6830,6850,6870,6850,6870,6864,40,34,300,2059.4,4340
4,p1001,20100107,6870,6864,0,0,0,6864,6864,0,0,0,0,4340
5,p1001,20100108,6864,6864,6870,6870,6870,6870,6870,6,6,40,274.8,4300
6,p1001,20100111,6870,6870,6870,6870,6870,6870,6870,0,0,200,1374,4100
7,p1001,20100112,6870,6870,6828,6830,6828,6830,6828,-40,-42,424,2895.9,3686
8,p1001,20100113,6830,6828,0,0,0,6828,6828,0,0,0,0,3686
9,p1001,20100114,6828,6828,6750,6750,6750,6750,6750,-78,-78,36,243,3650
10,p1001,20100115,6750,6750,0,0,0,6750,6840,0,90,0,0,0
11,p1002,20100104,6810,6760,6810,6950,6676,6918,6852,158,92,16,109.63,326
12,p1002,20100105,6918,6852,6930,6930,6930,6930,6930,78,78,200,1386,126
13,p1002,20100106,6930,6930,0,0,0,6930,6930,0,0,0,0,126
14,p1002,20100107,6930,6930,6594,6850,6594,6700,6722,-230,-208,34,228.58,114
15,p1002,20100108,6700,6722,6702,6702,6680,6680,6696,-42,-26,8,53.57,114
16,p1002,20100111,6680,6696,6656,6656,6656,6656,6656,-40,-40,2,13.31,112
17,p1002,20100112,6656,6656,6630,6630,6592,6630,6624,-26,-32,40,264.97,82
18,p1002,20100113,6630,6624,6500,6500,6480,6480,6490,-144,-134,8,51.92,74
19,p1002,20100114,6480,6490,6560,6560,6542,6542,6550,52,60,4,26.2,72
20,p1002,20100115,6542,6550,6500,6500,6500,6500,6500,-50,-50,4,26,68
21,p1002,20100118,6500,6500,6500,6500,6500,6500,6500,0,0,4,26,64
22,p1002,20100119,6500,6500,6450,6648,6450,6450,6498,-50,-2,8,52,58
23,p1002,20100120,6450,6498,6450,6600,6350,6532,6520,34,22,36,234.76,44
24,p1002,20100121,6532,6520,0,0,0,6520,6520,0,0,0,0,44
25,p1002,20100122,6520,6520,6400,6400,6400,6400,6400,-120,-120,8,51.2,36
26,p1002,20100125,6400,6400,6700,6700,6302,6302,6500,-98,100,4,26,34
27,p1002,20100126,6302,6500,6400,6500,6400,6500,6408,0,-92,26,166.61,12
28,p1002,20100127,6500,6408,0,0,0,6408,6408,0,0,0,0,12
29,p1002,20100128,6408,6408,6674,6674,6234,6400,6364,-8,-44,18,114.57,6
30,p1002,20100129,6400,6364,6350,6350,6300,6350,6332,-14,-32,6,38,0
31,p1002,20100201,6350,6332,0,0,0,6332,6332,0,0,0,0,0
32,p1002,20100202,6332,6332,0,0,0,6332,6332,0,0,0,0,0
33,p1002,20100203,6332,6332,0,0,0,6332,6332,0,0,0,0,0
34,p1002,20100204,6332,6332,0,0,0,6332,6332,0,0,0,0,0
35,p1002,20100205,6332,6332,0,0,0,6332,6332,0,0,0,0,0
36,p1002,20100208,6332,6332,0,0,0,6332,6332,0,0,0,0,0
37,p1002,20100209,6332,6332,0,0,0,6332,6332,0,0,0,0,0
38,p1002,20100210,6332,6332,0,0,0,6332,6332,0,0,0,0,0
39,p1002,20100211,6332,6332,0,0,0,6332,6332,0,0,0,0,0
40,p1002,20100212,6332,6332,0,0,0,6332,6332,0,0,0,0,0
41,p1003,20100104,6844,6842,7016,7022,6860,6980,6962,138,120,18,125.33,164
42,p1003,20100105,6980,6962,6880,7094,6880,6990,6988,28,26,50,349.49,170
43,p1003,20100106,6990,6988,7020,7020,7020,7020,7020,32,32,34,238.68,136
44,p1003,20100107,7020,7020,6964,6964,6754,6754,6898,-266,-122,22,151.76,148
45,p1003,20100108,6754,6898,6800,6800,6800,6800,6800,-98,-98,6,40.8,142
46,p1003,20100111,6800,6800,6858,6898,6756,6756,6848,-44,48,14,95.9,130
47,p1003,20100112,6756,6848,6680,6798,6656,6798,6752,-50,-96,22,148.56,134
48,p1003,20100113,6798,6752,6560,6658,6482,6658,6552,-94,-200,14,91.74,126
49,p1003,20100114,6658,6552,6788,6788,6562,6670,6674,118,122,96,640.85,122
50,p1003,20100115,6670,6674,6562,6700,6562,6620,6654,-54,-20,48,319.48,120
51,p1003,20100118,6620,6654,0,0,0,6654,6654,0,0,0,0,120
52,p1003,20100119,6654,6654,6750,6770,6638,6728,6726,74,72,44,295.99,132
53,p1003,20100120,6728,6726,6650,6708,6582,6582,6638,-144,-88,12,79.67,128
54,p1003,20100121,6582,6638,0,0,0,6638,6638,0,0,0,0,128
55,p1003,20100122,6638,6638,6560,6608,6560,6608,6574,-30,-64,18,118.35,118
56,p1003,20100125,6608,6574,6714,6714,6714,6714,6714,140,140,2,13.43,120
57,p1003,20100126,6714,6714,6580,6580,6580,6580,6580,-134,-134,10,65.8,114
58,p1003,20100127,6580,6580,6496,6556,6496,6556,6542,-24,-38,14,91.6,102
59,p1003,20100128,6556,6542,6442,6442,6442,6442,6442,-100,-100,2,12.88,100
60,p1003,20100129,6442,6442,0,0,0,6442,6442,0,0,0,0,100
61,p1003,20100201,6442,6442,0,0,0,6442,6442,0,0,0,0,100
62,p1003,20100202,6442,6442,6600,6600,6400,6400,6456,-42,14,8,51.65,100
63,p1003,20100203,6400,6456,0,0,0,6456,6456,0,0,0,0,100
64,p1003,20100204,6456,6456,6400,6400,6400,6400,6400,-56,-56,26,166.4,76
65,p1003,20100205,6400,6400,6254,6538,6254,6538,6396,138,-4,4,25.58,76
66,p1003,20100208,6538,6396,6400,6400,6340,6340,6354,-56,-42,16,101.68,60
67,p1003,20100209,6340,6354,6222,6222,6222,6222,6222,-132,-132,4,24.89,56
68,p1003,20100210,6222,6222,0,0,0,6222,6222,0,0,0,0,56
69,p1003,20100211,6222,6222,0,0,0,6222,6222,0,0,0,0,56
70,p1003,20100212,6222,6222,0,0,0,6222,6222,0,0,0,0,56
71,p1003,20100222,6222,6222,6600,6600,6600,6600,6600,378,378,12,79.2,44
72,p1003,20100223,6600,6600,6400,6400,6400,6400,6400,-200,-200,2,12.8,46
73,p1003,20100224,6400,6400,0,0,0,6400,6400,0,0,0,0,46
74,p1003,20100225,6400,6400,6120,6670,6120,6670,6370,270,-30,44,280.3,50
75,p1003,20100226,6670,6370,6370,6688,6350,6688,6542,318,172,34,222.46,26
76,p1003,20100301,6688,6542,0,0,0,6542,6542,0,0,0,0,26
77,p1003,20100302,6542,6542,0,0,0,6542,6542,0,0,0,0,26
78,p1003,20100303,6542,6542,0,0,0,6542,6542,0,0,0,0,26
79,p1003,20100304,6542,6542,6930,6930,6930,6930,6930,388,388,2,13.86,28
80,p1003,20100305,6930,6930,6880,6880,6880,6880,6880,-50,-50,2,13.76,28
81,p1003,20100308,6880,6880,6950,6950,6950,6950,6950,70,70,2,13.9,26
82,p1003,20100309,6950,6950,0,0,0,6950,6950,0,0,0,0,26
83,p1003,20100310,6950,6950,0,0,0,6950,6950,0,0,0,0,26
84,p1003,20100311,6950,6950,0,0,0,6950,6950,0,0,0,0,26
85,p1003,20100312,6950,6950,0,0,0,6950,6920,0,-30,0,0,0
86,p1004,20100104,7050,7034,7210,7210,6922,7118,7110,84,76,24,170.67,52
87,p1004,20100105,7118,7110,7158,7158,7106,7106,7140,-4,30,6,42.84,50
88,p1004,20100106,7106,7140,7200,7200,7200,7200,7200,60,60,2,14.4,50
89,p1004,20100107,7200,7200,7220,7238,7018,7018,7166,-182,-34,14,100.35,56
90,p1004,20100108,7018,7166,6850,6880,6808,6880,6846,-286,-320,6,41.08,58
91,p1004,20100111,6880,6846,7002,7070,6924,7022,7012,176,166,18,126.22,64
92,p1004,20100112,7022,7012,6954,6954,6830,6854,6906,-158,-106,14,96.7,58
93,p1004,20100113,6854,6906,6730,6744,6730,6730,6736,-176,-170,8,53.89,58
94,p1004,20100114,6730,6736,0,0,0,6736,6736,0,0,0,0,58
95,p1004,20100115,6736,6736,0,0,0,6736,6736,0,0,0,0,58
96,p1004,20100118,6736,6736,6760,6796,6640,6682,6698,-54,-38,204,1366.44,226
97,p1004,20100119,6682,6698,6680,6848,6680,6680,6702,-18,4,20,134.06,210
98,p1004,20100120,6680,6702,6632,6632,6632,6632,6632,-70,-70,6,39.79,210
99,p1004,20100121,6632,6632,6600,6670,6580,6670,6642,38,10,12,79.72,202
100,p1004,20100122,6670,6642,0,0,0,6642,6642,0,0,0,0,202
101,p1004,20100125,6642,6642,0,0,0,6642,6642,0,0,0,0,202
102,p1004,20100126,6642,6642,0,0,0,6642,6642,0,0,0,0,202
103,p1004,20100127,6642,6642,6652,6652,6532,6532,6592,-110,-50,4,26.37,202
104,p1004,20100128,6532,6592,0,0,0,6592,6592,0,0,0,0,202
105,p1004,20100129,6592,6592,0,0,0,6592,6592,0,0,0,0,202
106,p1004,20100201,6592,6592,0,0,0,6592,6592,0,0,0,0,202
107,p1004,20100202,6592,6592,6518,6518,6514,6514,6516,-78,-76,4,26.06,202
108,p1004,20100203,6514,6516,0,0,0,6516,6516,0,0,0,0,202
109,p1004,20100204,6516,6516,6516,6516,6416,6416,6464,-100,-52,8,51.72,198
110,p1004,20100205,6416,6464,6500,6500,6500,6500,6500,36,36,2,13,198
111,p1004,20100208,6500,6500,6550,6550,6504,6506,6516,6,16,10,65.17,190
112,p1004,20100209,6506,6516,0,0,0,6516,6516,0,0,0,0,190
113,p1004,20100210,6516,6516,6400,6400,6400,6400,6400,-116,-116,6,38.4,184
114,p1004,20100211,6400,6400,0,0,0,6400,6400,0,0,0,0,184
115,p1004,20100212,6400,6400,6550,6550,6160,6160,6250,-240,-150,156,975,28
116,p1004,20100222,6160,6250,0,0,0,6250,6250,0,0,0,0,28
117,p1004,20100223,6250,6250,6562,6562,6562,6562,6562,312,312,4,26.25,32
118,p1004,20100224,6562,6562,6690,6690,6690,6690,6690,128,128,2,13.38,30
119,p1004,20100225,6690,6690,6698,6698,6698,6698,6698,8,8,4,26.79,26
120,p1004,20100226,6698,6698,0,0,0,6698,6698,0,0,0,0,26
121,p1004,20100301,6698,6698,0,0,0,6698,6698,0,0,0,0,26
122,p1004,20100302,6698,6698,0,0,0,6698,6698,0,0,0,0,26
123,p1004,20100303,6698,6698,0,0,0,6698,6698,0,0,0,0,26
124,p1004,20100304,6698,6698,0,0,0,6698,6698,0,0,0,0,26
125,p1004,20100305,6698,6698,0,0,0,6698,6698,0,0,0,0,26
126,p1004,20100308,6698,6698,0,0,0,6698,6698,0,0,0,0,26
127,p1004,20100309,6698,6698,0,0,0,6698,6698,0,0,0,0,26
128,p1004,20100310,6698,6698,0,0,0,6698,6698,0,0,0,0,26
129,p1004,20100311,6698,6698,0,0,0,6698,6698,0,0,0,0,26
130,p1004,20100312,6698,6698,6698,6698,6698,6698,6698,0,0,4,26.79,26
131,p1004,20100315,6698,6698,0,0,0,6698,6698,0,0,0,0,26
132,p1004,20100316,6698,6698,0,0,0,6698,6698,0,0,0,0,26
133,p1004,20100317,6698,6698,6600,6600,6600,6600,6600,-98,-98,2,13.2,24
134,p1004,20100318,6600,6600,0,0,0,6600,6600,0,0,0,0,24
135,p1004,20100319,6600,6600,6600,6600,6600,6600,6600,0,0,10,66,14
136,p1004,20100322,6600,6600,6836,6836,6630,6630,6732,30,132,4,26.93,14
137,p1004,20100323,6630,6732,0,0,0,6732,6732,0,0,0,0,14
138,p1004,20100324,6732,6732,6630,6630,6630,6630,6630,-102,-102,4,26.52,10
139,p1004,20100325,6630,6630,0,0,0,6630,6630,0,0,0,0,10
140,p1004,20100326,6630,6630,6958,6958,6640,6640,6798,10,168,4,27.2,10
141,p1004,20100329,6640,6798,0,0,0,6798,6798,0,0,0,0,10
142,p1004,20100330,6798,6798,0,0,0,6798,6798,0,0,0,0,10
143,p1004,20100331,6798,6798,6650,6904,6650,6900,6850,102,52,10,68.52,8
144,p1004,20100401,6900,6850,6800,6800,6450,6450,6600,-400,-250,8,52.8,4
145,p1004,20100402,6450,6600,0,0,0,6600,6600,0,0,0,0,4
146,p1004,20100406,6600,6600,6400,6400,6400,6400,6400,-200,-200,4,25.6,4
147,p1004,20100407,6400,6400,0,0,0,6400,6400,0,0,0,0,4
148,p1004,20100408,6400,6400,0,0,0,6400,6400,0,0,0,0,4
149,p1004,20100409,6400,6400,0,0,0,6400,6400,0,0,0,0,4
150,p1004,20100412,6400,6400,0,0,0,6400,6400,0,0,0,0,4
151,p1004,20100413,6400,6400,0,0,0,6400,6400,0,0,0,0,4
152,p1004,20100414,6400,6400,0,0,0,6400,6400,0,0,0,0,4
153,p1004,20100415,6400,6400,0,0,0,6400,6532,0,132,0,0,0
154,p1005,20100104,7092,7036,7106,7172,7076,7116,7122,80,86,7994,56941.16,22472
155,p1005,20100105,7116,7122,7132,7194,7104,7168,7156,46,34,4696,33612.67,22160
156,p1005,20100106,7168,7156,7180,7272,7128,7196,7240,40,84,15756,114073.6,20660
157,p1005,20100107,7196,7240,7238,7274,6878,6966,7060,-274,-180,14768,104289.2,18586
158,p1005,20100108,6966,7060,6998,6998,6810,6910,6904,-150,-156,8412,58083.49,17332
159,p1005,20100111,6910,6904,6994,7060,6976,6996,7014,92,110,6380,44758.24,16618
160,p1005,20100112,6996,7014,6950,6956,6890,6910,6918,-104,-96,2850,19720.45,15998
161,p1005,20100113,6910,6918,6794,6794,6620,6674,6728,-244,-190,10698,71976.22,14612
162,p1005,20100114,6674,6728,6768,6782,6732,6772,6760,44,32,6406,43315.28,11676
163,p1005,20100115,6772,6760,6746,6820,6672,6726,6748,-34,-12,4298,29008.71,11600
164,p1005,20100118,6726,6748,6700,6732,6620,6700,6690,-48,-58,2466,16499.01,11274
165,p1005,20100119,6700,6690,6740,6876,6706,6740,6758,50,68,3148,21280.32,11524
166,p1005,20100120,6740,6758,6720,6780,6590,6604,6672,-154,-86,3306,22058.29,11048
167,p1005,20100121,6604,6672,6590,6690,6568,6686,6622,14,-50,4472,29617.06,10142
168,p1005,20100122,6686,6622,6612,6686,6542,6676,6628,54,6,2830,18758.44,9952
169,p1005,20100125,6676,6628,6688,6712,6644,6676,6686,48,58,2430,16247.37,9864
170,p1005,20100126,6676,6686,6600,6720,6572,6572,6636,-114,-50,1532,10166.47,9562
171,p1005,20100127,6572,6636,6580,6636,6562,6618,6608,-18,-28,1482,9793.09,9482
172,p1005,20100128,6618,6608,6532,6570,6500,6540,6538,-68,-70,1594,10423.54,9468
173,p1005,20100129,6540,6538,6558,6606,6500,6502,6558,-36,20,1054,6912.37,9306
174,p1005,20100201,6502,6558,6550,6550,6410,6410,6442,-148,-116,1812,11675.23,9166
175,p1005,20100202,6410,6442,6540,6540,6396,6414,6436,-28,-6,678,4364.64,9116
176,p1005,20100203,6414,6436,6530,6586,6504,6580,6540,144,104,2954,19324.51,8478
177,p1005,20100204,6580,6540,6536,6538,6468,6516,6508,-24,-32,738,4803.93,8242
178,p1005,20100205,6516,6508,6500,6586,6450,6550,6528,42,20,1236,8069.24,8160
179,p1005,20100208,6550,6528,6600,6760,6580,6630,6624,102,96,2644,17518.51,7816
180,p1005,20100209,6630,6624,6658,6662,6598,6648,6634,24,10,706,4683.74,7588
181,p1005,20100210,6648,6634,6648,6700,6632,6660,6666,26,32,892,5946.84,7264
182,p1005,20100211,6660,6666,6720,6764,6688,6710,6740,44,74,840,5662.49,6900
183,p1005,20100212,6710,6740,6688,6714,6660,6694,6680,-46,-60,382,2551.82,6838
184,p1005,20100222,6694,6680,6800,6902,6740,6830,6808,150,128,530,3609.08,6790
185,p1005,20100223,6830,6808,6830,6884,6820,6884,6840,76,32,1004,6868.07,6962
186,p1005,20100224,6884,6840,6820,6856,6820,6842,6844,2,4,466,3189.49,7024
187,p1005,20100225,6842,6844,6868,6884,6776,6796,6804,-48,-40,816,5552.24,7100
188,p1005,20100226,6796,6804,6798,6826,6750,6750,6782,-54,-22,674,4571.72,6902
189,p1005,20100301,6750,6782,6872,6872,6800,6800,6816,18,34,238,1622.31,6934
190,p1005,20100302,6800,6816,6764,6922,6764,6770,6836,-46,20,1038,7096.22,6952
191,p1005,20100303,6770,6836,6820,6840,6788,6816,6814,-20,-22,1228,8369.06,6774
192,p1005,20100304,6816,6814,6820,6822,6760,6770,6782,-44,-32,520,3526.87,6722
193,p1005,20100305,6770,6782,6758,6896,6758,6868,6822,86,40,730,4980.54,6748
194,p1005,20100308,6868,6822,6870,6898,6844,6892,6874,70,52,1304,8965.32,5876
195,p1005,20100309,6892,6874,6892,6972,6874,6960,6916,86,42,744,5145.63,5536
196,p1005,20100310,6960,6916,6964,6964,6910,6934,6944,18,28,238,1653.13,5468
197,p1005,20100311,6934,6944,7050,7054,6812,6894,6874,-50,-70,1524,10478.88,5958
198,p1005,20100312,6894,6874,6860,6880,6850,6852,6862,-22,-12,226,1551.24,6076
199,p1005,20100315,6852,6862,6924,6976,6840,6864,6860,2,-2,702,4817.06,6020
200,p1005,20100316,6864,6860,6840,6866,6824,6842,6844,-18,-16,260,1779.48,6036
201,p1005,20100317,6842,6844,6842,6914,6842,6900,6888,56,44,474,3265.05,5698
202,p1005,20100318,6900,6888,6880,6880,6842,6842,6870,-46,-18,506,3477.2,5462
203,p1005,20100319,6842,6870,6850,6886,6850,6878,6874,8,4,236,1622.73,5244
204,p1005,20100322,6878,6874,6900,6944,6900,6900,6916,26,42,204,1410.89,5190
205,p1005,20100323,6900,6916,6950,6950,6890,6912,6916,-4,0,386,2669.94,5044
206,p1005,20100324,6912,6916,6916,6928,6872,6900,6904,-16,-12,62,428.14,4996
207,p1005,20100325,6900,6904,6884,6928,6884,6924,6908,20,4,82,566.47,4950
208,p1005,20100326,6924,6908,6868,6880,6848,6880,6874,-28,-34,66,453.74,4904
209,p1005,20100329,6880,6874,6864,6920,6864,6900,6898,26,24,60,413.97,4862
210,p1005,20100330,6900,6898,6920,6950,6818,6928,6884,30,-14,166,1143.02,4812
211,p1005,20100331,6928,6884,6912,6912,6862,6882,6892,-2,8,608,4190.54,4352
212,p1005,20100401,6882,6892,6880,6880,6808,6830,6822,-62,-70,966,6591.76,3720
213,p1005,20100402,6830,6822,6850,6864,6840,6864,6856,42,34,1556,10668.17,2846
214,p1005,20100406,6864,6856,6868,6884,6850,6860,6858,4,2,376,2578.64,3090
215,p1005,20100407,6860,6858,6948,6948,6864,6900,6908,42,50,998,6894.61,3358
216,p1005,20100408,6900,6908,6888,6940,6888,6900,6924,-8,16,670,4639.67,3386
217,p1005,20100409,6900,6924,6900,6938,6900,6912,6926,-12,2,736,5098.95,2684
218,p1005,20100412,6912,6926,6920,6982,6918,6926,6962,0,36,2832,19719.91,3298
219,p1005,20100413,6926,6962,6938,6938,6884,6932,6910,-30,-52,98,677.2,3256
220,p1005,20100414,6932,6910,6920,6920,6910,6910,6914,0,4,18,124.45,3246
221,p1005,20100415,6910,6914,6888,6890,6864,6864,6884,-50,-30,114,784.81,3150
222,p1005,20100416,6864,6884,6884,6888,6852,6858,6884,-26,0,90,619.58,3148
223,p1005,20100419,6858,6884,6900,6900,6756,6766,6812,-118,-72,90,613.24,3130
224,p1005,20100420,6766,6812,6772,6796,6744,6772,6774,-40,-38,18,121.94,3128
225,p1005,20100421,6772,6774,6766,6800,6752,6772,6784,-2,10,76,515.61,3126
226,p1005,20100422,6772,6784,6770,6790,6726,6736,6786,-48,2,108,733.04,3228
227,p1005,20100423,6736,6786,6830,6880,6770,6852,6848,66,62,232,1589.17,3226
228,p1005,20100426,6852,6848,6852,6902,6834,6900,6882,52,34,834,5740.4,3222
229,p1005,20100427,6900,6882,6876,6896,6854,6868,6886,-14,4,68,468.29,3172
230,p1005,20100428,6868,6886,6832,6888,6802,6824,6820,-62,-66,42,286.48,3174
231,p1005,20100429,6824,6820,6830,6886,6802,6832,6840,12,20,140,957.62,3044
232,p1005,20100430,6832,6840,6890,6890,6826,6850,6840,10,0,1128,7716.76,2910
233,p1005,20100504,6850,6840,0,0,0,6840,6840,0,0,0,0,2910
234,p1005,20100505,6840,6840,6870,6870,6870,6870,6870,30,30,2,13.74,2910
235,p1005,20100506,6870,6870,6858,6860,6842,6842,6858,-28,-12,212,1454.26,2910
236,p1005,20100507,6842,6858,0,0,0,6858,6858,0,0,0,0,2910
237,p1005,20100510,6858,6858,6790,6790,6780,6780,6780,-78,-78,802,5437.58,2910
238,p1005,20100511,6780,6780,0,0,0,6780,6780,0,0,0,0,2910
239,p1005,20100512,6780,6780,6790,6790,6790,6790,6790,10,10,10,67.9,2910
240,p1005,20100513,6790,6790,6650,6650,6650,6650,6650,-140,-140,400,2660,2910
241,p1005,20100514,6650,6650,6680,6720,6680,6720,6682,70,32,568,3795.68,2378
242,p1005,20100517,6720,6682,6450,6450,6450,6450,6730,-232,48,30,193.5,0
243,p1006,20100104,7178,7142,7302,7302,7302,7302,7302,160,160,4,29.21,186
244,p1006,20100105,7302,7302,7314,7366,7072,7304,7274,2,-28,242,1760.72,300
245,p1006,20100106,7304,7274,7340,7342,7340,7342,7340,68,66,34,249.62,280
246,p1006,20100107,7342,7340,7220,7220,7010,7138,7056,-202,-284,162,1143.14,294
247,p1006,20100108,7138,7056,6968,7046,6954,7046,6988,-10,-68,18,125.79,288
248,p1006,20100111,7046,6988,7174,7174,7066,7124,7124,136,136,26,185.24,288
249,p1006,20100112,7124,7124,7002,7002,7002,7002,7002,-122,-122,2,14,290
250,p1006,20100113,7002,7002,6750,6888,6652,6850,6792,-152,-210,50,339.68,294
251,p1006,20100114,6850,6792,6888,6888,6888,6888,6888,96,96,248,1708.22,542
252,p1006,20100115,6888,6888,6924,6938,6836,6836,6872,-52,-16,20,137.44,546
253,p1006,20100118,6836,6872,6760,6766,6680,6766,6740,-106,-132,482,3249.22,238
254,p1006,20100119,6766,6740,6812,6822,6750,6750,6802,10,62,12,81.64,230
255,p1006,20100120,6750,6802,6680,6750,6680,6680,6708,-122,-94,94,630.69,318
256,p1006,20100121,6680,6708,0,0,0,6708,6708,0,0,0,0,318
257,p1006,20100122,6708,6708,6652,6652,6650,6650,6650,-58,-58,22,146.3,298
258,p1006,20100125,6650,6650,0,0,0,6650,6650,0,0,0,0,298
259,p1006,20100126,6650,6650,6680,6744,6614,6662,6686,12,36,20,133.72,294
260,p1006,20100127,6662,6686,6720,6758,6720,6750,6746,64,60,12,80.97,298
261,p1006,20100128,6750,6746,6582,6656,6582,6656,6618,-90,-128,10,66.19,298
262,p1006,20100129,6656,6618,6696,6738,6618,6618,6676,0,58,34,227,304
263,p1006,20100201,6618,6676,6680,6680,6532,6532,6592,-144,-84,12,79.11,304
264,p1006,20100202,6532,6592,6530,6530,6452,6478,6478,-114,-114,20,129.58,304
265,p1006,20100203,6478,6478,6648,6650,6602,6630,6634,152,156,48,318.46,294
266,p1006,20100204,6630,6634,6610,6628,6506,6612,6578,-22,-56,190,1250.05,352
267,p1006,20100205,6612,6578,6600,6672,6590,6672,6606,94,28,130,858.99,244
268,p1006,20100208,6672,6606,6742,6756,6676,6700,6708,94,102,54,362.24,232
269,p1006,20100209,6700,6708,6742,6742,6692,6732,6724,24,16,8,53.8,232
270,p1006,20100210,6732,6724,6736,6736,6682,6682,6708,-42,-16,4,26.84,232
271,p1006,20100211,6682,6708,6824,6824,6824,6824,6824,116,116,4,27.3,232
272,p1006,20100212,6824,6824,0,0,0,6824,6824,0,0,0,0,232
273,p1006,20100222,6824,6824,6920,6998,6836,6998,6928,174,104,26,180.15,240
274,p1006,20100223,6998,6928,6980,6980,6936,6936,6964,8,36,6,41.79,242
275,p1006,20100224,6936,6964,7000,7000,6886,6966,6940,2,-24,18,124.92,244
276,p1006,20100225,6966,6940,6980,6980,6802,6886,6854,-54,-86,246,1686.16,284
277,p1006,20100226,6886,6854,6898,6900,6800,6800,6864,-54,10,14,96.12,284
278,p1006,20100301,6800,6864,6928,6928,6874,6874,6900,10,36,4,27.6,284
279,p1006,20100302,6874,6900,6888,6906,6870,6870,6890,-30,-10,28,192.96,290
280,p1006,20100303,6870,6890,6950,6964,6812,6964,6900,74,10,342,2359.85,366
281,p1006,20100304,6964,6900,0,0,0,6900,6900,0,0,0,0,366
282,p1006,20100305,6900,6900,6900,6978,6900,6978,6930,78,30,26,180.2,360
283,p1006,20100308,6978,6930,6994,7004,6950,6952,6984,22,54,24,167.62,362
284,p1006,20100309,6952,6984,7070,7070,6994,7060,7018,76,34,18,126.34,366
285,p1006,20100310,7060,7018,7012,7064,6970,7040,7026,22,8,108,758.9,382
286,p1006,20100311,7040,7026,7102,7104,6904,6978,7026,-48,0,10,70.26,380
287,p1006,20100312,6978,7026,6980,6980,6910,6972,6950,-54,-76,36,250.22,386
288,p1006,20100315,6972,6950,6920,6920,6890,6890,6912,-60,-38,8,55.3,388
289,p1006,20100316,6890,6912,6928,6942,6820,6942,6894,30,-18,50,344.79,400
290,p1006,20100317,6942,6894,6988,6994,6880,6940,6938,46,44,48,333.11,390
291,p1006,20100318,6940,6938,6898,6932,6898,6928,6922,-10,-16,8,55.38,392
292,p1006,20100319,6928,6922,6870,6934,6856,6934,6902,12,-20,52,358.91,388
293,p1006,20100322,6934,6902,6950,6952,6928,6928,6940,26,38,32,222.14,372
294,p1006,20100323,6928,6940,6946,6946,6912,6946,6926,6,-14,12,83.12,372
295,p1006,20100324,6946,6926,6870,6890,6868,6890,6886,-36,-40,90,619.88,300
296,p1006,20100325,6890,6886,0,0,0,6886,6886,0,0,0,0,300
297,p1006,20100326,6886,6886,6872,6872,6860,6860,6870,-26,-16,82,563.4,286
298,p1006,20100329,6860,6870,6830,6896,6830,6896,6878,26,8,20,137.56,290
299,p1006,20100330,6896,6878,6870,6940,6792,6894,6882,16,4,136,936.02,304
300,p1006,20100331,6894,6882,6930,6930,6844,6844,6872,-38,-10,18,123.72,300
301,p1006,20100401,6844,6872,6802,6806,6802,6806,6802,-66,-70,6,40.82,300
302,p1006,20100402,6806,6802,0,0,0,6802,6802,0,0,0,0,300
303,p1006,20100406,6802,6802,6812,6812,6812,6812,6812,10,10,2,13.62,298
304,p1006,20100407,6812,6812,0,0,0,6812,6812,0,0,0,0,298
305,p1006,20100408,6812,6812,6948,6980,6948,6980,6956,168,144,8,55.65,300
306,p1006,20100409,6980,6956,6900,6928,6852,6928,6882,-28,-74,10,68.83,296
307,p1006,20100412,6928,6882,6894,6894,6894,6894,6894,12,12,2,13.79,294
308,p1006,20100413,6894,6894,6866,6866,6852,6852,6858,-42,-36,4,27.44,290
309,p1006,20100414,6852,6858,6880,6880,6880,6880,6880,22,22,24,165.12,290
310,p1006,20100415,6880,6880,0,0,0,6880,6880,0,0,0,0,290
311,p1006,20100416,6880,6880,0,0,0,6880,6880,0,0,0,0,290
312,p1006,20100419,6880,6880,0,0,0,6880,6880,0,0,0,0,290
313,p1006,20100420,6880,6880,0,0,0,6880,6880,0,0,0,0,290
314,p1006,20100421,6880,6880,0,0,0,6880,6880,0,0,0,0,290
315,p1006,20100422,6880,6880,0,0,0,6880,6880,0,0,0,0,290
316,p1006,20100423,6880,6880,6850,6850,6850,6850,6850,-30,-30,2,13.7,288
317,p1006,20100426,6850,6850,0,0,0,6850,6850,0,0,0,0,288
318,p1006,20100427,6850,6850,6820,6928,6820,6880,6888,30,38,34,234.19,282
319,p1006,20100428,6880,6888,6864,6864,6830,6830,6840,-58,-48,16,109.46,268
320,p1006,20100429,6830,6840,0,0,0,6840,6840,0,0,0,0,268
321,p1006,20100430,6840,6840,6800,6810,6800,6810,6804,-30,-36,14,95.28,254
322,p1006,20100504,6810,6804,6820,6830,6820,6830,6824,26,20,4,27.3,254
323,p1006,20100505,6830,6824,6610,6728,6610,6728,6688,-96,-136,26,173.89,246
324,p1006,20100506,6728,6688,6866,6866,6722,6730,6794,42,106,12,81.55,246
325,p1006,20100507,6730,6794,0,0,0,6794,6794,0,0,0,0,246
326,p1006,20100510,6794,6794,6650,6700,6650,6700,6666,-94,-128,24,160.02,242
327,p1006,20100511,6700,6666,6726,6730,6682,6700,6692,34,26,28,187.41,222
328,p1006,20100512,6700,6692,6736,6736,6736,6736,6736,44,44,2,13.47,222
329,p1006,20100513,6736,6736,6730,6730,6476,6700,6634,-36,-102,6,39.81,222
330,p1006,20100514,6700,6634,6600,6600,6600,6600,6600,-34,-34,2,13.2,222
331,p1006,20100517,6600,6600,6400,6400,6400,6400,6400,-200,-200,10,64,222
332,p1006,20100518,6400,6400,6400,6400,6400,6400,6400,0,0,4,25.6,220
333,p1006,20100519,6400,6400,6544,6544,6544,6544,6544,144,144,88,575.87,132
334,p1006,20100520,6544,6544,0,0,0,6544,6544,0,0,0,0,132
335,p1006,20100521,6544,6544,6550,6666,6550,6666,6630,122,86,20,132.61,132
336,p1006,20100524,6666,6630,6400,6560,6302,6550,6422,-80,-208,94,603.72,104
337,p1006,20100525,6550,6422,6372,6372,6372,6372,6372,-50,-50,6,38.23,98
338,p1006,20100526,6372,6372,0,0,0,6372,6372,0,0,0,0,98
339,p1006,20100527,6372,6372,6372,6372,6372,6372,6372,0,0,2,12.74,96
340,p1006,20100528,6372,6372,6420,6420,6372,6372,6384,0,12,14,89.4,82
341,p1006,20100531,6372,6384,6372,6470,6370,6470,6400,86,16,64,409.65,76
342,p1006,20100601,6470,6400,0,0,0,6400,6400,0,0,0,0,76
343,p1006,20100602,6400,6400,0,0,0,6400,6400,0,0,0,0,76
344,p1006,20100603,6400,6400,0,0,0,6400,6400,0,0,0,0,76
345,p1006,20100604,6400,6400,0,0,0,6400,6400,0,0,0,0,76
346,p1006,20100607,6400,6400,6210,6210,6210,6210,6210,-190,-190,56,347.76,76
347,p1006,20100608,6210,6210,0,0,0,6210,6210,0,0,0,0,76
348,p1006,20100609,6210,6210,0,0,0,6210,6210,0,0,0,0,76
349,p1006,20100610,6210,6210,0,0,0,6210,6210,0,0,0,0,76
350,p1006,20100611,6210,6210,0,0,0,6210,6210,0,0,0,0,76
351,p1006,20100617,6210,6210,0,0,0,6210,6210,0,0,0,0,0
352,p1007,20100104,7180,7144,7204,7328,7204,7280,7254,136,110,10,72.55,20
353,p1007,20100105,7280,7254,0,0,0,7254,7270,0,16,4,29.08,20
354,p1007,20100106,7254,7270,0,0,0,7270,7270,0,0,0,0,20
355,p1007,20100107,7270,7270,7488,7488,7052,7116,7244,-154,-26,14,101.44,22
356,p1007,20100108,7116,7244,0,0,0,7244,7244,0,0,0,0,22
357,p1007,20100111,7244,7244,7230,7232,7230,7232,7230,-12,-14,10,72.31,26
358,p1007,20100112,7232,7230,7000,7156,6994,6994,7050,-236,-180,6,42.3,26
359,p1007,20100113,6994,7050,6714,6860,6714,6820,6838,-230,-212,28,191.47,44
360,p1007,20100114,6820,6838,0,0,0,6838,6838,0,0,0,0,44
361,p1007,20100115,6838,6838,0,0,0,6838,6838,0,0,0,0,44
362,p1007,20100118,6838,6838,6618,6788,6618,6788,6672,-50,-166,44,293.57,30
363,p1007,20100119,6788,6672,0,0,0,6672,6672,0,0,0,0,30
364,p1007,20100120,6672,6672,0,0,0,6672,6672,0,0,0,0,30
365,p1007,20100121,6672,6672,6626,6714,6626,6714,6670,42,-2,36,240.12,30
366,p1007,20100122,6714,6670,6680,6794,6680,6790,6764,120,94,8,54.12,22
367,p1007,20100125,6790,6764,0,0,0,6764,6764,0,0,0,0,22
368,p1007,20100126,6764,6764,0,0,0,6764,6764,0,0,0,0,22
369,p1007,20100127,6764,6764,0,0,0,6764,6764,0,0,0,0,22
370,p1007,20100128,6764,6764,6978,6978,6532,6754,6712,-10,-52,8,53.71,22
371,p1007,20100129,6754,6712,6706,6706,6604,6604,6652,-108,-60,58,385.83,26
372,p1007,20100201,6604,6652,6602,6602,6512,6566,6554,-86,-98,472,3094.2,388
373,p1007,20100202,6566,6554,6502,6502,6502,6502,6502,-52,-52,206,1339.74,590
374,p1007,20100203,6502,6502,6622,6622,6622,6622,6622,120,120,2,13.24,590
375,p1007,20100204,6622,6622,6560,6684,6560,6684,6668,62,46,16,106.7,588
376,p1007,20100205,6684,6668,0,0,0,6668,6668,0,0,0,0,588
377,p1007,20100208,6668,6668,0,0,0,6668,6668,0,0,0,0,588
378,p1007,20100209,6668,6668,6702,6742,6680,6742,6706,74,38,66,442.66,588
379,p1007,20100210,6742,6706,0,0,0,6706,6706,0,0,0,0,588
380,p1007,20100211,6706,6706,6880,6880,6870,6870,6874,164,168,8,55,584
381,p1007,20100212,6870,6874,6750,6830,6748,6830,6796,-44,-78,30,203.93,580
382,p1007,20100222,6830,6796,6978,6978,6978,6978,6978,182,182,2,13.96,580
383,p1007,20100223,6978,6978,0,0,0,6978,6978,0,0,0,0,580
384,p1007,20100224,6978,6978,0,0,0,6978,6978,0,0,0,0,580
385,p1007,20100225,6978,6978,6872,6920,6872,6920,6884,-58,-94,14,96.4,582
386,p1007,20100226,6920,6884,0,0,0,6884,6884,0,0,0,0,582
387,p1007,20100301,6884,6884,6910,6910,6910,6910,6910,26,26,2,13.82,582
388,p1007,20100302,6910,6910,6930,6930,6930,6930,6930,20,20,2,13.86,582
389,p1007,20100303,6930,6930,0,0,0,6930,6930,0,0,0,0,582
390,p1007,20100304,6930,6930,0,0,0,6930,6930,0,0,0,0,582
391,p1007,20100305,6930,6930,6818,7104,6818,7104,6942,174,12,6,41.66,582
392,p1007,20100308,7104,6942,0,0,0,6942,6942,0,0,0,0,582
393,p1007,20100309,6942,6942,7184,7184,7126,7130,7146,188,204,6,42.88,584
394,p1007,20100310,7130,7146,0,0,0,7146,7146,0,0,0,0,584
395,p1007,20100311,7146,7146,7040,7078,6980,7078,7038,-68,-108,16,112.61,592
396,p1007,20100312,7078,7038,7018,7018,7000,7000,7008,-38,-30,4,28.04,588
397,p1007,20100315,7000,7008,7028,7028,6862,6862,6944,-146,-64,4,27.78,588
398,p1007,20100316,6862,6944,6920,6920,6900,6900,6910,-44,-34,4,27.64,588
399,p1007,20100317,6900,6910,6956,6956,6956,6956,6956,46,46,2,13.91,588
400,p1007,20100318,6956,6956,0,0,0,6956,6956,0,0,0,0,588
401,p1007,20100319,6956,6956,0,0,0,6956,6956,0,0,0,0,588
402,p1007,20100322,6956,6956,6956,7054,6930,7054,6996,98,40,12,83.96,590
403,p1007,20100323,7054,6996,0,0,0,6996,6996,0,0,0,0,590
404,p1007,20100324,6996,6996,6952,6952,6952,6952,6952,-44,-44,2,13.9,590
405,p1007,20100325,6952,6952,0,0,0,6952,6952,0,0,0,0,590
406,p1007,20100326,6952,6952,6904,6904,6902,6904,6902,-48,-50,12,82.84,580
407,p1007,20100329,6904,6902,0,0,0,6902,6902,0,0,0,0,580
408,p1007,20100330,6902,6902,0,0,0,6902,6902,0,0,0,0,580
409,p1007,20100331,6902,6902,0,0,0,6902,6902,0,0,0,0,580
410,p1007,20100401,6902,6902,0,0,0,6902,6902,0,0,0,0,580
411,p1007,20100402,6902,6902,6780,7008,6780,6878,6930,-24,28,10,69.32,582
412,p1007,20100406,6878,6930,0,0,0,6930,6930,0,0,0,0,582
413,p1007,20100407,6930,6930,0,0,0,6930,6930,0,0,0,0,582
414,p1007,20100408,6930,6930,7006,7028,7002,7006,7010,76,80,8,56.08,582
415,p1007,20100409,7006,7010,6998,6998,6998,6998,6998,-12,-12,2,14,582
416,p1007,20100412,6998,6998,0,0,0,6998,6998,0,0,0,0,582
417,p1007,20100413,6998,6998,0,0,0,6998,6998,0,0,0,0,582
418,p1007,20100414,6998,6998,6920,6930,6920,6920,6922,-78,-76,10,69.22,576
419,p1007,20100415,6920,6922,7078,7078,6914,6914,6996,-8,74,4,27.98,576
420,p1007,20100416,6914,6996,0,0,0,6996,6996,0,0,0,0,576
421,p1007,20100419,6996,6996,0,0,0,6996,6996,0,0,0,0,576
422,p1007,20100420,6996,6996,0,0,0,6996,6996,0,0,0,0,576
423,p1007,20100421,6996,6996,0,0,0,6996,6996,0,0,0,0,576
424,p1007,20100422,6996,6996,0,0,0,6996,6996,0,0,0,0,576
425,p1007,20100423,6996,6996,0,0,0,6996,6996,0,0,0,0,576
426,p1007,20100426,6996,6996,0,0,0,6996,6996,0,0,0,0,576
427,p1007,20100427,6996,6996,0,0,0,6996,6996,0,0,0,0,576
428,p1007,20100428,6996,6996,0,0,0,6996,6996,0,0,0,0,576
429,p1007,20100429,6996,6996,0,0,0,6996,6996,0,0,0,0,576
430,p1007,20100430,6996,6996,6770,6938,6770,6938,6854,-58,-142,4,27.42,576
431,p1007,20100504,6938,6854,6760,6924,6760,6924,6882,70,28,8,55.06,582
432,p1007,20100505,6924,6882,0,0,0,6882,6882,0,0,0,0,582
433,p1007,20100506,6882,6882,0,0,0,6882,6882,0,0,0,0,582
434,p1007,20100507,6882,6882,0,0,0,6882,6882,0,0,0,0,582
435,p1007,20100510,6882,6882,0,0,0,6882,6882,0,0,0,0,582
436,p1007,20100511,6882,6882,0,0,0,6882,6882,0,0,0,0,582
437,p1007,20100512,6882,6882,0,0,0,6882,6882,0,0,0,0,582
438,p1007,20100513,6882,6882,6652,6718,6652,6718,6678,-164,-204,10,66.78,582
439,p1007,20100514,6718,6678,6746,6746,6746,6746,6746,68,68,2,13.49,580
440,p1007,20100517,6746,6746,0,0,0,6746,6746,0,0,0,0,580
441,p1007,20100518,6746,6746,0,0,0,6746,6746,0,0,0,0,580
442,p1007,20100519,6746,6746,0,0,0,6746,6746,0,0,0,0,580
443,p1007,20100520,6746,6746,0,0,0,6746,6746,0,0,0,0,580
444,p1007,20100521,6746,6746,6642,6642,6610,6610,6626,-136,-120,8,53.01,574
445,p1007,20100524,6610,6626,0,0,0,6626,6626,0,0,0,0,574
446,p1007,20100525,6626,6626,0,0,0,6626,6626,0,0,0,0,574
447,p1007,20100526,6626,6626,0,0,0,6626,6626,0,0,0,0,574
448,p1007,20100527,6626,6626,6626,6626,6626,6626,6626,0,0,2,13.25,572
449,p1007,20100528,6626,6626,0,0,0,6626,6626,0,0,0,0,572
450,p1007,20100531,6626,6626,6760,6760,6402,6402,6580,-224,-46,4,26.32,574
451,p1007,20100601,6402,6580,6538,6538,6538,6538,6538,-42,-42,564,3687.43,10
452,p1007,20100602,6538,6538,0,0,0,6538,6538,0,0,0,0,10
453,p1007,20100603,6538,6538,0,0,0,6538,6538,0,0,0,0,10
454,p1007,20100604,6538,6538,0,0,0,6538,6538,0,0,0,0,10
455,p1007,20100607,6538,6538,0,0,0,6538,6538,0,0,0,0,10
456,p1007,20100608,6538,6538,6478,6478,6478,6478,6478,-60,-60,2,12.96,10
457,p1007,20100609,6478,6478,0,0,0,6478,6508,0,30,8,52.07,10
458,p1007,20100610,6478,6508,0,0,0,6508,6508,0,0,0,0,10
459,p1007,20100611,6508,6508,0,0,0,6508,6508,0,0,0,0,10
460,p1007,20100617,6508,6508,0,0,0,6508,6368,0,-140,8,50.95,10
461,p1007,20100618,6508,6368,0,0,0,6368,6368,0,0,0,0,10
462,p1007,20100621,6368,6368,6434,6434,6434,6434,6386,66,18,18,114.95,8
463,p1007,20100622,6434,6386,0,0,0,6386,6386,0,0,0,0,8
464,p1007,20100623,6386,6386,0,0,0,6386,6386,0,0,0,0,8
465,p1007,20100624,6386,6386,0,0,0,6386,6386,0,0,0,0,8
466,p1007,20100625,6386,6386,0,0,0,6386,6386,0,0,0,0,8
467,p1007,20100628,6386,6386,0,0,0,6386,6386,0,0,0,0,8
468,p1007,20100629,6386,6386,6200,6200,6200,6200,6200,-186,-186,4,24.8,6
469,p1007,20100630,6200,6200,6250,6250,6250,6250,6250,50,50,6,37.5,0
470,p1007,20100701,6250,6250,0,0,0,6250,6250,0,0,0,0,0
471,p1007,20100702,6250,6250,0,0,0,6250,6250,0,0,0,0,0
472,p1007,20100705,6250,6250,0,0,0,6250,6250,0,0,0,0,0
473,p1007,20100706,6250,6250,0,0,0,6250,6250,0,0,0,0,0
474,p1007,20100707,6250,6250,0,0,0,6250,6250,0,0,0,0,0
475,p1007,20100708,6250,6250,0,0,0,6250,6250,0,0,0,0,0
476,p1007,20100709,6250,6250,0,0,0,6250,6250,0,0,0,0,0
477,p1007,20100712,6250,6250,0,0,0,6250,6250,0,0,0,0,0
478,p1007,20100713,6250,6250,0,0,0,6250,6250,0,0,0,0,0
479,p1007,20100714,6250,6250,0,0,0,6250,6250,0,0,0,0,0
480,p1008,20100104,7328,7314,7332,7420,7332,7420,7386,106,72,12,88.63,222
481,p1008,20100105,7420,7386,7430,7472,7380,7434,7418,48,32,42,311.59,218
482,p1008,20100106,7434,7418,7488,7542,7470,7470,7498,52,80,20,149.98,222
483,p1008,20100107,7470,7498,7490,7556,7124,7238,7232,-260,-266,636,4600.82,264
484,p1008,20100108,7238,7232,7202,7222,7060,7060,7088,-172,-144,106,751.44,270
485,p1008,20100111,7060,7088,7184,7288,7184,7264,7274,176,186,92,669.22,250
486,p1008,20100112,7264,7274,7174,7200,7120,7200,7164,-74,-110,24,171.98,262
487,p1008,20100113,7200,7164,6960,6960,6908,6908,6942,-256,-222,6,41.66,262
488,p1008,20100114,6908,6942,6954,7028,6954,7018,6998,76,56,10,70,262
489,p1008,20100115,7018,6998,7058,7058,6842,6850,6956,-148,-42,410,2852.12,514
490,p1008,20100118,6850,6956,6776,6796,6624,6780,6746,-176,-210,436,2941.55,276
491,p1008,20100119,6780,6746,6806,6806,6796,6796,6802,50,56,26,176.9,276
492,p1008,20100120,6796,6802,6796,6796,6730,6730,6760,-72,-42,198,1338.6,144
493,p1008,20100121,6730,6760,6658,6840,6658,6840,6820,80,60,20,136.44,160
494,p1008,20100122,6840,6820,6826,6842,6660,6842,6722,22,-98,88,591.6,170
495,p1008,20100125,6842,6722,6872,6872,6666,6780,6784,58,62,26,176.42,164
496,p1008,20100126,6780,6784,6784,6812,6750,6750,6792,-34,8,14,95.11,162
497,p1008,20100127,6750,6792,6732,6750,6716,6716,6734,-76,-58,38,255.89,156
498,p1008,20100128,6716,6734,6592,6748,6592,6732,6706,-2,-28,124,831.58,144
499,p1008,20100129,6732,6706,6734,6788,6690,6706,6758,0,52,232,1568.31,130
500,p1008,20100201,6706,6758,6638,6666,6620,6630,6638,-128,-120,8,53.11,128
501,p1008,20100202,6630,6638,6642,6678,6562,6622,6626,-16,-12,12,79.53,130
502,p1008,20100203,6622,6626,6752,6752,6656,6730,6710,104,84,48,322.17,148
503,p1008,20100204,6730,6710,6690,6726,6664,6726,6700,16,-10,8,53.61,150
504,p1008,20100205,6726,6700,6708,6710,6706,6710,6706,10,6,32,214.62,118
505,p1008,20100208,6710,6706,6766,6790,6762,6790,6774,84,68,18,121.94,110
506,p1008,20100209,6790,6774,6836,6836,6836,6836,6836,62,62,6,41.02,114
507,p1008,20100210,6836,6836,6828,6828,6800,6800,6808,-36,-28,6,40.86,110
508,p1008,20100211,6800,6808,6848,6870,6848,6870,6858,62,50,4,27.44,108
509,p1008,20100212,6870,6858,6842,6842,6842,6842,6842,-16,-16,2,13.68,106
510,p1008,20100222,6842,6842,7000,7036,6974,7006,7004,164,162,8,56.03,106
511,p1008,20100223,7006,7004,7018,7034,7018,7034,7028,30,24,16,112.46,106
512,p1008,20100224,7034,7028,7020,7052,7000,7052,7024,24,-4,10,70.24,106
513,p1008,20100225,7052,7024,6996,6996,6910,6984,6944,-40,-80,86,597.22,104
514,p1008,20100226,6984,6944,6996,6996,6936,6936,6960,-8,16,10,69.61,104
515,p1008,20100301,6936,6960,7018,7032,6992,6992,7014,32,54,6,42.08,106
516,p1008,20100302,6992,7014,7000,7000,6988,6988,6994,-26,-20,4,27.98,106
517,p1008,20100303,6988,6994,6996,7066,6996,7066,7030,72,36,84,590.6,136
518,p1008,20100304,7066,7030,6994,6994,6970,6970,6982,-60,-48,4,27.93,136
519,p1008,20100305,6970,6982,7038,7124,6998,7124,7026,142,44,28,196.76,138
520,p1008,20100308,7124,7026,7062,7062,7062,7062,7062,36,36,2,14.12,136
521,p1008,20100309,7062,7062,7238,7238,7086,7198,7178,136,116,14,100.51,138
522,p1008,20100310,7198,7178,7180,7180,7180,7180,7180,2,2,2,14.36,138
523,p1008,20100311,7180,7180,7050,7100,6972,7100,7048,-80,-132,152,1071.33,232
524,p1008,20100312,7100,7048,7096,7096,6982,7040,7036,-8,-12,40,281.46,256
525,p1008,20100315,7040,7036,6968,6972,6872,6872,6910,-164,-126,10,69.11,256
526,p1008,20100316,6872,6910,6978,6978,6904,6914,6932,4,22,12,83.18,260
527,p1008,20100317,6914,6932,7032,7032,7020,7020,7024,88,92,12,84.29,258
528,p1008,20100318,7020,7024,6958,6958,6956,6956,6956,-68,-68,206,1432.95,464
529,p1008,20100319,6956,6956,6982,7004,6980,6980,6988,24,32,66,461.32,450
530,p1008,20100322,6980,6988,6980,7040,6980,7040,7004,52,16,10,70.04,450
531,p1008,20100323,7040,7004,7020,7032,7020,7024,7022,20,18,14,98.31,450
532,p1008,20100324,7024,7022,6990,6992,6990,6992,6990,-30,-32,4,27.96,448
533,p1008,20100325,6992,6990,0,0,0,6990,6990,0,0,0,0,448
534,p1008,20100326,6990,6990,6930,6994,6930,6936,6936,-54,-54,134,929.62,382
535,p1008,20100329,6936,6936,7040,7040,7040,7040,7040,104,104,8,56.32,390
536,p1008,20100330,7040,7040,6956,7098,6936,7044,6968,4,-72,36,250.85,418
537,p1008,20100331,7044,6968,7032,7032,7032,7032,7032,64,64,4,28.13,422
538,p1008,20100401,7032,7032,6922,6990,6806,6950,6926,-82,-106,26,180.09,412
539,p1008,20100402,6950,6926,7006,7006,6990,7004,7000,78,74,8,56.01,414
540,p1008,20100406,7004,7000,7032,7044,6944,6970,6980,-30,-20,74,516.54,376
541,p1008,20100407,6970,6980,7328,7328,6836,7074,7054,94,74,20,141.08,384
542,p1008,20100408,7074,7054,7074,7074,7068,7068,7068,14,14,10,70.7,378
543,p1008,20100409,7068,7068,7060,7060,6978,7030,7032,-38,-36,252,1772.48,470
544,p1008,20100412,7030,7032,6912,7078,6912,7042,7018,10,-14,8,56.15,470
545,p1008,20100413,7042,7018,6972,6972,6972,6972,6972,-46,-46,4,27.89,474
546,p1008,20100414,6972,6972,6980,6980,6980,6980,6980,8,8,10,69.8,466
547,p1008,20100415,6980,6980,6976,6976,6970,6970,6972,-10,-8,10,69.72,458
548,p1008,20100416,6970,6972,0,0,0,6972,6972,0,0,0,0,458
549,p1008,20100419,6972,6972,0,0,0,6972,6972,0,0,0,0,458
550,p1008,20100420,6972,6972,0,0,0,6972,6972,0,0,0,0,458
551,p1008,20100421,6972,6972,6924,6930,6852,6930,6902,-42,-70,38,262.29,460
552,p1008,20100422,6930,6902,0,0,0,6902,6902,0,0,0,0,460
553,p1008,20100423,6902,6902,0,0,0,6902,6902,0,0,0,0,460
554,p1008,20100426,6902,6902,0,0,0,6902,6902,0,0,0,0,460
555,p1008,20100427,6902,6902,7198,7198,7198,7198,7198,296,296,2,14.4,460
556,p1008,20100428,7198,7198,6842,7030,6842,6962,6946,-236,-252,70,486.28,438
557,p1008,20100429,6962,6946,6918,6968,6914,6950,6930,4,-16,22,152.47,430
558,p1008,20100430,6950,6930,6930,6960,6930,6960,6948,30,18,48,333.54,404
559,p1008,20100504,6960,6948,6958,6964,6958,6964,6962,16,14,6,41.77,404
560,p1008,20100505,6964,6962,6856,6940,6856,6940,6888,-22,-74,152,1047.16,336
561,p1008,20100506,6940,6888,0,0,0,6888,6888,0,0,0,0,336
562,p1008,20100507,6888,6888,6806,6840,6756,6822,6820,-66,-68,100,682.18,328
563,p1008,20100510,6822,6820,6838,6960,6838,6876,6886,56,66,20,137.73,328
564,p1008,20100511,6876,6886,0,0,0,6886,6886,0,0,0,0,328
565,p1008,20100512,6886,6886,0,0,0,6886,6886,0,0,0,0,328
566,p1008,20100513,6886,6886,6810,6810,6810,6810,6810,-76,-76,6,40.86,328
567,p1008,20100514,6810,6810,6788,6788,6788,6788,6788,-22,-22,2,13.58,328
568,p1008,20100517,6788,6788,6776,6776,6630,6630,6656,-158,-132,60,399.46,292
569,p1008,20100518,6630,6656,6716,6728,6716,6728,6724,72,68,10,67.26,284
570,p1008,20100519,6728,6724,0,0,0,6724,6724,0,0,0,0,284
571,p1008,20100520,6724,6724,6724,6724,6724,6724,6724,0,0,8,53.79,276
572,p1008,20100521,6724,6724,6720,6730,6720,6730,6722,6,-2,26,174.8,258
573,p1008,20100524,6730,6722,6818,6818,6750,6750,6780,28,58,50,339.08,260
574,p1008,20100525,6750,6780,6680,6680,6680,6680,6680,-100,-100,2,13.36,260
575,p1008,20100526,6680,6680,0,0,0,6680,6680,0,0,0,0,260
576,p1008,20100527,6680,6680,0,0,0,6680,6680,0,0,0,0,260
577,p1008,20100528,6680,6680,0,0,0,6680,6680,0,0,0,0,260
578,p1008,20100531,6680,6680,0,0,0,6680,6680,0,0,0,0,260
579,p1008,20100601,6680,6680,0,0,0,6680,6680,0,0,0,0,260
580,p1008,20100602,6680,6680,6650,6690,6650,6660,6666,-20,-14,6,40,260
581,p1008,20100603,6660,6666,6828,6828,6728,6728,6778,62,112,4,27.11,264
582,p1008,20100604,6728,6778,6736,6736,6712,6712,6724,-66,-54,4,26.9,262
583,p1008,20100607,6712,6724,6452,6490,6452,6490,6470,-234,-254,4,25.88,260
584,p1008,20100608,6490,6470,0,0,0,6470,6470,0,0,0,0,260
585,p1008,20100609,6470,6470,6452,6452,6452,6452,6452,-18,-18,4,25.81,260
586,p1008,20100610,6452,6452,0,0,0,6452,6452,0,0,0,0,260
587,p1008,20100611,6452,6452,6452,6452,6452,6452,6452,0,0,12,77.42,248
588,p1008,20100617,6452,6452,0,0,0,6452,6452,0,0,0,0,248
589,p1008,20100618,6452,6452,0,0,0,6452,6452,0,0,0,0,248
590,p1008,20100621,6452,6452,6612,6612,6612,6612,6612,160,160,2,13.22,246
591,p1008,20100622,6612,6612,0,0,0,6612,6612,0,0,0,0,246
592,p1008,20100623,6612,6612,6586,6586,6580,6580,6582,-32,-30,4,26.33,246
593,p1008,20100624,6580,6582,0,0,0,6582,6582,0,0,0,0,246
594,p1008,20100625,6582,6582,0,0,0,6582,6582,0,0,0,0,246
595,p1008,20100628,6582,6582,0,0,0,6582,6582,0,0,0,0,246
596,p1008,20100629,6582,6582,6432,6432,6432,6432,6432,-150,-150,2,12.86,246
597,p1008,20100630,6432,6432,6308,6308,6308,6308,6308,-124,-124,2,12.62,246
598,p1008,20100701,6308,6308,6352,6354,6352,6354,6352,46,44,206,1308.92,40
599,p1008,20100702,6354,6352,0,0,0,6352,6352,0,0,0,0,40
600,p1008,20100705,6352,6352,0,0,0,6352,6352,0,0,0,0,40
601,p1008,20100706,6352,6352,6224,6224,6212,6212,6222,-140,-130,24,149.35,28
602,p1008,20100707,6212,6222,0,0,0,6222,6222,0,0,0,0,28
603,p1008,20100708,6222,6222,0,0,0,6222,6222,0,0,0,0,28
604,p1008,20100709,6222,6222,0,0,0,6222,6222,0,0,0,0,28
605,p1008,20100712,6222,6222,6426,6426,6426,6426,6426,204,204,2,12.85,26
606,p1008,20100713,6426,6426,0,0,0,6426,6426,0,0,0,0,26
607,p1008,20100714,6426,6426,6446,6446,6262,6262,6354,-164,-72,4,25.42,24
608,p1008,20100715,6262,6354,6478,6478,6478,6478,6478,124,124,4,25.91,26
609,p1008,20100716,6478,6478,6180,6528,6180,6528,6354,50,-124,4,25.42,26
610,p1008,20100719,6528,6354,0,0,0,6354,6354,0,0,0,0,26
611,p1008,20100720,6354,6354,6402,6402,6402,6402,6402,48,48,6,38.41,20
612,p1008,20100721,6402,6402,0,0,0,6402,6402,0,0,0,0,20
613,p1008,20100722,6402,6402,6402,6402,6402,6402,6402,0,0,10,64.02,10
614,p1008,20100723,6402,6402,6402,6402,6402,6402,6402,0,0,6,38.41,6
615,p1008,20100726,6402,6402,6660,6660,6660,6660,6660,258,258,2,13.32,4
616,p1008,20100727,6660,6660,0,0,0,6660,6660,0,0,0,0,4
617,p1008,20100728,6660,6660,0,0,0,6660,6660,0,0,0,0,4
618,p1008,20100729,6660,6660,6678,6678,6678,6678,6678,18,18,4,26.71,0
619,p1008,20100730,6678,6678,0,0,0,6678,6678,0,0,0,0,0
620,p1008,20100802,6678,6678,0,0,0,6678,6678,0,0,0,0,0
621,p1008,20100803,6678,6678,0,0,0,6678,6678,0,0,0,0,0
622,p1008,20100804,6678,6678,0,0,0,6678,6678,0,0,0,0,0
623,p1008,20100805,6678,6678,0,0,0,6678,6678,0,0,0,0,0
624,p1008,20100806,6678,6678,0,0,0,6678,6678,0,0,0,0,0
625,p1008,20100809,6678,6678,0,0,0,6678,6678,0,0,0,0,0
626,p1008,20100810,6678,6678,0,0,0,6678,6678,0,0,0,0,0
627,p1008,20100811,6678,6678,0,0,0,6678,6678,0,0,0,0,0
628,p1008,20100812,6678,6678,0,0,0,6678,6678,0,0,0,0,0
629,p1008,20100813,6678,6678,0,0,0,6678,6678,0,0,0,0,0
630,p1009,20100104,7276,7186,7300,7368,7244,7302,7310,116,124,641592,4690064.15,302644
631,p1009,20100105,7302,7310,7320,7388,7288,7344,7348,34,38,726722,5340036.95,329262
632,p1009,20100106,7344,7348,7314,7466,7304,7376,7400,28,52,758566,5614162.48,345622
633,p1009,20100107,7376,7400,7420,7464,7030,7134,7222,-266,-178,971910,7019454.24,284252
634,p1009,20100108,7134,7222,7130,7150,6914,7036,7046,-186,-176,857686,6043303.89,264762
635,p1009,20100111,7036,7046,7124,7204,7120,7124,7156,78,110,697064,4989020.33,279150
636,p1009,20100112,7124,7156,7022,7100,7008,7034,7046,-122,-110,495840,3494675.41,286586
637,p1009,20100113,7034,7046,6800,6880,6736,6794,6820,-252,-226,544822,3716721.8,263236
638,p1009,20100114,6794,6820,6880,6918,6844,6888,6882,68,62,472570,3252956.44,248218
639,p1009,20100115,6888,6882,6860,6944,6786,6842,6868,-40,-14,586250,4027007.06,255726
640,p1009,20100118,6842,6868,6790,6862,6750,6820,6808,-48,-60,581646,3960531.42,308022
641,p1009,20100119,6820,6808,6850,6892,6810,6846,6848,38,40,434246,2974133.9,297188
642,p1009,20100120,6846,6848,6888,6894,6698,6702,6782,-146,-66,622982,4225990.38,292092
643,p1009,20100121,6702,6782,6688,6830,6662,6818,6732,36,-50,694602,4677403.2,280430
644,p1009,20100122,6818,6732,6752,6826,6658,6808,6752,76,20,786590,5311808.34,278932
645,p1009,20100125,6808,6752,6790,6868,6774,6818,6830,66,78,800640,5469718.1,313968
646,p1009,20100126,6818,6830,6826,6846,6706,6706,6774,-124,-56,765770,5187451.46,306826
647,p1009,20100127,6706,6774,6750,6774,6690,6750,6740,-24,-34,665180,4483800.13,289686
648,p1009,20100128,6750,6740,6682,6720,6618,6704,6684,-36,-56,631430,4221326.36,276574
649,p1009,20100129,6704,6684,6700,6772,6640,6646,6714,-38,30,720468,4838312.81,304518
650,p1009,20100201,6646,6714,6662,6682,6554,6556,6600,-158,-114,575700,3800368.38,286032
651,p1009,20100202,6556,6600,6644,6644,6534,6558,6582,-42,-18,459570,3025727.64,282612
652,p1009,20100203,6558,6582,6686,6724,6636,6720,6674,138,92,470116,3138138.58,285022
653,p1009,20100204,6720,6674,6662,6694,6608,6648,6648,-26,-26,447720,2976469.1,289572
654,p1009,20100205,6648,6648,6582,6728,6572,6684,6662,36,14,529578,3528249.95,295658
655,p1009,20100208,6684,6662,6740,6796,6732,6784,6766,122,104,469572,3177590.76,322866
656,p1009,20100209,6784,6766,6802,6814,6748,6776,6770,10,4,351342,2379153.12,310254
657,p1009,20100210,6776,6770,6800,6826,6730,6766,6782,-4,12,437428,2967215.56,306356
658,p1009,20100211,6766,6782,6800,6856,6800,6820,6832,38,50,233452,1594987.37,296490
659,p1009,20100212,6820,6832,6820,6842,6750,6782,6800,-50,-32,165296,1124197.32,291972
660,p1009,20100222,6782,6800,6900,6972,6846,6932,6922,132,122,451592,3126057.66,319766
661,p1009,20100223,6932,6922,6938,7018,6920,7016,6972,94,50,405170,2824989.78,343624
662,p1009,20100224,7016,6972,6962,6988,6938,6956,6962,-16,-10,309294,2153836.09,333394
663,p1009,20100225,6956,6962,7000,7006,6858,6900,6924,-62,-38,391872,2713641.67,311078
664,p1009,20100226,6900,6924,6900,6924,6844,6864,6890,-60,-34,301028,2074147.17,321734
665,p1009,20100301,6864,6890,7000,7002,6904,6922,6938,32,48,344422,2390050.66,330956
666,p1009,20100302,6922,6938,6918,6976,6888,6888,6930,-50,-8,429384,2975825.05,296070
667,p1009,20100303,6888,6930,6912,6986,6912,6968,6958,38,28,377554,2627532.27,305024
668,p1009,20100304,6968,6958,6960,6970,6880,6884,6922,-74,-36,332544,2302513.32,285390
669,p1009,20100305,6884,6922,6900,7038,6860,7018,6966,96,44,621786,4332250,339764
670,p1009,20100308,7018,6966,7008,7048,6972,7030,7014,64,48,505750,3548091.92,332682
671,p1009,20100309,7030,7014,7016,7104,7010,7092,7054,78,40,802350,5660171.16,397838
672,p1009,20100310,7092,7054,7050,7086,7032,7046,7058,-8,4,521414,3680150.56,392456
673,p1009,20100311,7046,7058,7086,7098,6890,6954,6976,-104,-82,658346,4593763.39,326030
674,p1009,20100312,6954,6976,6922,6956,6888,6904,6920,-72,-56,332210,2299002.38,302502
675,p1009,20100315,6904,6920,6880,6912,6794,6854,6848,-66,-72,406324,2783102.9,284250
676,p1009,20100316,6854,6848,6820,6858,6810,6844,6834,-4,-14,295900,2022326.44,275790
677,p1009,20100317,6844,6834,6868,6924,6866,6888,6900,54,66,328958,2270145.24,257322
678,p1009,20100318,6888,6900,6904,6906,6822,6850,6856,-50,-44,310792,2130835.14,263592
679,p1009,20100319,6850,6856,6858,6896,6840,6880,6872,24,16,246002,1690709.94,255378
680,p1009,20100322,6880,6872,6866,6940,6862,6902,6910,30,38,325718,2251331.88,271096
681,p1009,20100323,6902,6910,6950,6950,6892,6896,6916,-14,6,260026,1798721.78,279040
682,p1009,20100324,6896,6916,6900,6922,6852,6888,6886,-28,-30,276752,1905833.98,259436
683,p1009,20100325,6888,6886,6870,6918,6868,6892,6892,6,6,222262,1532189.21,244646
684,p1009,20100326,6892,6892,6876,6884,6838,6860,6858,-32,-34,219374,1504696.54,241436
685,p1009,20100329,6860,6858,6862,6918,6854,6886,6886,28,28,209610,1443542.71,238774
686,p1009,20100330,6886,6886,6910,6940,6782,6894,6868,8,-18,710442,4880189.75,263684
687,p1009,20100331,6894,6868,6878,6916,6844,6850,6880,-18,12,352710,2426656.05,251396
688,p1009,20100401,6850,6880,6848,6866,6796,6848,6834,-32,-46,260424,1779888.95,249370
689,p1009,20100402,6848,6834,6880,6888,6852,6880,6868,46,34,119946,823973.26,236064
690,p1009,20100406,6880,6868,6882,6892,6854,6868,6874,0,6,165454,1137403.77,237858
691,p1009,20100407,6868,6874,6888,6994,6886,6968,6960,94,86,368764,2567179.3,232740
692,p1009,20100408,6968,6960,6960,7032,6952,6970,6994,10,34,371606,2599186.34,235302
693,p1009,20100409,6970,6994,6976,7024,6966,6998,6994,4,0,196430,1373981.54,233034
694,p1009,20100412,6998,6994,7030,7056,7000,7024,7030,30,36,214918,1511126.52,227520
695,p1009,20100413,7024,7030,7000,7002,6940,6990,6978,-40,-52,169844,1185464.4,224886
696,p1009,20100414,6990,6978,7002,7024,6982,6984,7004,6,26,158738,1111988.64,224276
697,p1009,20100415,6984,7004,7010,7010,6966,6980,6982,-24,-22,115490,806450.94,208920
698,p1009,20100416,6980,6982,6990,7008,6974,6988,6990,6,8,92242,644836.12,200254
699,p1009,20100419,6988,6990,6948,6964,6874,6888,6910,-102,-80,108318,748537.07,190578
700,p1009,20100420,6888,6910,6914,6930,6874,6902,6898,-8,-12,86630,597716.66,192746
701,p1009,20100421,6902,6898,6900,6934,6888,6924,6920,26,22,94194,651958.5,175666
702,p1009,20100422,6924,6920,6920,6926,6892,6906,6908,-14,-12,56206,388314.87,164508
703,p1009,20100423,6906,6908,6920,6976,6910,6964,6950,56,42,90340,628021.76,149666
704,p1009,20100426,6964,6950,6982,7016,6978,7000,6996,50,46,73960,517457.71,141490
705,p1009,20100427,7000,6996,6992,7046,6970,7026,7010,30,14,87486,613299.34,135838
706,p1009,20100428,7026,7010,6970,6976,6920,6954,6952,-56,-58,61844,429963.12,128442
707,p1009,20100429,6954,6952,6920,6960,6912,6920,6930,-32,-22,35190,243908.92,125988
708,p1009,20100430,6920,6930,6932,6950,6900,6948,6928,18,-2,27922,193449.65,120142
709,p1009,20100504,6948,6928,6938,6948,6912,6932,6932,4,4,16004,110962.81,118042
710,p1009,20100505,6932,6932,6882,6942,6878,6940,6918,8,-14,18246,126253.26,115332
711,p1009,20100506,6940,6918,6942,6966,6896,6896,6930,-22,12,22884,158611.89,111402
712,p1009,20100507,6896,6930,6850,6850,6772,6782,6804,-148,-126,44954,305913.82,95562
713,p1009,20100510,6782,6804,6850,6888,6832,6878,6850,74,46,21328,146109.64,87614
714,p1009,20100511,6878,6850,6884,6884,6838,6840,6858,-10,8,15270,104737.1,87022
715,p1009,20100512,6840,6858,6838,6900,6838,6882,6882,24,24,9206,63357.68,85976
716,p1009,20100513,6882,6882,6880,6896,6806,6844,6836,-38,-46,23350,159651.84,86376
717,p1009,20100514,6844,6836,6802,6842,6774,6774,6804,-62,-32,13254,90188.95,84328
718,p1009,20100517,6774,6804,6702,6736,6610,6640,6670,-164,-134,33082,220707.38,70698
719,p1009,20100518,6640,6670,6610,6720,6610,6712,6684,42,14,10492,70137.87,68404
720,p1009,20100519,6712,6684,6622,6716,6622,6676,6678,-8,-6,8028,53626.6,66304
721,p1009,20100520,6676,6678,6630,6762,6630,6714,6732,36,54,9646,64954.32,61768
722,p1009,20100521,6714,6732,6698,6772,6686,6766,6734,34,2,7094,47782.15,60602
723,p1009,20100524,6766,6734,6758,6784,6752,6760,6766,26,32,8172,55296.38,58150
724,p1009,20100525,6760,6766,6758,6758,6678,6684,6706,-82,-60,5936,39809.14,57626
725,p1009,20100526,6684,6706,6698,6718,6656,6718,6690,12,-16,11380,76147.49,55358
726,p1009,20100527,6718,6690,6728,6730,6700,6724,6710,34,20,7094,47612.45,53204
727,p1009,20100528,6724,6710,6730,6748,6702,6718,6726,8,16,2284,15365.51,52656
728,p1009,20100531,6718,6726,6682,6688,6654,6660,6676,-66,-50,6402,42741.42,51476
729,p1009,20100601,6660,6676,6674,6694,6634,6646,6658,-30,-18,5852,38968.91,49108
730,p1009,20100602,6646,6658,6658,6680,6622,6680,6660,22,2,3670,24445.8,46824
731,p1009,20100603,6680,6660,6688,6706,6650,6680,6674,20,14,6372,42536.28,42844
732,p1009,20100604,6680,6674,6704,6720,6678,6702,6700,28,26,1954,13093.58,41788
733,p1009,20100607,6702,6700,6536,6574,6506,6528,6534,-172,-166,9760,63789.54,37248
734,p1009,20100608,6528,6534,6518,6560,6518,6550,6550,16,16,10406,68170.56,34880
735,p1009,20100609,6550,6550,6544,6570,6462,6536,6528,-14,-22,15838,103419.42,31714
736,p1009,20100610,6536,6528,6536,6540,6490,6494,6508,-34,-20,3342,21756.25,31214
737,p1009,20100611,6494,6508,6512,6512,6466,6476,6494,-32,-14,2064,13404.49,30180
738,p1009,20100617,6476,6494,6528,6560,6514,6524,6534,30,40,2744,17931.8,29442
739,p1009,20100618,6524,6534,6524,6548,6524,6532,6536,-2,2,2364,15453.28,28028
740,p1009,20100621,6532,6536,6532,6600,6532,6586,6582,50,46,4848,31911.63,26928
741,p1009,20100622,6586,6582,6522,6574,6522,6560,6564,-22,-18,858,5632.66,26608
742,p1009,20100623,6560,6564,6550,6558,6518,6558,6540,-6,-24,946,6187.83,26238
743,p1009,20100624,6558,6540,6542,6572,6542,6552,6558,12,18,750,4919.04,26236
744,p1009,20100625,6552,6558,6540,6546,6514,6516,6530,-42,-28,1172,7654.06,26220
745,p1009,20100628,6516,6530,6526,6550,6508,6508,6522,-22,-8,2744,17898.66,26120
746,p1009,20100629,6508,6522,6500,6502,6416,6436,6466,-86,-56,2896,18727.71,27726
747,p1009,20100630,6436,6466,6412,6412,6362,6374,6376,-92,-90,938,5982.38,27404
748,p1009,20100701,6374,6376,6360,6388,6324,6338,6374,-38,-2,4454,28398.49,23400
749,p1009,20100702,6338,6374,6330,6360,6302,6354,6338,-20,-36,2394,15176.26,21972
750,p1009,20100705,6354,6338,6336,6346,6310,6318,6332,-20,-6,582,3686.06,21648
751,p1009,20100706,6318,6332,6292,6292,6208,6262,6250,-70,-82,1468,9176.91,21368
752,p1009,20100707,6262,6250,6262,6274,6228,6244,6242,-6,-8,1028,6418.1,21088
753,p1009,20100708,6244,6242,6296,6318,6282,6288,6302,46,60,3790,23884.89,19018
754,p1009,20100709,6288,6302,6290,6310,6268,6306,6292,4,-10,1652,10394.47,18348
755,p1009,20100712,6306,6292,6322,6332,6300,6302,6308,10,16,1114,7027.14,18264
756,p1009,20100713,6302,6308,6322,6330,6278,6286,6308,-22,0,906,5716.24,18140
757,p1009,20100714,6286,6308,6330,6344,6290,6324,6314,16,6,3104,19603.75,16930
758,p1009,20100715,6324,6314,6306,6336,6306,6308,6320,-6,6,660,4172.26,16892
759,p1009,20100716,6308,6320,6358,6416,6352,6416,6390,96,70,1566,10006.99,16780
760,p1009,20100719,6416,6390,6380,6400,6372,6398,6388,8,-2,492,3143.14,16610
761,p1009,20100720,6398,6388,6412,6424,6382,6408,6392,20,4,2004,12813.55,15718
762,p1009,20100721,6408,6392,6408,6436,6408,6430,6424,38,32,1878,12066.95,14788
763,p1009,20100722,6430,6424,6442,6502,6430,6486,6458,62,34,2124,13719.79,14404
764,p1009,20100723,6486,6458,6550,6550,6518,6544,6528,86,70,1422,9284.2,14550
765,p1009,20100726,6544,6528,6548,6592,6548,6572,6570,44,42,506,3325.1,14434
766,p1009,20100727,6572,6570,6540,6564,6520,6536,6544,-34,-26,2214,14490.68,13858
767,p1009,20100728,6536,6544,6536,6618,6512,6592,6576,48,32,680,4471.74,13638
768,p1009,20100729,6592,6576,6630,6710,6630,6704,6682,128,106,1026,6856.74,13370
769,p1009,20100730,6704,6682,6746,6774,6736,6756,6752,74,70,1124,7591.34,12834
770,p1009,20100802,6756,6752,6850,6944,6834,6932,6902,180,150,3832,26450.31,10200
771,p1009,20100803,6932,6902,6952,6954,6908,6922,6932,20,30,1796,12451.23,9068
772,p1009,20100804,6922,6932,6960,6962,6928,6930,6940,-2,8,2274,15782.76,7528
773,p1009,20100805,6930,6940,6980,6988,6904,6912,6932,-28,-8,2052,14228.46,6740
774,p1009,20100806,6912,6932,6922,7030,6922,7030,6980,98,48,1434,10011.22,6532
775,p1009,20100809,7030,6980,6952,7100,6952,7078,7048,98,68,1126,7936.72,6312
776,p1009,20100810,7078,7048,7050,7066,6996,7016,7024,-32,-24,270,1896.58,6278
777,p1009,20100811,7016,7024,7004,7040,6984,6984,7002,-40,-22,518,3627.65,6120
778,p1009,20100812,6984,7002,6980,7000,6928,6996,6966,-6,-36,216,1505.04,6054
779,p1009,20100813,6996,6966,6998,7130,6998,7128,7076,162,110,1208,8547.94,6180
780,p1009,20100816,7128,7076,7152,7240,7150,7210,7208,134,132,678,4887.24,6166
781,p1009,20100817,7210,7208,7200,7206,7128,7206,7160,-2,-48,1244,8907.41,5978
782,p1009,20100818,7206,7160,7220,7232,7166,7200,7192,40,32,1572,11306.8,5652
783,p1009,20100819,7200,7192,7200,7218,7180,7200,7200,8,8,1710,12314.13,4952
784,p1009,20100820,7200,7200,7150,7150,7120,7126,7132,-74,-68,702,5007.3,4788
785,p1009,20100823,7126,7132,7114,7150,7114,7136,7138,4,6,1164,8309.92,4264
786,p1009,20100824,7136,7138,7088,7130,7060,7072,7096,-66,-42,992,7040.48,4446
787,p1009,20100825,7072,7096,7068,7100,7024,7050,7052,-46,-44,228,1608.07,4466
788,p1009,20100826,7050,7052,7058,7090,7058,7090,7082,38,30,76,538.27,4408
789,p1009,20100827,7090,7082,7116,7126,7010,7100,7100,18,18,148,1050.83,4362
790,p1009,20100830,7100,7100,7190,7190,7128,7140,7140,40,40,570,4070.5,4012
791,p1009,20100831,7140,7140,7070,7140,7070,7140,7084,0,-56,58,410.98,3982
792,p1009,20100901,7140,7084,0,0,0,7084,7084,0,0,0,0,3982
793,p1009,20100902,7084,7084,0,0,0,7084,7084,0,0,0,0,3982
794,p1009,20100903,7084,7084,0,0,0,7084,7084,0,0,0,0,3982
795,p1009,20100906,7084,7084,0,0,0,7084,7084,0,0,0,0,3982
796,p1009,20100907,7084,7084,0,0,0,7084,7084,0,0,0,0,3982
797,p1009,20100908,7084,7084,7300,7300,7300,7300,7300,216,216,92,671.6,3982
798,p1009,20100909,7300,7300,0,0,0,7300,7300,0,0,0,0,3982
799,p1009,20100910,7300,7300,0,0,0,7300,7300,0,0,0,0,3982
800,p1009,20100913,7300,7300,0,0,0,7300,7300,0,0,0,0,3982
801,p1009,20100914,7300,7300,0,0,0,7300,7300,0,0,0,0,0
802,p1010,20100104,7334,7270,7408,7478,7312,7462,7424,192,154,116,861.37,446
803,p1010,20100105,7462,7424,7440,7490,7428,7430,7454,6,30,42,313.13,434
804,p1010,20100106,7430,7454,7430,7538,7430,7440,7482,-14,28,136,1017.71,366
805,p1010,20100107,7440,7482,7496,7526,7254,7254,7328,-228,-154,74,542.4,362
806,p1010,20100108,7254,7328,7194,7200,7174,7174,7192,-154,-136,8,57.54,362
807,p1010,20100111,7174,7192,7198,7292,7198,7240,7284,48,92,86,626.46,406
808,p1010,20100112,7240,7284,7178,7178,7090,7120,7110,-164,-174,248,1763.67,482
809,p1010,20100113,7120,7110,6900,6922,6836,6900,6858,-210,-252,34,233.22,474
810,p1010,20100114,6900,6858,6900,6982,6888,6900,6906,42,48,136,939.28,440
811,p1010,20100115,6900,6906,6922,6960,6792,6830,6894,-76,-12,94,648.12,428
812,p1010,20100118,6830,6894,6794,6816,6758,6816,6788,-78,-106,186,1262.66,408
813,p1010,20100119,6816,6788,6886,6886,6834,6834,6844,46,56,24,164.29,408
814,p1010,20100120,6834,6844,6748,6818,6704,6710,6728,-134,-116,668,4495.13,1022
815,p1010,20100121,6710,6728,6688,6796,6688,6796,6752,68,24,18,121.54,1020
816,p1010,20100122,6796,6752,6776,6794,6688,6794,6762,42,10,22,148.76,1022
817,p1010,20100125,6794,6762,6788,6854,6724,6812,6802,50,40,954,6489.84,530
818,p1010,20100126,6812,6802,6850,6850,6762,6772,6786,-30,-16,48,325.82,572
819,p1010,20100127,6772,6786,6752,6752,6742,6750,6746,-36,-40,8,53.97,566
820,p1010,20100128,6750,6746,6746,6746,6660,6670,6710,-76,-36,418,2804.96,484
821,p1010,20100129,6670,6710,6766,6766,6680,6680,6702,-30,-8,12,80.44,476
822,p1010,20100201,6680,6702,6680,6680,6512,6512,6596,-190,-106,4,26.38,478
823,p1010,20100202,6512,6596,6664,6664,6548,6550,6596,-46,0,60,395.78,484
824,p1010,20100203,6550,6596,6682,6696,6674,6696,6682,100,86,28,187.11,504
825,p1010,20100204,6696,6682,6642,6708,6642,6708,6666,26,-16,26,173.34,512
826,p1010,20100205,6708,6666,6546,6746,6546,6746,6660,80,-6,68,452.9,516
827,p1010,20100208,6746,6660,6766,6830,6766,6820,6796,160,136,132,897.3,528
828,p1010,20100209,6820,6796,6840,6840,6806,6806,6810,10,14,56,381.41,488
829,p1010,20100210,6806,6810,6832,6832,6832,6832,6832,22,22,2,13.66,486
830,p1010,20100211,6832,6832,6852,6912,6852,6912,6874,80,42,6,41.24,484
831,p1010,20100212,6912,6874,6850,6850,6822,6840,6840,-34,-34,8,54.72,480
832,p1010,20100222,6840,6840,6920,7040,6920,6970,7016,130,176,64,449.07,530
833,p1010,20100223,6970,7016,6982,7064,6666,7064,7020,48,4,142,996.92,544
834,p1010,20100224,7064,7020,6990,7020,6990,7012,7012,-8,-8,46,322.63,566
835,p1010,20100225,7012,7012,7012,7012,6910,6980,6940,-32,-72,72,499.7,542
836,p1010,20100226,6980,6940,6960,6960,6960,6960,6960,20,20,6,41.76,542
837,p1010,20100301,6960,6960,7000,7022,7000,7022,7014,62,54,6,42.09,544
838,p1010,20100302,7022,7014,0,0,0,7014,7014,0,0,0,0,544
839,p1010,20100303,7014,7014,7050,7060,7024,7024,7050,10,36,38,267.92,570
840,p1010,20100304,7024,7050,6984,7034,6944,6986,6978,-64,-72,110,767.77,620
841,p1010,20100305,6986,6978,7054,7096,7054,7088,7082,110,104,8,56.66,620
842,p1010,20100308,7088,7082,7078,7144,7078,7144,7104,62,22,80,568.41,648
843,p1010,20100309,7144,7104,7150,7194,7122,7194,7166,90,62,38,272.34,666
844,p1010,20100310,7194,7166,7152,7180,7136,7150,7152,-16,-14,34,243.18,672
845,p1010,20100311,7150,7152,7160,7194,7000,7038,7084,-114,-68,132,935.22,708
846,p1010,20100312,7038,7084,7050,7050,7008,7024,7030,-60,-54,110,773.4,804
847,p1010,20100315,7024,7030,7000,7000,6920,6920,6962,-110,-68,78,543.09,808
848,p1010,20100316,6920,6962,6912,6986,6912,6966,6946,4,-16,108,750.18,810
849,p1010,20100317,6966,6946,7024,7044,7024,7044,7028,98,82,8,56.23,812
850,p1010,20100318,7044,7028,6984,6992,6962,6964,6972,-64,-56,36,251,812
851,p1010,20100319,6964,6972,7006,7006,6998,6998,7000,26,28,8,56,810
852,p1010,20100322,6998,7000,6998,7018,6998,7018,7002,18,2,10,70.02,802
853,p1010,20100323,7018,7002,7030,7030,7030,7030,7030,28,28,2,14.06,802
854,p1010,20100324,7030,7030,7020,7020,7020,7020,7020,-10,-10,2,14.04,802
855,p1010,20100325,7020,7020,7018,7044,7018,7044,7022,24,2,14,98.32,816
856,p1010,20100326,7044,7022,6982,6982,6954,6980,6966,-42,-56,120,835.95,776
857,p1010,20100329,6980,6966,6992,6992,6992,6992,6992,26,26,6,41.95,776
858,p1010,20100330,6992,6992,7002,7054,6912,7054,6972,62,-20,28,195.24,778
859,p1010,20100331,7054,6972,7006,7006,7006,7006,7006,34,34,2,14.01,778
860,p1010,20100401,7006,7006,6948,6958,6930,6930,6944,-76,-62,6,41.67,778
861,p1010,20100402,6930,6944,6968,7010,6968,6980,6976,36,32,18,125.58,786
862,p1010,20100406,6980,6976,6986,6996,6960,6960,6966,-16,-10,176,1226.16,684
863,p1010,20100407,6960,6966,7034,7074,7034,7050,7056,84,90,38,268.18,678
864,p1010,20100408,7050,7056,7056,7138,7036,7056,7080,0,24,26,184.1,678
865,p1010,20100409,7056,7080,6992,7054,6992,7054,7008,-26,-72,390,2733.14,696
866,p1010,20100412,7054,7008,7088,7088,7022,7022,7072,14,64,18,127.3,692
867,p1010,20100413,7022,7072,6994,7012,6980,6992,6990,-80,-82,20,139.8,688
868,p1010,20100414,6992,6990,6992,7026,6992,7000,7004,10,14,126,882.61,640
869,p1010,20100415,7000,7004,6982,6982,6982,6982,6982,-22,-22,6,41.89,634
870,p1010,20100416,6982,6982,7008,7008,6986,6986,6992,4,10,6,41.96,630
871,p1010,20100419,6986,6992,6918,6918,6914,6914,6916,-78,-76,8,55.34,628
872,p1010,20100420,6914,6916,6934,6934,6862,6888,6896,-28,-20,42,289.7,626
873,p1010,20100421,6888,6896,6908,6942,6890,6894,6912,-2,16,24,165.9,614
874,p1010,20100422,6894,6912,6898,6926,6890,6892,6906,-20,-6,92,635.42,598
875,p1010,20100423,6892,6906,6926,6960,6926,6960,6946,54,40,22,152.84,584
876,p1010,20100426,6960,6946,6956,7004,6956,6994,6986,48,40,52,363.28,566
877,p1010,20100427,6994,6986,0,0,0,6986,6986,0,0,0,0,566
878,p1010,20100428,6986,6986,6946,6976,6946,6966,6960,-20,-26,22,153.15,548
879,p1010,20100429,6966,6960,6996,7020,6912,6918,6954,-42,-6,62,431.26,544
880,p1010,20100430,6918,6954,6980,6982,6920,6950,6950,-4,-4,116,806.28,532
881,p1010,20100504,6950,6950,6992,6992,6954,6954,6978,4,28,6,41.88,532
882,p1010,20100505,6954,6978,6902,6940,6822,6940,6894,-38,-84,220,1516.72,452
883,p1010,20100506,6940,6894,7004,7004,6902,6912,6948,18,54,52,361.32,426
884,p1010,20100507,6912,6948,6848,6848,6744,6744,6756,-204,-192,26,175.66,412
885,p1010,20100510,6744,6756,6744,6886,6738,6886,6796,130,40,18,122.36,414
886,p1010,20100511,6886,6796,6812,6834,6776,6790,6804,-6,8,16,108.88,414
887,p1010,20100512,6790,6804,6782,6796,6464,6782,6668,-22,-136,28,186.73,410
888,p1010,20100513,6782,6668,6746,6794,6706,6746,6716,78,48,86,577.71,412
889,p1010,20100514,6746,6716,6612,6762,6612,6668,6686,-48,-30,36,240.76,404
890,p1010,20100517,6668,6686,6660,6660,6452,6552,6542,-134,-144,86,562.63,358
891,p1010,20100518,6552,6542,6598,6602,6552,6600,6580,58,38,12,78.98,358
892,p1010,20100519,6600,6580,6594,6696,6546,6578,6596,-2,16,180,1187.52,202
893,p1010,20100520,6578,6596,6622,6622,6608,6608,6610,12,14,8,52.89,202
894,p1010,20100521,6608,6610,6634,6672,6634,6672,6656,62,46,10,66.56,202
895,p1010,20100524,6672,6656,6686,6692,6648,6666,6674,10,18,12,80.1,202
896,p1010,20100525,6666,6674,6604,6680,6604,6680,6642,6,-32,4,26.57,202
897,p1010,20100526,6680,6642,6680,6680,6604,6640,6660,-2,18,12,79.93,206
898,p1010,20100527,6640,6660,6680,6680,6678,6678,6678,18,18,50,333.93,236
899,p1010,20100528,6678,6678,6748,6748,6700,6700,6724,22,46,4,26.9,236
900,p1010,20100531,6700,6724,0,0,0,6724,6724,0,0,0,0,236
901,p1010,20100601,6724,6724,0,0,0,6724,6724,0,0,0,0,236
902,p1010,20100602,6724,6724,0,0,0,6724,6724,0,0,0,0,236
903,p1010,20100603,6724,6724,0,0,0,6724,6724,0,0,0,0,236
904,p1010,20100604,6724,6724,6606,6688,6604,6636,6646,-88,-78,12,79.77,234
905,p1010,20100607,6636,6646,6432,6688,6430,6516,6498,-130,-148,140,909.82,264
906,p1010,20100608,6516,6498,6498,6500,6472,6500,6490,2,-8,42,272.61,282
907,p1010,20100609,6500,6490,6432,6474,6406,6446,6418,-44,-72,114,731.86,242
908,p1010,20100610,6446,6418,0,0,0,6418,6418,0,0,0,0,242
909,p1010,20100611,6418,6418,6418,6418,6418,6418,6418,0,0,20,128.36,222
910,p1010,20100617,6418,6418,6468,6468,6468,6468,6468,50,50,8,51.74,222
911,p1010,20100618,6468,6468,0,0,0,6468,6468,0,0,0,0,222
912,p1010,20100621,6468,6468,0,0,0,6468,6468,0,0,0,0,222
913,p1010,20100622,6468,6468,6506,6506,6506,6506,6506,38,38,2,13.01,222
914,p1010,20100623,6506,6506,6498,6498,6498,6498,6498,-8,-8,2,13,220
915,p1010,20100624,6498,6498,6518,6518,6518,6518,6518,20,20,2,13.04,218
916,p1010,20100625,6518,6518,6520,6520,6510,6510,6516,-8,-2,8,52.14,210
917,p1010,20100628,6510,6516,6522,6548,6522,6548,6534,32,18,4,26.14,208
918,p1010,20100629,6548,6534,6430,6482,6366,6366,6434,-168,-100,26,167.32,208
919,p1010,20100630,6366,6434,6422,6422,6330,6362,6356,-72,-78,16,101.7,210
920,p1010,20100701,6362,6356,6480,6480,6314,6360,6382,4,26,14,89.36,214
921,p1010,20100702,6360,6382,6286,6286,6286,6286,6286,-96,-96,6,37.72,214
922,p1010,20100705,6286,6286,6292,6314,6292,6314,6302,28,16,4,25.21,214
923,p1010,20100706,6314,6302,6208,6276,6208,6230,6234,-72,-68,10,62.34,210
924,p1010,20100707,6230,6234,0,0,0,6234,6234,0,0,0,0,210
925,p1010,20100708,6234,6234,0,0,0,6234,6234,0,0,0,0,210
926,p1010,20100709,6234,6234,6290,6324,6270,6316,6304,82,70,10,63.04,210
927,p1010,20100712,6316,6304,6396,6396,6396,6396,6396,92,92,46,294.22,230
928,p1010,20100713,6396,6396,6394,6396,6354,6354,6368,-42,-28,16,101.91,224
929,p1010,20100714,6354,6368,6388,6388,6388,6388,6388,20,20,4,25.55,224
930,p1010,20100715,6388,6388,6504,6504,6410,6410,6456,22,68,8,51.66,228
931,p1010,20100716,6410,6456,6404,6544,6404,6522,6492,66,36,32,207.75,230
932,p1010,20100719,6522,6492,6368,6502,6368,6486,6464,-6,-28,24,155.16,230
933,p1010,20100720,6486,6464,6478,6572,6442,6504,6496,40,32,14,90.96,236
934,p1010,20100721,6504,6496,6500,6520,6462,6498,6494,2,-2,226,1467.76,264
935,p1010,20100722,6498,6494,6512,6610,6498,6608,6564,114,70,244,1601.87,160
936,p1010,20100723,6608,6564,6612,6650,6612,6648,6638,84,74,56,371.73,138
937,p1010,20100726,6648,6638,6666,6666,6666,6666,6666,28,28,2,13.33,136
938,p1010,20100727,6666,6666,6602,6602,6602,6602,6602,-64,-64,6,39.61,132
939,p1010,20100728,6602,6602,6576,6666,6576,6658,6602,56,0,142,937.68,140
940,p1010,20100729,6658,6602,6720,6758,6700,6758,6714,156,112,54,362.63,136
941,p1010,20100730,6758,6714,6850,6850,6788,6790,6838,76,124,54,369.31,174
942,p1010,20100802,6790,6838,6928,6966,6928,6966,6940,128,102,6,41.64,178
943,p1010,20100803,6966,6940,7014,7014,6944,7014,6990,74,50,6,41.94,178
944,p1010,20100804,7014,6990,7092,7094,6970,7036,7042,46,52,12,84.52,182
945,p1010,20100805,7036,7042,7128,7128,6922,6940,6988,-102,-54,28,195.7,174
946,p1010,20100806,6940,6988,7044,7118,7002,7118,7086,130,98,84,595.28,180
947,p1010,20100809,7118,7086,7264,7264,7176,7210,7186,124,100,84,603.72,126
948,p1010,20100810,7210,7186,7298,7298,7126,7210,7210,24,24,56,403.86,170
949,p1010,20100811,7210,7210,7114,7170,7114,7170,7146,-40,-64,70,500.27,128
950,p1010,20100812,7170,7146,0,0,0,7146,7146,0,0,0,0,128
951,p1010,20100813,7146,7146,7286,7316,7286,7316,7300,170,154,4,29.2,128
952,p1010,20100816,7316,7300,0,0,0,7300,7300,0,0,0,0,128
953,p1010,20100817,7300,7300,0,0,0,7300,7300,0,0,0,0,128
954,p1010,20100818,7300,7300,7282,7294,7262,7262,7268,-38,-32,16,116.32,128
955,p1010,20100819,7262,7268,7252,7252,7250,7250,7250,-18,-18,4,29,126
956,p1010,20100820,7250,7250,7106,7232,7104,7134,7148,-116,-102,46,328.86,126
957,p1010,20100823,7134,7148,0,0,0,7148,7148,0,0,0,0,126
958,p1010,20100824,7148,7148,0,0,0,7148,7148,0,0,0,0,126
959,p1010,20100825,7148,7148,7114,7116,7114,7114,7114,-34,-34,26,184.97,102
960,p1010,20100826,7114,7114,0,0,0,7114,7114,0,0,0,0,102
961,p1010,20100827,7114,7114,7080,7200,7080,7200,7140,86,26,4,28.56,102
962,p1010,20100830,7200,7140,0,0,0,7140,7140,0,0,0,0,102
963,p1010,20100831,7140,7140,0,0,0,7140,7140,0,0,0,0,102
964,p1010,20100901,7140,7140,7102,7102,7102,7102,7102,-38,-38,2,14.2,100
965,p1010,20100902,7102,7102,7090,7090,7090,7090,7090,-12,-12,2,14.18,98
966,p1010,20100903,7090,7090,7140,7140,7140,7140,7140,50,50,4,28.56,94
967,p1010,20100906,7140,7140,7230,7240,7230,7240,7232,100,92,10,72.32,84
968,p1010,20100907,7240,7232,7150,7150,7150,7150,7150,-82,-82,2,14.3,84
969,p1010,20100908,7150,7150,7240,7240,7230,7230,7232,80,82,16,115.73,68
970,p1010,20100909,7230,7232,7150,7194,7150,7194,7184,-38,-48,10,71.85,70
971,p1010,20100910,7194,7184,7298,7298,7298,7298,7298,114,114,2,14.6,68
972,p1010,20100913,7298,7298,7180,7270,7114,7114,7188,-184,-110,20,143.77,64
973,p1010,20100914,7114,7188,7114,7114,7114,7114,7114,-74,-74,24,170.74,40
974,p1010,20100915,7114,7114,7132,7132,7132,7132,7132,18,18,6,42.79,34
975,p1010,20100916,7132,7132,7198,7198,7198,7198,7198,66,66,2,14.4,32
976,p1010,20100917,7198,7198,0,0,0,7198,7198,0,0,0,0,32
977,p1010,20100920,7198,7198,7552,7552,7302,7302,7426,104,228,4,29.71,30
978,p1010,20100921,7302,7426,7548,7548,7280,7450,7444,24,18,8,59.56,28
979,p1010,20100927,7450,7444,7890,7890,7464,7464,7728,20,284,10,77.29,24
980,p1010,20100928,7464,7728,0,0,0,7728,7728,0,0,0,0,24
981,p1010,20100929,7728,7728,7650,7650,7500,7500,7550,-228,-178,6,45.3,18
982,p1010,20100930,7500,7550,7500,7500,7480,7480,7484,-70,-66,18,134.72,0
983,p1010,20101008,7480,7484,0,0,0,7484,7484,0,0,0,0,0
984,p1010,20101011,7484,7484,0,0,0,7484,7484,0,0,0,0,0
985,p1010,20101012,7484,7484,0,0,0,7484,7484,0,0,0,0,0
986,p1010,20101013,7484,7484,0,0,0,7484,7484,0,0,0,0,0
987,p1010,20101014,7484,7484,0,0,0,7484,7484,0,0,0,0,0
988,p1010,20101015,7484,7484,0,0,0,7484,7484,0,0,0,0,0
989,p1010,20101018,7484,7484,0,0,0,7484,7484,0,0,0,0,0
990,p1010,20101019,7484,7484,0,0,0,7484,7484,0,0,0,0,0
991,p1010,20101020,7484,7484,0,0,0,7484,7484,0,0,0,0,0
992,p1010,20101021,7484,7484,0,0,0,7484,7484,0,0,0,0,0
993,p1011,20100104,7302,7268,7336,7430,7336,7430,7398,162,130,6,44.39,78
994,p1011,20100105,7430,7398,0,0,0,7398,7398,0,0,0,0,78
995,p1011,20100106,7398,7398,7290,7496,7290,7496,7440,98,42,8,59.53,74
996,p1011,20100107,7496,7440,7584,7584,7250,7292,7400,-148,-40,12,88.81,76
997,p1011,20100108,7292,7400,7200,7200,7030,7030,7086,-370,-314,6,42.52,74
998,p1011,20100111,7030,7086,7252,7252,7252,7252,7252,166,166,2,14.5,72
999,p1011,20100112,7252,7252,0,0,0,7252,7252,0,0,0,0,72
1000,p1011,20100113,7252,7252,6892,6892,6892,6892,6892,-360,-360,2,13.78,72
1001,p1011,20100114,6892,6892,7050,7050,6888,6888,6968,-4,76,8,55.75,72
1002,p1011,20100115,6888,6968,0,0,0,6968,6968,0,0,0,0,72
1003,p1011,20100118,6968,6968,6780,6888,6780,6888,6800,-80,-168,50,340.06,54
1004,p1011,20100119,6888,6800,6890,6890,6844,6860,6866,60,66,34,233.44,62
1005,p1011,20100120,6860,6866,6860,6860,6700,6730,6740,-136,-126,156,1051.61,190
1006,p1011,20100121,6730,6740,6730,6820,6694,6820,6742,80,2,12,80.92,186
1007,p1011,20100122,6820,6742,6686,6686,6674,6674,6680,-68,-62,6,40.08,184
1008,p1011,20100125,6674,6680,6876,6876,6770,6796,6820,116,140,148,1009.41,68
1009,p1011,20100126,6796,6820,6774,6856,6722,6750,6774,-70,-46,8,54.2,68
1010,p1011,20100127,6750,6774,0,0,0,6774,6658,0,-116,2,13.32,68
1011,p1011,20100128,6774,6658,6708,6708,6708,6708,6708,50,50,2,13.42,68
1012,p1011,20100129,6708,6708,6750,6750,6610,6610,6614,-98,-94,68,449.76,132
1013,p1011,20100201,6610,6614,6512,6512,6510,6510,6510,-104,-104,4,26.04,134
1014,p1011,20100202,6510,6510,6598,6600,6570,6570,6572,60,62,32,210.36,162
1015,p1011,20100203,6570,6572,6602,6732,6602,6666,6696,94,124,16,107.15,170
1016,p1011,20100204,6666,6696,6692,6758,6622,6706,6664,10,-32,266,1773.1,294
1017,p1011,20100205,6706,6664,6660,6714,6660,6698,6690,34,26,22,147.18,292
1018,p1011,20100208,6698,6690,6766,6780,6750,6750,6768,60,78,12,81.23,296
1019,p1011,20100209,6750,6768,6680,6820,6680,6820,6762,52,-6,358,2420.94,292
1020,p1011,20100210,6820,6762,6800,6800,6800,6800,6766,38,4,6,40.6,288
1021,p1011,20100211,6800,6766,0,0,0,6766,6766,0,0,0,0,288
1022,p1011,20100212,6766,6766,0,0,0,6766,6766,0,0,0,0,288
1023,p1011,20100222,6766,6766,6900,6900,6900,6900,6900,134,134,2,13.8,286
1024,p1011,20100223,6900,6900,0,0,0,6900,6900,0,0,0,0,286
1025,p1011,20100224,6900,6900,7026,7026,7022,7022,7024,122,124,6,42.15,290
1026,p1011,20100225,7022,7024,6950,6968,6938,6968,6952,-56,-72,12,83.44,294
1027,p1011,20100226,6968,6952,0,0,0,6952,6952,0,0,0,0,294
1028,p1011,20100301,6952,6952,6920,7030,6920,6960,6974,8,22,30,209.23,294
1029,p1011,20100302,6960,6974,7040,7056,6990,6990,7032,16,58,118,829.88,294
1030,p1011,20100303,6990,7032,0,0,0,7032,7032,0,0,0,0,294
1031,p1011,20100304,7032,7032,0,0,0,7032,7032,0,0,0,0,294
1032,p1011,20100305,7032,7032,0,0,0,7032,7032,0,0,0,0,294
1033,p1011,20100308,7032,7032,7130,7130,7054,7054,7104,22,72,6,42.62,296
1034,p1011,20100309,7054,7104,7154,7192,7154,7192,7172,88,68,4,28.69,294
1035,p1011,20100310,7192,7172,7192,7192,7102,7168,7162,-4,-10,14,100.27,304
1036,p1011,20100311,7168,7162,7118,7186,7042,7042,7078,-120,-84,46,325.61,314
1037,p1011,20100312,7042,7078,7010,7048,7008,7048,7018,-30,-60,36,252.7,322
1038,p1011,20100315,7048,7018,6922,6948,6910,6948,6926,-70,-92,6,41.56,322
1039,p1011,20100316,6948,6926,6880,6976,6880,6944,6916,18,-10,12,82.99,330
1040,p1011,20100317,6944,6916,7016,7016,6950,6950,6966,34,50,8,55.73,332
1041,p1011,20100318,6950,6966,6936,6936,6936,6936,6936,-30,-30,2,13.87,332
1042,p1011,20100319,6936,6936,6946,6966,6916,6964,6944,28,8,14,97.24,330
1043,p1011,20100322,6964,6944,6964,6964,6960,6960,6958,16,14,6,41.75,328
1044,p1011,20100323,6960,6958,6980,6980,6980,6980,6972,22,14,10,69.72,328
1045,p1011,20100324,6980,6972,7002,7002,7002,7002,6968,30,-4,6,41.81,326
1046,p1011,20100325,7002,6968,6988,6994,6986,6994,6988,26,20,8,55.91,330
1047,p1011,20100326,6994,6988,6904,6904,6852,6904,6908,-84,-80,140,967.12,266
1048,p1011,20100329,6904,6908,6944,6956,6906,6940,6930,32,22,26,180.23,264
1049,p1011,20100330,6940,6930,6912,6988,6824,6942,6900,12,-30,46,317.41,264
1050,p1011,20100331,6942,6900,6948,6948,6948,6948,6934,48,34,4,27.74,262
1051,p1011,20100401,6948,6934,6844,6904,6844,6880,6876,-54,-58,8,55.02,266
1052,p1011,20100402,6880,6876,6950,6950,6950,6950,6950,74,74,2,13.9,266
1053,p1011,20100406,6950,6950,6882,6948,6750,6938,6884,-12,-66,220,1514.51,280
1054,p1011,20100407,6938,6884,6996,7004,6994,6994,6998,110,114,14,97.97,278
1055,p1011,20100408,6994,6998,0,0,0,6998,6998,0,0,0,0,278
1056,p1011,20100409,6998,6998,7028,7028,6948,6948,6998,-50,0,6,41.99,274
1057,p1011,20100412,6948,6998,7030,7054,7030,7054,7042,56,44,28,197.18,266
1058,p1011,20100413,7054,7042,7032,7032,6956,7008,7008,-34,-34,12,84.1,262
1059,p1011,20100414,7008,7008,7062,7064,7026,7026,7050,18,42,18,126.92,268
1060,p1011,20100415,7026,7050,0,0,0,7050,7050,0,0,0,0,268
1061,p1011,20100416,7050,7050,7024,7034,6930,7008,7004,-42,-46,84,588.4,266
1062,p1011,20100419,7008,7004,7004,7004,7004,7004,6980,0,-24,8,55.84,266
1063,p1011,20100420,7004,6980,6988,6988,6872,6936,6940,-44,-40,120,832.87,288
1064,p1011,20100421,6936,6940,6962,6988,6922,6956,6962,16,22,60,417.75,268
1065,p1011,20100422,6956,6962,6976,6976,6928,6928,6952,-34,-10,4,27.81,268
1066,p1011,20100423,6928,6952,6990,7032,6984,7000,7006,48,54,14,98.1,270
1067,p1011,20100426,7000,7006,7006,7078,7006,7006,7030,0,24,100,703.12,270
1068,p1011,20100427,7006,7030,7004,7066,7004,7054,7048,24,18,290,2044.01,406
1069,p1011,20100428,7054,7048,6944,6966,6934,6934,6944,-114,-104,138,958.32,342
1070,p1011,20100429,6934,6944,6940,6964,6930,6932,6946,-12,2,26,180.6,342
1071,p1011,20100430,6932,6946,6944,6978,6888,6978,6936,32,-10,114,790.87,360
1072,p1011,20100504,6978,6936,6910,7136,6910,6930,6956,-6,20,64,445.28,364
1073,p1011,20100505,6930,6956,6900,6954,6890,6932,6928,-24,-28,268,1856.95,574
1074,p1011,20100506,6932,6928,6798,7000,6798,6910,6928,-18,0,32,221.7,572
1075,p1011,20100507,6910,6928,6726,6790,6720,6726,6742,-202,-186,74,498.97,570
1076,p1011,20100510,6726,6742,6768,6846,6766,6846,6820,104,78,26,177.34,570
1077,p1011,20100511,6846,6820,6784,6864,6782,6798,6816,-22,-4,30,204.5,566
1078,p1011,20100512,6798,6816,6830,6840,6830,6840,6832,24,16,6,41,560
1079,p1011,20100513,6840,6832,6858,6876,6680,6756,6758,-76,-74,118,797.56,550
1080,p1011,20100514,6756,6758,6750,6750,6686,6730,6718,-28,-40,50,335.96,564
1081,p1011,20100517,6730,6718,6620,6678,6474,6522,6582,-196,-136,148,974.2,560
1082,p1011,20100518,6522,6582,6426,6608,6426,6608,6576,26,-6,24,157.84,554
1083,p1011,20100519,6608,6576,6594,6648,6588,6588,6640,12,64,52,345.32,590
1084,p1011,20100520,6588,6640,6652,6698,6652,6680,6682,40,42,28,187.1,578
1085,p1011,20100521,6680,6682,6612,6700,6470,6660,6640,-22,-42,148,982.94,582
1086,p1011,20100524,6660,6640,6714,6728,6674,6728,6714,88,74,60,402.85,576
1087,p1011,20100525,6728,6714,6602,6710,6582,6582,6614,-132,-100,108,714.46,582
1088,p1011,20100526,6582,6614,6634,6634,6598,6598,6612,-16,-2,6,39.68,586
1089,p1011,20100527,6598,6612,6692,6744,6670,6688,6684,76,72,64,427.79,560
1090,p1011,20100528,6688,6684,6744,6744,6698,6698,6708,14,24,16,107.33,562
1091,p1011,20100531,6698,6708,6652,6652,6626,6640,6642,-68,-66,24,159.45,558
1092,p1011,20100601,6640,6642,6660,6660,6574,6574,6618,-68,-24,8,52.95,556
1093,p1011,20100602,6574,6618,6620,6656,6592,6648,6626,30,8,138,914.4,564
1094,p1011,20100603,6648,6626,6640,6640,6640,6640,6640,14,14,2,13.28,564
1095,p1011,20100604,6640,6640,6630,6688,6630,6662,6662,22,22,30,199.88,550
1096,p1011,20100607,6662,6662,6592,6592,6458,6490,6480,-172,-182,468,3033.51,572
1097,p1011,20100608,6490,6480,6512,6512,6488,6488,6490,8,10,34,220.69,566
1098,p1011,20100609,6488,6490,6468,6514,6348,6464,6426,-26,-64,254,1632.61,566
1099,p1011,20100610,6464,6426,6408,6452,6380,6414,6420,-12,-6,64,410.89,548
1100,p1011,20100611,6414,6420,6410,6410,6410,6410,6410,-10,-10,10,64.1,538
1101,p1011,20100617,6410,6410,6430,6430,6430,6430,6430,20,20,2,12.86,540
1102,p1011,20100618,6430,6430,6436,6500,6430,6430,6444,0,14,84,541.45,594
1103,p1011,20100621,6430,6444,6474,6574,6474,6552,6504,108,60,252,1639.27,578
1104,p1011,20100622,6552,6504,6522,6524,6502,6524,6520,20,16,34,221.7,554
1105,p1011,20100623,6524,6520,6506,6546,6484,6500,6516,-20,-4,38,247.64,548
1106,p1011,20100624,6500,6516,6552,6552,6500,6534,6532,18,16,52,339.76,536
1107,p1011,20100625,6534,6532,6518,6520,6518,6520,6518,-12,-14,42,273.81,514
1108,p1011,20100628,6520,6518,6520,6526,6494,6494,6512,-24,-6,12,78.16,518
1109,p1011,20100629,6494,6512,6500,6514,6322,6404,6406,-108,-106,144,922.65,596
1110,p1011,20100630,6404,6406,6368,6390,6336,6382,6384,-24,-22,132,842.91,532
1111,p1011,20100701,6382,6384,6384,6384,6350,6350,6366,-34,-18,4,25.47,530
1112,p1011,20100702,6350,6366,6304,6340,6278,6308,6314,-58,-52,16,101.03,526
1113,p1011,20100705,6308,6314,6332,6332,6302,6302,6326,-12,12,26,164.48,530
1114,p1011,20100706,6302,6326,6238,6274,6202,6268,6242,-58,-84,248,1548.18,562
1115,p1011,20100707,6268,6242,6256,6262,6256,6262,6258,20,16,4,25.04,558
1116,p1011,20100708,6262,6258,6398,6398,6312,6330,6322,72,64,170,1074.9,526
1117,p1011,20100709,6330,6322,6274,6384,6274,6384,6344,62,22,28,177.68,520
1118,p1011,20100712,6384,6344,6388,6454,6340,6340,6402,-4,58,104,665.83,532
1119,p1011,20100713,6340,6402,6386,6416,6250,6354,6364,-48,-38,36,229.16,526
1120,p1011,20100714,6354,6364,6400,6434,6400,6412,6408,48,44,42,269.2,542
1121,p1011,20100715,6412,6408,6442,6442,6388,6420,6414,12,6,48,307.91,578
1122,p1011,20100716,6420,6414,6500,6508,6446,6470,6476,56,62,328,2124.33,646
1123,p1011,20100719,6470,6476,0,0,0,6476,6476,0,0,0,0,646
1124,p1011,20100720,6476,6476,6488,6488,6424,6474,6464,-2,-12,144,930.97,640
1125,p1011,20100721,6474,6464,6546,6546,6470,6470,6494,6,30,18,116.91,638
1126,p1011,20100722,6470,6494,6476,6552,6452,6552,6502,58,8,70,455.22,640
1127,p1011,20100723,6552,6502,6638,6638,6562,6586,6576,84,74,122,802.44,700
1128,p1011,20100726,6586,6576,6584,6666,6584,6624,6620,48,44,86,569.34,670
1129,p1011,20100727,6624,6620,6612,6612,6508,6540,6560,-80,-60,94,616.81,658
1130,p1011,20100728,6540,6560,6540,6598,6540,6568,6564,8,4,46,301.96,650
1131,p1011,20100729,6568,6564,6636,6688,6636,6686,6666,122,102,50,333.37,682
1132,p1011,20100730,6686,6666,6672,6752,6670,6698,6716,32,50,176,1182.1,700
1133,p1011,20100802,6698,6716,6752,6850,6742,6850,6812,134,96,36,245.25,700
1134,p1011,20100803,6850,6812,6824,6922,6824,6876,6884,64,72,160,1101.5,696
1135,p1011,20100804,6876,6884,6938,6946,6872,6946,6914,62,30,28,193.64,698
1136,p1011,20100805,6946,6914,6946,6966,6850,6858,6906,-56,-8,84,580.12,694
1137,p1011,20100806,6858,6906,6906,7050,6850,7050,6938,144,32,224,1554.4,702
1138,p1011,20100809,7050,6938,7010,7170,6960,7128,7072,190,134,220,1556.04,750
1139,p1011,20100810,7128,7072,7122,7136,7012,7014,7046,-58,-26,714,5031.46,1312
1140,p1011,20100811,7014,7046,7042,7050,7000,7000,7036,-46,-10,22,154.82,1312
1141,p1011,20100812,7000,7036,6986,7008,6986,7000,6998,-36,-38,606,4241.3,708
1142,p1011,20100813,7000,6998,7076,7168,7050,7168,7096,170,98,64,454.16,708
1143,p1011,20100816,7168,7096,7284,7366,7196,7196,7240,100,144,14,101.37,708
1144,p1011,20100817,7196,7240,7100,7176,7100,7152,7140,-88,-100,10,71.41,708
1145,p1011,20100818,7152,7140,7172,7172,7080,7118,7132,-22,-8,360,2567.73,724
1146,p1011,20100819,7118,7132,7084,7114,7030,7090,7074,-42,-58,1228,8688.98,726
1147,p1011,20100820,7090,7074,7050,7098,6872,6992,6996,-82,-78,146,1021.55,740
1148,p1011,20100823,6992,6996,6974,6988,6904,6970,6954,-26,-42,18,125.2,734
1149,p1011,20100824,6970,6954,6942,6982,6874,6874,6948,-80,-6,20,138.98,734
1150,p1011,20100825,6874,6948,6898,6898,6858,6858,6878,-90,-70,12,82.54,734
1151,p1011,20100826,6858,6878,6880,6890,6876,6890,6880,12,2,8,55.05,732
1152,p1011,20100827,6890,6880,6926,6972,6926,6960,6952,80,72,6,41.72,732
1153,p1011,20100830,6960,6952,7008,7060,7008,7050,7050,98,98,60,423.09,732
1154,p1011,20100831,7050,7050,6990,6990,6924,6948,6954,-102,-96,50,347.8,752
1155,p1011,20100901,6948,6954,6874,6980,6872,6910,6948,-44,-6,80,555.98,706
1156,p1011,20100902,6910,6948,6940,6990,6932,6932,6972,-16,24,62,432.28,680
1157,p1011,20100903,6932,6972,7010,7012,7002,7012,7010,40,38,66,462.76,664
1158,p1011,20100906,7012,7010,7032,7120,7032,7068,7064,58,54,44,310.85,660
1159,p1011,20100907,7068,7064,7106,7106,7032,7032,7056,-32,-8,12,84.68,662
1160,p1011,20100908,7032,7056,7096,7096,7096,7096,7096,40,40,4,28.38,662
1161,p1011,20100909,7096,7096,7040,7050,7000,7050,7024,-46,-72,148,1039.62,724
1162,p1011,20100910,7050,7024,0,0,0,7024,7024,0,0,0,0,724
1163,p1011,20100913,7024,7024,7078,7096,7018,7028,7046,4,22,100,704.62,722
1164,p1011,20100914,7028,7046,7048,7054,6972,7024,7016,-22,-30,164,1150.84,656
1165,p1011,20100915,7024,7016,7032,7056,7032,7056,7048,40,32,6,42.29,658
1166,p1011,20100916,7056,7048,7024,7052,6932,6998,7000,-50,-48,40,280,624
1167,p1011,20100917,6998,7000,0,0,0,7000,7000,0,0,0,0,624
1168,p1011,20100920,7000,7000,7200,7288,7180,7242,7226,242,226,86,621.6,618
1169,p1011,20100921,7242,7226,7240,7268,7174,7268,7250,42,24,134,971.67,612
1170,p1011,20100927,7268,7250,7614,7614,7500,7500,7538,250,288,12,90.46,612
1171,p1011,20100928,7500,7538,7310,7558,7310,7558,7458,20,-80,50,372.98,612
1172,p1011,20100929,7558,7458,7360,7488,7360,7468,7448,10,-10,40,297.98,592
1173,p1011,20100930,7468,7448,7458,7580,7458,7580,7472,132,24,16,119.57,594
1174,p1011,20101008,7580,7472,7370,7994,7370,7374,7578,-98,106,6,45.48,592
1175,p1011,20101011,7374,7578,7896,7956,7896,7956,7936,378,358,6,47.62,588
1176,p1011,20101012,7956,7936,8138,8138,8134,8134,8134,198,198,6,48.81,592
1177,p1011,20101013,8134,8134,7980,8042,7970,8042,7982,-92,-152,26,207.56,572
1178,p1011,20101014,8042,7982,8120,8150,8100,8120,8122,138,140,8,64.98,570
1179,p1011,20101015,8120,8122,8150,8194,8150,8160,8180,38,58,128,1047.22,474
1180,p1011,20101018,8160,8180,8200,8200,7814,8090,8184,-90,4,404,3306.99,100
1181,p1011,20101019,8090,8184,8090,8280,8090,8280,8098,96,-86,78,631.78,26
1182,p1011,20101020,8280,8098,0,0,0,8098,8098,0,0,0,0,26
1183,p1011,20101021,8098,8098,8488,8488,8488,8488,8488,390,390,4,33.95,28
1184,p1011,20101022,8488,8488,8210,8210,8064,8210,8144,-278,-344,18,146.61,20
1185,p1011,20101025,8210,8144,8350,8550,8350,8550,8400,406,256,14,117.6,6
1186,p1011,20101026,8550,8400,7990,8560,7990,8560,8274,160,-126,16,132.4,6
1187,p1011,20101027,8560,8274,8372,8472,8270,8270,8362,-4,88,24,200.7,6
1188,p1011,20101028,8270,8362,8250,8780,8250,8780,8382,418,20,8,67.06,2
1189,p1011,20101029,8780,8382,8120,8120,8120,8120,8120,-262,-262,2,16.24,0
1190,p1011,20101101,8120,8120,0,0,0,8120,8120,0,0,0,0,0
1191,p1011,20101102,8120,8120,0,0,0,8120,8120,0,0,0,0,0
1192,p1011,20101103,8120,8120,0,0,0,8120,8120,0,0,0,0,0
1193,p1011,20101104,8120,8120,0,0,0,8120,8120,0,0,0,0,0
1194,p1011,20101105,8120,8120,0,0,0,8120,8120,0,0,0,0,0
1195,p1011,20101108,8120,8120,0,0,0,8120,8120,0,0,0,0,0
1196,p1011,20101109,8120,8120,0,0,0,8120,8120,0,0,0,0,0
1197,p1011,20101110,8120,8120,0,0,0,8120,8120,0,0,0,0,0
1198,p1011,20101111,8120,8120,0,0,0,8120,8120,0,0,0,0,0
1199,p1011,20101112,8120,8120,0,0,0,8120,8120,0,0,0,0,0
1200,p1012,20100104,7362,7314,7548,7548,7470,7470,7508,156,194,4,30.04,6
1201,p1012,20100105,7470,7508,7416,7416,7416,7416,7416,-92,-92,2,14.83,4
1202,p1012,20100106,7416,7416,0,0,0,7416,7416,0,0,0,0,4
1203,p1012,20100107,7416,7416,7374,7374,7364,7364,7368,-52,-48,4,29.48,4
1204,p1012,20100108,7364,7368,7298,7322,7298,7322,7310,-46,-58,4,29.24,4
1205,p1012,20100111,7322,7310,7360,7360,7152,7152,7256,-158,-54,4,29.02,4
1206,p1012,20100112,7152,7256,7256,7256,7256,7256,7256,0,0,2,14.51,4
1207,p1012,20100113,7256,7256,0,0,0,7256,7256,0,0,0,0,4
1208,p1012,20100114,7256,7256,0,0,0,7256,7256,0,0,0,0,4
1209,p1012,20100115,7256,7256,6990,7036,6900,6900,6976,-356,-280,8,55.81,4
1210,p1012,20100118,6900,6976,0,0,0,6976,6976,0,0,0,0,4
1211,p1012,20100119,6976,6976,6854,6854,6854,6854,6854,-122,-122,2,13.71,4
1212,p1012,20100120,6854,6854,0,0,0,6854,6854,0,0,0,0,4
1213,p1012,20100121,6854,6854,6870,6870,6830,6830,6850,-24,-4,4,27.4,4
1214,p1012,20100122,6830,6850,6844,6844,6756,6756,6812,-94,-38,6,40.87,4
1215,p1012,20100125,6756,6812,6700,6870,6700,6830,6818,18,6,810,5524.02,804
1216,p1012,20100126,6830,6818,6770,6770,6770,6770,6770,-48,-48,2,13.54,804
1217,p1012,20100127,6770,6770,0,0,0,6770,6770,0,0,0,0,804
1218,p1012,20100128,6770,6770,0,0,0,6770,6770,0,0,0,0,804
1219,p1012,20100129,6770,6770,0,0,0,6770,6770,0,0,0,0,804
1220,p1012,20100201,6770,6770,0,0,0,6770,6770,0,0,0,0,804
1221,p1012,20100202,6770,6770,0,0,0,6770,6770,0,0,0,0,804
1222,p1012,20100203,6770,6770,0,0,0,6770,6770,0,0,0,0,804
1223,p1012,20100204,6770,6770,0,0,0,6770,6770,0,0,0,0,804
1224,p1012,20100205,6770,6770,6600,6748,6600,6748,6674,-22,-96,4,26.7,806
1225,p1012,20100208,6748,6674,0,0,0,6674,6674,0,0,0,0,806
1226,p1012,20100209,6674,6674,0,0,0,6674,6674,0,0,0,0,806
1227,p1012,20100210,6674,6674,6870,6870,6722,6722,6796,48,122,4,27.18,806
1228,p1012,20100211,6722,6796,0,0,0,6796,6796,0,0,0,0,806
1229,p1012,20100212,6796,6796,0,0,0,6796,6796,0,0,0,0,806
1230,p1012,20100222,6796,6796,0,0,0,6796,6796,0,0,0,0,806
1231,p1012,20100223,6796,6796,0,0,0,6796,6796,0,0,0,0,806
1232,p1012,20100224,6796,6796,0,0,0,6796,6796,0,0,0,0,806
1233,p1012,20100225,6796,6796,6834,6834,6800,6800,6800,4,4,102,693.67,904
1234,p1012,20100226,6800,6800,0,0,0,6800,6800,0,0,0,0,904
1235,p1012,20100301,6800,6800,0,0,0,6800,6800,0,0,0,0,904
1236,p1012,20100302,6800,6800,6830,7050,6830,7010,6932,210,132,8,55.46,904
1237,p1012,20100303,7010,6932,0,0,0,6932,6932,0,0,0,0,904
1238,p1012,20100304,6932,6932,0,0,0,6932,6932,0,0,0,0,904
1239,p1012,20100305,6932,6932,0,0,0,6932,6932,0,0,0,0,904
1240,p1012,20100308,6932,6932,0,0,0,6932,6932,0,0,0,0,904
1241,p1012,20100309,6932,6932,6908,6908,6908,6908,6908,-24,-24,2,13.82,906
1242,p1012,20100310,6908,6908,6996,7108,6996,7096,7052,188,144,26,183.39,908
1243,p1012,20100311,7096,7052,7096,7096,7096,7096,7006,44,-46,4,28.03,906
1244,p1012,20100312,7096,7006,0,0,0,7006,7006,0,0,0,0,906
1245,p1012,20100315,7006,7006,6816,6816,6816,6816,6816,-190,-190,2,13.63,906
1246,p1012,20100316,6816,6816,6810,7154,6810,7154,6982,338,166,4,27.93,904
1247,p1012,20100317,7154,6982,0,0,0,6982,6982,0,0,0,0,904
1248,p1012,20100318,6982,6982,6856,6896,6850,6896,6876,-86,-106,10,68.78,910
1249,p1012,20100319,6896,6876,6976,6976,6976,6976,6976,100,100,2,13.95,910
1250,p1012,20100322,6976,6976,6852,7000,6852,7000,6926,24,-50,4,27.7,912
1251,p1012,20100323,7000,6926,6944,6944,6944,6944,6944,18,18,6,41.66,918
1252,p1012,20100324,6944,6944,0,0,0,6944,6980,0,36,2,13.96,920
1253,p1012,20100325,6944,6980,0,0,0,6980,6980,0,0,0,0,920
1254,p1012,20100326,6980,6980,0,0,0,6980,6792,0,-188,2,13.58,918
1255,p1012,20100329,6980,6792,6918,6918,6918,6918,6918,126,126,2,13.84,918
1256,p1012,20100330,6918,6918,6928,6928,6928,6928,6928,10,10,6,41.57,918
1257,p1012,20100331,6928,6928,6880,6994,6880,6950,6934,22,6,18,124.84,922
1258,p1012,20100401,6950,6934,6900,6900,6862,6900,6890,-34,-44,8,55.12,922
1259,p1012,20100402,6900,6890,0,0,0,6890,6890,0,0,0,0,922
1260,p1012,20100406,6890,6890,0,0,0,6890,6890,0,0,0,0,922
1261,p1012,20100407,6890,6890,0,0,0,6890,6890,0,0,0,0,922
1262,p1012,20100408,6890,6890,6998,7110,6998,7026,7032,136,142,8,56.26,926
1263,p1012,20100409,7026,7032,6998,6998,6998,6998,6998,-34,-34,2,14,926
1264,p1012,20100412,6998,6998,7048,7086,7048,7052,7056,54,58,24,169.38,928
1265,p1012,20100413,7052,7056,7000,7000,6990,6996,6994,-60,-62,22,153.9,926
1266,p1012,20100414,6996,6994,7026,7026,7022,7022,7022,28,28,10,70.24,926
1267,p1012,20100415,7022,7022,6994,6994,6994,6994,6994,-28,-28,2,13.99,926
1268,p1012,20100416,6994,6994,0,0,0,6994,6994,0,0,0,0,926
1269,p1012,20100419,6994,6994,6898,6898,6898,6898,6898,-96,-96,2,13.8,928
1270,p1012,20100420,6898,6898,6990,6990,6970,6986,6984,88,86,10,69.84,932
1271,p1012,20100421,6986,6984,6868,6988,6868,6962,6950,-22,-34,8,55.61,932
1272,p1012,20100422,6962,6950,0,0,0,6950,6950,0,0,0,0,932
1273,p1012,20100423,6950,6950,7020,7060,7020,7060,7036,110,86,16,112.6,938
1274,p1012,20100426,7060,7036,7058,7090,7058,7090,7068,54,32,6,42.41,940
1275,p1012,20100427,7090,7068,7096,7096,7096,7096,7112,28,44,4,28.45,940
1276,p1012,20100428,7096,7112,7068,7068,7028,7028,7032,-84,-80,6,42.2,934
1277,p1012,20100429,7028,7032,7006,7026,6996,6996,7008,-36,-24,10,70.09,928
1278,p1012,20100430,6996,7008,6974,6974,6974,6974,6948,-34,-60,4,27.79,930
1279,p1012,20100504,6974,6948,7014,7014,6940,6950,6974,2,26,8,55.8,928
1280,p1012,20100505,6950,6974,0,0,0,6974,6974,0,0,0,0,928
1281,p1012,20100506,6974,6974,0,0,0,6974,6976,0,2,4,27.9,930
1282,p1012,20100507,6974,6976,6830,6830,6740,6760,6816,-216,-160,16,109.06,928
1283,p1012,20100510,6760,6816,0,0,0,6816,6816,0,0,0,0,928
1284,p1012,20100511,6816,6816,0,0,0,6816,6816,0,0,0,0,928
1285,p1012,20100512,6816,6816,0,0,0,6816,6816,0,0,0,0,928
1286,p1012,20100513,6816,6816,6826,6826,6740,6740,6782,-76,-34,4,27.13,928
1287,p1012,20100514,6740,6782,0,0,0,6782,6782,0,0,0,0,928
1288,p1012,20100517,6782,6782,6600,6614,6598,6614,6604,-168,-178,6,39.62,928
1289,p1012,20100518,6614,6604,0,0,0,6604,6604,0,0,0,0,928
1290,p1012,20100519,6604,6604,0,0,0,6604,6604,0,0,0,0,928
1291,p1012,20100520,6604,6604,6686,6706,6686,6706,6696,102,92,4,26.78,926
1292,p1012,20100521,6706,6696,6630,6738,6628,6738,6682,42,-14,214,1430.08,1008
1293,p1012,20100524,6738,6682,6700,6700,6700,6700,6700,18,18,4,26.8,1008
1294,p1012,20100525,6700,6700,6698,6698,6698,6698,6698,-2,-2,2,13.4,1006
1295,p1012,20100526,6698,6698,6652,6728,6634,6700,6690,2,-8,804,5379.07,1132
1296,p1012,20100527,6700,6690,6720,6734,6720,6734,6730,44,40,20,134.63,1116
1297,p1012,20100528,6734,6730,0,0,0,6730,6730,0,0,0,0,1116
1298,p1012,20100531,6730,6730,6686,6686,6686,6686,6686,-44,-44,4,26.74,1112
1299,p1012,20100601,6686,6686,6610,6658,6610,6658,6656,-28,-30,570,3794.77,1670
1300,p1012,20100602,6658,6656,6724,6724,6652,6690,6672,34,16,18,120.13,1668
1301,p1012,20100603,6690,6672,0,0,0,6672,6672,0,0,0,0,1668
1302,p1012,20100604,6672,6672,6702,6720,6702,6720,6710,48,38,4,26.84,1666
1303,p1012,20100607,6720,6710,6530,6530,6530,6530,6530,-180,-180,2,13.06,1666
1304,p1012,20100608,6530,6530,6516,6578,6514,6578,6530,48,0,8,52.24,1664
1305,p1012,20100609,6578,6530,6484,6506,6414,6474,6470,-56,-60,16,103.55,1664
1306,p1012,20100610,6474,6470,6464,6464,6464,6464,6464,-6,-6,240,1551.36,1424
1307,p1012,20100611,6464,6464,6508,6508,6456,6472,6480,8,16,8,51.85,1424
1308,p1012,20100617,6472,6480,0,0,0,6480,6480,0,0,0,0,1424
1309,p1012,20100618,6480,6480,0,0,0,6480,6480,0,0,0,0,1424
1310,p1012,20100621,6480,6480,0,0,0,6480,6480,0,0,0,0,1424
1311,p1012,20100622,6480,6480,0,0,0,6480,6480,0,0,0,0,1424
1312,p1012,20100623,6480,6480,6590,6590,6570,6570,6574,90,94,12,78.9,1424
1313,p1012,20100624,6570,6574,0,0,0,6574,6574,0,0,0,0,1424
1314,p1012,20100625,6574,6574,0,0,0,6574,6574,0,0,0,0,1424
1315,p1012,20100628,6574,6574,0,0,0,6574,6574,0,0,0,0,1424
1316,p1012,20100629,6574,6574,6462,6462,6462,6462,6462,-112,-112,2,12.92,1424
1317,p1012,20100630,6462,6462,6440,6440,6438,6438,6438,-24,-24,4,25.76,1422
1318,p1012,20100701,6438,6438,6442,6442,6442,6442,6442,4,4,564,3633.29,858
1319,p1012,20100702,6442,6442,0,0,0,6442,6442,0,0,0,0,858
1320,p1012,20100705,6442,6442,0,0,0,6442,6442,0,0,0,0,858
1321,p1012,20100706,6442,6442,6254,6318,6254,6318,6312,-124,-130,60,378.77,906
1322,p1012,20100707,6318,6312,6354,6354,6354,6354,6354,42,42,2,12.71,908
1323,p1012,20100708,6354,6354,6420,6420,6364,6380,6376,26,22,44,280.55,910
1324,p1012,20100709,6380,6376,6338,6446,6338,6426,6374,50,-2,90,573.75,892
1325,p1012,20100712,6426,6374,0,0,0,6374,6374,0,0,0,0,892
1326,p1012,20100713,6374,6374,6456,6456,6404,6430,6430,56,56,28,180.08,888
1327,p1012,20100714,6430,6430,6508,6510,6480,6480,6492,50,62,10,64.93,888
1328,p1012,20100715,6480,6492,0,0,0,6492,6492,0,0,0,0,888
1329,p1012,20100716,6492,6492,6596,6596,6596,6596,6596,104,104,10,65.96,886
1330,p1012,20100719,6596,6596,6586,6586,6586,6586,6586,-10,-10,8,52.69,886
1331,p1012,20100720,6586,6586,6600,6600,6600,6600,6600,14,14,2,13.2,886
1332,p1012,20100721,6600,6600,6612,6612,6600,6600,6606,0,6,16,105.7,880
1333,p1012,20100722,6600,6606,6660,6710,6650,6704,6682,98,76,44,294.06,864
1334,p1012,20100723,6704,6682,6730,6730,6710,6710,6728,28,46,570,3835.96,302
1335,p1012,20100726,6710,6728,6710,6778,6710,6766,6746,38,18,72,485.74,314
1336,p1012,20100727,6766,6746,6716,6716,6656,6658,6680,-88,-66,122,814.98,304
1337,p1012,20100728,6658,6680,6682,6686,6682,6686,6684,6,4,36,240.69,270
1338,p1012,20100729,6686,6684,6758,6790,6722,6722,6730,38,46,60,403.87,322
1339,p1012,20100730,6722,6730,6808,6870,6752,6772,6840,42,110,72,492.58,270
1340,p1012,20100802,6772,6840,6950,6950,6950,6950,6950,110,110,2,13.9,270
1341,p1012,20100803,6950,6950,6960,7032,6960,7004,7002,54,52,12,84.04,272
1342,p1012,20100804,7004,7002,7030,7030,7030,7030,7030,28,28,2,14.06,272
1343,p1012,20100805,7030,7030,7150,7150,6952,6970,7008,-60,-22,124,869,346
1344,p1012,20100806,6970,7008,7014,7166,7000,7166,7040,158,32,106,746.4,344
1345,p1012,20100809,7166,7040,7178,7272,7178,7216,7232,176,192,134,969.17,368
1346,p1012,20100810,7216,7232,7220,7264,7160,7168,7210,-64,-22,80,576.83,340
1347,p1012,20100811,7168,7210,7164,7164,7156,7156,7160,-54,-50,20,143.24,334
1348,p1012,20100812,7156,7160,7106,7164,7106,7164,7138,4,-22,8,57.11,338
1349,p1012,20100813,7164,7138,7218,7322,7218,7322,7270,184,132,4,29.08,336
1350,p1012,20100816,7322,7270,7422,7444,7390,7422,7426,152,156,32,237.64,334
1351,p1012,20100817,7422,7426,7422,7422,7364,7364,7382,-62,-44,6,44.3,330
1352,p1012,20100818,7364,7382,7366,7366,7254,7254,7310,-128,-72,4,29.24,330
1353,p1012,20100819,7254,7310,7236,7236,7236,7236,7236,-74,-74,10,72.36,322
1354,p1012,20100820,7236,7236,7154,7154,7028,7028,7074,-208,-162,8,56.59,320
1355,p1012,20100823,7028,7074,0,0,0,7074,7074,0,0,0,0,320
1356,p1012,20100824,7074,7074,0,0,0,7074,7074,0,0,0,0,320
1357,p1012,20100825,7074,7074,0,0,0,7074,7074,0,0,0,0,320
1358,p1012,20100826,7074,7074,7036,7036,7034,7034,7034,-40,-40,6,42.21,320
1359,p1012,20100827,7034,7034,7114,7114,7114,7114,7114,80,80,2,14.23,320
1360,p1012,20100830,7114,7114,7248,7322,7204,7230,7238,116,124,70,506.79,368
1361,p1012,20100831,7230,7238,7130,7130,7060,7060,7104,-178,-134,72,511.58,344
1362,p1012,20100901,7060,7104,7098,7128,7054,7054,7100,-50,-4,50,355.09,328
1363,p1012,20100902,7054,7100,7078,7120,7078,7120,7098,20,-2,4,28.4,328
1364,p1012,20100903,7120,7098,7180,7180,7176,7176,7176,78,78,8,57.42,326
1365,p1012,20100906,7176,7176,7176,7232,7176,7232,7194,56,18,6,43.17,324
1366,p1012,20100907,7232,7194,7240,7240,7240,7240,7240,46,46,2,14.48,322
1367,p1012,20100908,7240,7240,0,0,0,7240,7240,0,0,0,0,322
1368,p1012,20100909,7240,7240,7160,7172,7160,7172,7166,-68,-74,6,43,320
1369,p1012,20100910,7172,7166,0,0,0,7166,7166,0,0,0,0,320
1370,p1012,20100913,7166,7166,0,0,0,7166,7166,0,0,0,0,320
1371,p1012,20100914,7166,7166,7270,7270,7270,7270,7270,104,104,2,14.54,322
1372,p1012,20100915,7270,7270,7240,7240,7240,7240,7240,-30,-30,2,14.48,320
1373,p1012,20100916,7240,7240,0,0,0,7240,7240,0,0,0,0,320
1374,p1012,20100917,7240,7240,0,0,0,7240,7240,0,0,0,0,320
1375,p1012,20100920,7240,7240,7400,7420,7400,7400,7408,160,168,56,414.92,266
1376,p1012,20100921,7400,7408,0,0,0,7408,7408,0,0,0,0,266
1377,p1012,20100927,7408,7408,7670,7670,7618,7618,7644,210,236,4,30.58,266
1378,p1012,20100928,7618,7644,0,0,0,7644,7644,0,0,0,0,266
1379,p1012,20100929,7644,7644,0,0,0,7644,7556,0,-88,6,45.34,266
1380,p1012,20100930,7644,7556,7570,7570,7570,7570,7570,14,14,2,15.14,266
1381,p1012,20101008,7570,7570,0,0,0,7570,7570,0,0,0,0,266
1382,p1012,20101011,7570,7570,7948,7948,7948,7948,7948,378,378,2,15.9,264
1383,p1012,20101012,7948,7948,0,0,0,7948,7948,0,0,0,0,264
1384,p1012,20101013,7948,7948,0,0,0,7948,7948,0,0,0,0,264
1385,p1012,20101014,7948,7948,8338,8338,8210,8210,8274,262,326,4,33.1,264
1386,p1012,20101015,8210,8274,8298,8298,8250,8276,8280,2,6,8,66.24,264
1387,p1012,20101018,8276,8280,0,0,0,8280,8280,0,0,0,0,264
1388,p1012,20101019,8280,8280,8200,8200,8200,8200,8200,-80,-80,10,82,264
1389,p1012,20101020,8200,8200,0,0,0,8200,8200,0,0,0,0,264
1390,p1012,20101021,8200,8200,8444,8444,8428,8428,8436,228,236,4,33.74,264
1391,p1012,20101022,8428,8436,8446,8448,8406,8436,8434,0,-2,8,67.47,264
1392,p1012,20101025,8436,8434,8558,8558,8558,8558,8558,124,124,2,17.12,264
1393,p1012,20101026,8558,8558,8600,8600,8562,8562,8578,4,20,10,85.79,258
1394,p1012,20101027,8562,8578,8550,8550,8420,8420,8472,-158,-106,106,898.18,158
1395,p1012,20101028,8420,8472,0,0,0,8472,8472,0,0,0,0,158
1396,p1012,20101029,8472,8472,8550,8550,8550,8550,8550,78,78,2,17.1,158
1397,p1012,20101101,8550,8550,8598,8606,8580,8580,8592,30,42,8,68.74,154
1398,p1012,20101102,8580,8592,8600,8618,8550,8550,8574,-42,-18,42,360.11,136
1399,p1012,20101103,8550,8574,8520,8520,8520,8520,8520,-54,-54,4,34.08,132
1400,p1012,20101104,8520,8520,8600,8650,8528,8640,8616,120,96,32,275.74,136
1401,p1012,20101105,8640,8616,0,0,0,8616,8616,0,0,0,0,136
1402,p1012,20101108,8616,8616,9046,9046,9046,9046,9046,430,430,18,162.83,118
1403,p1012,20101109,9046,9046,0,0,0,9046,9046,0,0,0,0,118
1404,p1012,20101110,9046,9046,9220,9498,8900,8900,9202,-146,156,12,110.42,110
1405,p1012,20101111,8900,9202,0,0,0,9202,9202,0,0,0,0,110
1406,p1012,20101112,9202,9202,8830,8830,8742,8742,8808,-460,-394,8,70.46,102
1407,p1012,20101115,8742,8808,8700,8700,8600,8600,8650,-208,-158,16,138.4,86
1408,p1012,20101116,8600,8650,8600,8630,8600,8630,8612,-20,-38,8,68.91,80
1409,p1012,20101117,8630,8612,8400,8720,8400,8720,8444,108,-168,28,236.44,56
1410,p1012,20101118,8720,8444,8402,8850,8402,8850,8430,406,-14,30,252.96,28
1411,p1012,20101119,8850,8430,8500,8500,8500,8500,8500,70,70,20,170,8
1412,p1012,20101122,8500,8500,0,0,0,8500,8500,0,0,0,0,8
1413,p1012,20101123,8500,8500,0,0,0,8500,8500,0,0,0,0,8
1414,p1012,20101124,8500,8500,0,0,0,8500,8500,0,0,0,0,8
1415,p1012,20101125,8500,8500,8500,8924,8500,8700,8748,200,248,10,87.49,4
1416,p1012,20101126,8700,8748,0,0,0,8748,8748,0,0,0,0,4
1417,p1012,20101129,8748,8748,8650,8650,8650,8650,8650,-98,-98,4,34.6,0
1418,p1012,20101130,8650,8650,0,0,0,8650,8650,0,0,0,0,0
1419,p1012,20101201,8650,8650,0,0,0,8650,8650,0,0,0,0,0
1420,p1012,20101202,8650,8650,0,0,0,8650,8650,0,0,0,0,0
1421,p1012,20101203,8650,8650,0,0,0,8650,8650,0,0,0,0,0
1422,p1012,20101206,8650,8650,0,0,0,8650,8650,0,0,0,0,0
1423,p1012,20101207,8650,8650,0,0,0,8650,8650,0,0,0,0,0
1424,p1012,20101208,8650,8650,0,0,0,8650,8650,0,0,0,0,0
1425,p1012,20101209,8650,8650,0,0,0,8650,8650,0,0,0,0,0
1426,p1012,20101210,8650,8650,0,0,0,8650,8650,0,0,0,0,0
1427,p1012,20101213,8650,8650,0,0,0,8650,8650,0,0,0,0,0
1428,p1012,20101214,8650,8650,0,0,0,8650,8650,0,0,0,0,0
1429,p1101,20100118,,6882,7108,7108,6722,6766,6780,-116,-102,972,6590.85,540
1430,p1101,20100119,6766,6780,6794,6850,6764,6772,6820,-8,40,776,5292.52,884
1431,p1101,20100120,6772,6820,6796,6820,6650,6650,6728,-170,-92,616,4145.66,1084
1432,p1101,20100121,6650,6728,6618,6734,6614,6728,6666,0,-62,340,2266.61,1128
1433,p1101,20100122,6728,6666,6686,6732,6436,6716,6662,50,-4,366,2438.72,1178
1434,p1101,20100125,6716,6662,6704,6738,6600,6698,6708,36,46,692,4641.96,1488
1435,p1101,20100126,6698,6708,6710,6710,6606,6610,6656,-98,-52,298,1983.69,1564
1436,p1101,20100127,6610,6656,6630,6660,6588,6648,6632,-8,-24,478,3170.28,1636
1437,p1101,20100128,6648,6632,6600,6604,6530,6588,6580,-44,-52,352,2316.19,1734
1438,p1101,20100129,6588,6580,6592,6638,6534,6542,6586,-38,6,580,3820.36,1826
1439,p1101,20100201,6542,6586,6568,6568,6478,6512,6540,-74,-46,3238,21180.31,3156
1440,p1101,20100202,6512,6540,6572,6608,6436,6456,6484,-84,-56,3582,23231.8,2800
1441,p1101,20100203,6456,6484,6518,6618,6518,6616,6566,132,82,5916,38853.23,3980
1442,p1101,20100204,6616,6566,6570,6596,6514,6566,6562,0,-4,1226,8045.6,4132
1443,p1101,20100205,6566,6562,6542,6624,6500,6582,6580,20,18,2488,16374.79,4756
1444,p1101,20100208,6582,6580,6622,6688,6622,6680,6666,100,86,3130,20865.74,5776
1445,p1101,20100209,6680,6666,6752,6752,6660,6678,6676,12,10,1314,8773.92,5290
1446,p1101,20100210,6678,6676,6650,6720,6632,6658,6682,-18,6,3146,21021.71,4876
1447,p1101,20100211,6658,6682,6690,6748,6690,6706,6718,24,36,578,3883.5,4756
1448,p1101,20100212,6706,6718,6710,6722,6650,6668,6692,-50,-26,708,4739.31,4592
1449,p1101,20100222,6668,6692,6800,6866,6726,6832,6822,140,130,7448,50820.66,5890
1450,p1101,20100223,6832,6822,6844,6900,6822,6890,6862,68,40,5478,37593.69,6584
1451,p1101,20100224,6890,6862,6896,6896,6818,6824,6834,-38,-28,2168,14817.76,6810
1452,p1101,20100225,6824,6834,6850,6876,6752,6784,6816,-50,-18,2110,14383.38,7110
1453,p1101,20100226,6784,6816,6784,6808,6744,6750,6770,-66,-46,1556,10536.36,7544
1454,p1101,20100301,6750,6770,6808,6874,6802,6810,6830,40,60,2006,13701.01,7926
1455,p1101,20100302,6810,6830,6816,6864,6792,6796,6824,-34,-6,2534,17296.24,8206
1456,p1101,20100303,6796,6824,6830,6872,6822,6856,6852,32,28,2252,15434.24,8198
1457,p1101,20100304,6856,6852,6852,6864,6782,6788,6818,-64,-34,1500,10229,8344
1458,p1101,20100305,6788,6818,6808,6898,6760,6880,6846,62,28,4320,29578.76,9336
1459,p1101,20100308,6880,6846,6888,6926,6864,6918,6898,72,52,7326,50544.44,11812
1460,p1101,20100309,6918,6898,6906,6962,6888,6956,6930,58,32,9146,63388.71,14234
1461,p1101,20100310,6956,6930,6934,6956,6910,6922,6930,-8,0,6016,41691.04,14090
1462,p1101,20100311,6922,6930,6940,6964,6776,6842,6854,-88,-76,12152,83296.8,14782
1463,p1101,20100312,6842,6854,6810,6828,6758,6770,6796,-84,-58,5714,38833.79,16570
1464,p1101,20100315,6770,6796,6728,6782,6678,6718,6726,-78,-70,11146,74970.64,17504
1465,p1101,20100316,6718,6726,6700,6728,6670,6718,6700,-8,-26,6018,40323.76,18412
1466,p1101,20100317,6718,6700,6744,6780,6738,6758,6760,58,60,6582,44497.5,19558
1467,p1101,20100318,6758,6760,6762,6768,6696,6714,6726,-46,-34,7128,47943.81,20568
1468,p1101,20100319,6714,6726,6706,6758,6706,6754,6740,28,14,5088,34296.82,21432
1469,p1101,20100322,6754,6740,6742,6800,6740,6772,6774,32,34,6066,41095.46,21824
1470,p1101,20100323,6772,6774,6806,6818,6776,6792,6798,18,24,12326,83815.28,24576
1471,p1101,20100324,6792,6798,6800,6800,6738,6768,6772,-30,-26,8236,55775.02,23900
1472,p1101,20100325,6768,6772,6758,6812,6752,6788,6788,16,16,6852,46519.82,24022
1473,p1101,20100326,6788,6788,6780,6780,6734,6756,6756,-32,-32,5794,39149.13,24970
1474,p1101,20100329,6756,6756,6784,6784,6740,6774,6758,18,2,13638,92183.09,25484
1475,p1101,20100330,6774,6758,6792,6836,6680,6798,6752,40,-6,36290,245092.1,23844
1476,p1101,20100331,6798,6752,6788,6814,6754,6760,6786,8,34,14684,99666.66,25452
1477,p1101,20100401,6760,6786,6740,6786,6706,6750,6742,-36,-44,10456,70498.72,25720
1478,p1101,20100402,6750,6742,6770,6784,6760,6780,6770,38,28,5820,39411.87,25482
1479,p1101,20100406,6780,6770,6770,6796,6760,6776,6780,6,10,8354,56645.41,27060
1480,p1101,20100407,6776,6780,6796,6894,6796,6878,6864,98,84,24648,169204.17,29630
1481,p1101,20100408,6878,6864,6866,6926,6862,6866,6896,2,32,25102,173140.77,30626
1482,p1101,20100409,6866,6896,6888,6912,6866,6910,6896,14,0,22848,157579.95,35594
1483,p1101,20100412,6910,6896,6948,6970,6908,6940,6944,44,48,39652,275346.32,44808
1484,p1101,20100413,6940,6944,6920,6920,6844,6894,6886,-50,-58,33888,233363.39,49774
1485,p1101,20100414,6894,6886,6920,6944,6896,6916,6922,30,36,38838,268896.53,50958
1486,p1101,20100415,6916,6922,6930,6940,6902,6914,6922,-8,0,61694,427144.02,67774
1487,p1101,20100416,6914,6922,6938,6956,6910,6950,6936,28,14,56426,391385.02,74176
1488,p1101,20100419,6950,6936,6928,6928,6826,6830,6868,-106,-68,60804,417621.32,76140
1489,p1101,20100420,6830,6868,6864,6898,6858,6880,6880,12,12,77454,533022.68,86402
1490,p1101,20100421,6880,6880,6884,6944,6866,6930,6920,50,40,153192,1060305.39,104794
1491,p1101,20100422,6930,6920,6916,6940,6896,6918,6920,-2,0,111366,770741.14,107340
1492,p1101,20100423,6918,6920,6930,7020,6924,7002,6994,82,74,251800,1761093.41,126100
1493,p1101,20100426,7002,6994,7044,7068,7014,7028,7036,34,42,242204,1704447.82,133382
1494,p1101,20100427,7028,7036,7006,7078,6986,7062,7036,26,0,336880,2370619.94,153850
1495,p1101,20100428,7062,7036,6992,7026,6934,6966,6986,-70,-50,351232,2453991.7,167948
1496,p1101,20100429,6966,6986,6946,6976,6916,6916,6940,-70,-46,251504,1745662.22,173908
1497,p1101,20100430,6916,6940,6936,6958,6886,6950,6924,10,-16,192888,1335886.91,169298
1498,p1101,20100504,6950,6924,6930,6942,6896,6910,6918,-14,-6,150550,1041552.97,175340
1499,p1101,20100505,6910,6918,6866,6930,6848,6924,6900,6,-18,198134,1367125.27,174306
1500,p1101,20100506,6924,6900,6938,6944,6856,6862,6904,-38,4,222380,1535377.96,185280
1501,p1101,20100507,6862,6904,6820,6820,6702,6704,6738,-200,-166,281486,1896778.27,176634
1502,p1101,20100510,6704,6738,6770,6806,6750,6800,6772,62,34,186498,1263163.98,175374
1503,p1101,20100511,6800,6772,6788,6800,6736,6744,6764,-28,-8,180538,1221517.18,184418
1504,p1101,20100512,6744,6764,6760,6810,6752,6778,6784,14,20,150800,1023203.09,172720
1505,p1101,20100513,6778,6784,6788,6792,6678,6734,6722,-50,-62,351938,2366209.7,197800
1506,p1101,20100514,6734,6722,6700,6728,6650,6656,6690,-66,-32,238106,1593107.33,211834
1507,p1101,20100517,6656,6690,6600,6630,6468,6504,6534,-186,-156,318098,2078599.46,208854
1508,p1101,20100518,6504,6534,6520,6602,6488,6590,6556,56,22,224778,1473984.01,192152
1509,p1101,20100519,6590,6556,6538,6614,6520,6570,6572,14,16,166954,1097420.84,193458
1510,p1101,20100520,6570,6572,6610,6680,6610,6630,6646,58,74,229444,1525323.99,186232
1511,p1101,20100521,6630,6646,6612,6690,6592,6686,6646,40,0,226228,1503824.64,189766
1512,p1101,20100524,6686,6646,6670,6698,6660,6686,6678,40,32,160074,1069229.26,192098
1513,p1101,20100525,6686,6678,6670,6672,6598,6604,6630,-74,-48,174476,1156779.13,201464
1514,p1101,20100526,6604,6630,6628,6650,6570,6646,6618,16,-12,207376,1372660.46,198828
1515,p1101,20100527,6646,6618,6660,6668,6628,6666,6644,48,26,152232,1011606.15,190052
1516,p1101,20100528,6666,6644,6696,6698,6644,6666,6670,22,26,109560,730968.64,186062
1517,p1101,20100531,6666,6670,6640,6640,6578,6584,6604,-86,-66,144520,954496.36,194780
1518,p1101,20100601,6584,6604,6582,6634,6550,6576,6588,-28,-16,179462,1182484.16,197784
1519,p1101,20100602,6576,6588,6576,6630,6560,6630,6598,42,10,153340,1011832.7,196058
1520,p1101,20100603,6630,6598,6634,6640,6580,6610,6608,12,10,157660,1042105.42,199752
1521,p1101,20100604,6610,6608,6612,6654,6602,6630,6630,22,22,136752,906786.42,197410
1522,p1101,20100607,6630,6630,6506,6506,6412,6442,6452,-188,-178,231388,1492957.82,215636
1523,p1101,20100608,6442,6452,6452,6462,6430,6448,6446,-4,-6,108440,699212.12,206920
1524,p1101,20100609,6448,6446,6448,6454,6320,6408,6378,-38,-68,368822,2353032.61,198508
1525,p1101,20100610,6408,6378,6398,6420,6362,6362,6392,-16,14,204852,1309579.4,198894
1526,p1101,20100611,6362,6392,6380,6404,6350,6362,6376,-30,-16,140584,896571.56,200028
1527,p1101,20100617,6362,6376,6450,6456,6402,6410,6426,34,50,127908,821958.71,197098
1528,p1101,20100618,6410,6426,6412,6448,6412,6432,6434,6,8,91582,589248.72,191910
1529,p1101,20100621,6432,6434,6450,6534,6450,6518,6496,84,62,140140,910415.52,188058
1530,p1101,20100622,6518,6496,6492,6506,6476,6492,6486,-4,-10,67516,438025.86,185882
1531,p1101,20100623,6492,6486,6460,6498,6436,6496,6472,10,-14,99350,643068.29,182302
1532,p1101,20100624,6496,6472,6496,6522,6478,6502,6502,30,30,126994,825880.46,184720
1533,p1101,20100625,6502,6502,6474,6512,6474,6494,6492,-8,-10,110612,718247.22,184888
1534,p1101,20100628,6494,6492,6496,6540,6472,6474,6508,-18,16,138942,904467.95,194652
1535,p1101,20100629,6474,6508,6460,6472,6368,6388,6414,-120,-94,170608,1094328.76,213128
1536,p1101,20100630,6388,6414,6330,6352,6308,6336,6330,-78,-84,116036,734645.27,226396
1537,p1101,20100701,6336,6330,6328,6358,6270,6284,6328,-46,-2,98246,621786.65,226896
1538,p1101,20100702,6284,6328,6272,6312,6232,6292,6272,-36,-56,180388,1131411.79,230718
1539,p1101,20100705,6292,6272,6284,6292,6252,6256,6272,-16,0,104640,656474.7,230036
1540,p1101,20100706,6256,6272,6188,6232,6152,6220,6196,-52,-76,230026,1425514.11,238228
1541,p1101,20100707,6220,6196,6226,6232,6194,6220,6212,24,16,113232,703481.5,235176
1542,p1101,20100708,6220,6212,6312,6312,6272,6284,6286,72,74,121204,762004.2,217078
1543,p1101,20100709,6284,6286,6300,6352,6284,6344,6316,58,30,118472,748422.48,202092
1544,p1101,20100712,6344,6316,6378,6378,6312,6324,6344,8,28,92658,587856.86,196800
1545,p1101,20100713,6324,6344,6346,6398,6316,6348,6354,4,10,219290,1393663.83,201818
1546,p1101,20100714,6348,6354,6380,6410,6376,6406,6394,52,40,194362,1242831.4,214072
1547,p1101,20100715,6406,6394,6412,6426,6386,6398,6408,4,14,153356,982747.54,210402
1548,p1101,20100716,6398,6408,6460,6544,6454,6538,6502,130,94,252244,1640395.33,223160
1549,p1101,20100719,6538,6502,6520,6538,6504,6536,6516,34,14,121930,794680.32,219458
1550,p1101,20100720,6536,6516,6518,6538,6478,6526,6506,10,-10,179894,1170648.2,217634
1551,p1101,20100721,6526,6506,6546,6554,6506,6516,6526,10,20,121618,793899.48,206068
1552,p1101,20100722,6516,6526,6500,6612,6500,6594,6568,68,42,223734,1469561.49,224458
1553,p1101,20100723,6594,6568,6636,6642,6608,6628,6626,60,58,157178,1041504.65,221572
1554,p1101,20100726,6628,6626,6600,6696,6600,6674,6666,48,40,186174,1241335.3,233090
1555,p1101,20100727,6674,6666,6654,6660,6556,6566,6592,-100,-74,227402,1499125.43,217908
1556,p1101,20100728,6566,6592,6582,6628,6570,6624,6608,32,16,121330,801832.28,210274
1557,p1101,20100729,6624,6608,6660,6748,6640,6720,6708,112,100,273924,1837883.98,232622
1558,p1101,20100730,6720,6708,6744,6788,6728,6740,6758,32,50,211170,1427273.7,236766
1559,p1101,20100802,6740,6758,6800,6946,6800,6910,6886,152,128,259290,1785591.65,246036
1560,p1101,20100803,6910,6886,6930,6948,6864,6900,6914,14,28,284814,1969242.21,240496
1561,p1101,20100804,6900,6914,6978,6978,6916,6940,6948,26,34,274154,1904828.26,249102
1562,p1101,20100805,6940,6948,7000,7024,6854,6858,6914,-90,-34,315382,2180681.59,246506
1563,p1101,20100806,6858,6914,6890,7068,6872,7058,6966,144,52,566646,3947737.61,291704
1564,p1101,20100809,7058,6966,7058,7220,7026,7184,7128,218,162,655522,4673414.42,258168
1565,p1101,20100810,7184,7128,7142,7170,7062,7084,7106,-44,-22,402010,2856814.93,238270
1566,p1101,20100811,7084,7106,7094,7136,7044,7056,7096,-50,-10,302568,2147495.21,216552
1567,p1101,20100812,7056,7096,7046,7130,7014,7070,7080,-26,-16,316612,2241785,215928
1568,p1101,20100813,7070,7080,7090,7248,7086,7234,7166,154,86,301338,2159924.52,210902
1569,p1101,20100816,7234,7166,7280,7378,7266,7290,7324,124,158,406428,2976908.54,225318
1570,p1101,20100817,7290,7324,7250,7268,7208,7266,7242,-58,-82,306798,2222205.48,226466
1571,p1101,20100818,7266,7242,7298,7322,7144,7176,7220,-66,-22,412662,2979562.46,230440
1572,p1101,20100819,7176,7220,7178,7200,7102,7188,7162,-32,-58,331236,2372553.16,237258
1573,p1101,20100820,7188,7162,7060,7082,6942,6958,7032,-204,-130,256308,1802726.87,213178
1574,p1101,20100823,6958,7032,6988,7026,6948,6978,6990,-54,-42,220246,1539910.52,206010
1575,p1101,20100824,6978,6990,6950,7020,6930,6950,6984,-40,-6,171650,1198880.96,202634
1576,p1101,20100825,6950,6984,6974,6996,6874,6898,6936,-86,-48,160404,1112722.43,202044
1577,p1101,20100826,6898,6936,6916,6964,6902,6958,6928,22,-8,138504,959817.98,198084
1578,p1101,20100827,6958,6928,6980,7034,6976,7020,7006,92,78,128556,900714.77,184524
1579,p1101,20100830,7020,7006,7100,7130,7068,7110,7104,104,98,91604,650829.39,165328
1580,p1101,20100831,7110,7104,7056,7056,6962,6964,6990,-140,-114,62258,435297.21,161432
1581,p1101,20100901,6964,6990,6944,7034,6934,6962,6986,-28,-4,73062,510449.24,154266
1582,p1101,20100902,6962,6986,6992,7026,6974,7022,7002,36,16,57264,400987.34,146978
1583,p1101,20100903,7022,7002,7012,7120,7012,7110,7068,108,66,62678,443040.93,137614
1584,p1101,20100906,7110,7068,7156,7180,7130,7132,7150,64,82,42622,304807.76,133650
1585,p1101,20100907,7132,7150,7152,7214,7108,7214,7170,64,20,54316,389514.88,130226
1586,p1101,20100908,7214,7170,7230,7278,7184,7192,7226,22,56,37264,269286.96,122890
1587,p1101,20100909,7192,7226,7220,7242,6866,7098,7106,-128,-120,55908,397328.98,116538
1588,p1101,20100910,7098,7106,7130,7166,7098,7160,7136,54,30,23210,165662.32,111862
1589,p1101,20100913,7160,7136,7110,7222,7100,7216,7152,80,16,32986,235946.31,107884
1590,p1101,20100914,7216,7152,7204,7238,7140,7158,7190,6,38,31002,222950.99,103768
1591,p1101,20100915,7158,7190,7176,7204,7150,7170,7180,-20,-10,18522,133008.76,101354
1592,p1101,20100916,7170,7180,7142,7210,7100,7136,7148,-44,-32,19292,137932.34,98376
1593,p1101,20100917,7136,7148,7148,7162,7130,7142,7144,-6,-4,11832,84541.29,94866
1594,p1101,20100920,7142,7144,7242,7442,7242,7382,7374,238,230,33690,248448.72,84156
1595,p1101,20100921,7382,7374,7398,7398,7310,7388,7358,14,-16,17718,130397.39,79112
1596,p1101,20100927,7388,7358,7780,7796,7546,7598,7650,240,292,16442,125790.38,74634
1597,p1101,20100928,7598,7650,7590,7646,7536,7630,7588,-20,-62,8030,60933.17,72340
1598,p1101,20100929,7630,7588,7588,7588,7432,7506,7504,-82,-84,10172,76343.4,71548
1599,p1101,20100930,7506,7504,7504,7554,7450,7552,7504,48,0,7082,53147.66,68396
1600,p1101,20101008,7552,7504,7558,7694,7500,7590,7614,86,110,13648,103926.71,66288
1601,p1101,20101011,7590,7614,7994,7994,7994,7994,7992,380,378,2004,16018.84,65442
1602,p1101,20101012,7994,7992,8020,8160,7938,8020,8014,28,22,17968,144024.81,62284
1603,p1101,20101013,8020,8014,8100,8120,8020,8074,8068,60,54,12460,100533.76,58970
1604,p1101,20101014,8074,8068,8144,8226,8100,8194,8182,126,114,12872,105327.98,56052
1605,p1101,20101015,8194,8182,8216,8222,8144,8170,8180,-12,-2,14684,120129.52,47762
1606,p1101,20101018,8170,8180,8136,8136,7980,8018,8048,-162,-132,12648,101807.17,49004
1607,p1101,20101019,8018,8048,8080,8140,8038,8050,8082,2,34,16482,133234.2,44314
1608,p1101,20101020,8050,8082,8000,8054,7898,8020,8004,-62,-78,8624,69029.41,42968
1609,p1101,20101021,8020,8004,8218,8302,8130,8150,8216,146,212,14984,123111.78,33068
1610,p1101,20101022,8150,8216,8120,8206,8120,8180,8178,-36,-38,3428,28035.42,32378
1611,p1101,20101025,8180,8178,8220,8410,8220,8364,8336,186,158,7198,60003.42,29452
1612,p1101,20101026,8364,8336,8364,8366,8260,8316,8322,-20,-14,2546,21191.31,28092
1613,p1101,20101027,8316,8322,8376,8402,8110,8164,8260,-158,-62,4020,33207.42,27356
1614,p1101,20101028,8164,8260,8258,8300,8230,8300,8274,40,14,1850,15308.09,26812
1615,p1101,20101029,8300,8274,8280,8280,8170,8198,8240,-76,-34,3616,29798.84,24654
1616,p1101,20101101,8198,8240,8280,8306,8224,8280,8292,40,52,2252,18676,23322
1617,p1101,20101102,8280,8292,8298,8348,8260,8288,8302,-4,10,2178,18085.5,21816
1618,p1101,20101103,8288,8302,8290,8326,8250,8268,8296,-34,-6,1538,12761.76,21408
1619,p1101,20101104,8268,8296,8316,8558,8294,8542,8406,246,110,3504,29458.58,18948
1620,p1101,20101105,8542,8406,8696,8826,8680,8826,8782,420,376,1494,13121.96,17812
1621,p1101,20101108,8826,8782,8828,9160,8766,9018,9000,236,218,2608,23473.82,16908
1622,p1101,20101109,9018,9000,8988,9260,8988,9202,9186,202,186,5728,52620.09,12200
1623,p1101,20101110,9202,9186,9412,9588,9250,9252,9312,66,126,3394,31606.27,10880
1624,p1101,20101111,9252,9312,9350,9390,9270,9302,9340,-10,28,2512,23465.32,9516
1625,p1101,20101112,9302,9340,9400,9400,8876,8920,9096,-420,-244,2292,20851.91,9264
1626,p1101,20101115,8920,9096,8934,9100,8710,8880,8964,-216,-132,734,6580.03,8936
1627,p1101,20101116,8880,8964,8904,9044,8896,8900,8948,-64,-16,626,5602.43,8890
1628,p1101,20101117,8900,8948,8502,8720,8502,8502,8582,-446,-366,946,8119.08,8756
1629,p1101,20101118,8502,8582,8680,9000,8480,8680,8650,98,68,1590,13756.08,7580
1630,p1101,20101119,8680,8650,8726,8810,8624,8810,8740,160,90,888,7762.78,7448
1631,p1101,20101122,8810,8740,8738,8738,8610,8610,8648,-130,-92,818,7075.52,7078
1632,p1101,20101123,8610,8648,8648,8650,8510,8530,8618,-118,-30,1864,16066.14,5564
1633,p1101,20101124,8530,8618,8610,8760,8590,8760,8692,142,74,756,6572.18,4980
1634,p1101,20101125,8760,8692,8846,8880,8806,8806,8846,114,154,572,5060.42,4632
1635,p1101,20101126,8806,8846,8802,8810,8710,8710,8778,-136,-68,310,2721.79,4424
1636,p1101,20101129,8710,8778,8710,8858,8710,8858,8790,80,12,404,3551.8,4068
1637,p1101,20101130,8858,8790,8852,8978,8800,8978,8866,188,76,112,993.05,4048
1638,p1101,20101201,8978,8866,9028,9108,8986,9108,9076,242,210,258,2341.68,3934
1639,p1101,20101202,9108,9076,9298,9298,9236,9256,9258,180,182,804,7444.18,3912
1640,p1101,20101203,9256,9258,9228,9266,9222,9258,9254,0,-4,396,3664.84,3828
1641,p1101,20101206,9258,9254,9286,9334,9260,9320,9304,66,50,578,5378.28,3666
1642,p1101,20101207,9320,9304,9312,9350,9280,9350,9320,46,16,894,8332.1,3086
1643,p1101,20101208,9350,9320,9282,9296,9212,9218,9256,-102,-64,176,1629.17,2938
1644,p1101,20101209,9218,9256,9280,9350,9252,9252,9308,-4,52,102,949.46,2904
1645,p1101,20101210,9252,9308,9320,9320,9260,9292,9286,-16,-22,366,3398.92,2768
1646,p1101,20101213,9292,9286,9322,9430,9322,9400,9376,114,90,628,5889.28,2452
1647,p1101,20101214,9400,9376,9450,9450,9406,9442,9440,66,64,60,566.41,2456
1648,p1101,20101215,9442,9440,9438,9488,9380,9380,9442,-60,2,52,491.02,2450
1649,p1101,20101216,9380,9442,9530,9530,9392,9392,9438,-50,-4,10,94.4,2448
1650,p1101,20101217,9392,9438,9392,9406,9340,9340,9372,-98,-66,102,956.14,2446
1651,p1101,20101220,9340,9372,9390,9430,9300,9300,9362,-72,-10,1220,11421.98,1440
1652,p1101,20101221,9300,9362,9330,9360,9300,9346,9310,-16,-52,272,2532.56,1450
1653,p1101,20101222,9346,9310,9396,9468,9380,9468,9406,158,96,28,263.38,1428
1654,p1101,20101223,9468,9406,9498,9750,9452,9750,9570,344,164,10,95.71,1424
1655,p1101,20101224,9750,9570,9748,9748,9590,9688,9638,118,68,42,404.86,1416
1656,p1101,20101227,9688,9638,9730,9730,9640,9640,9672,2,34,28,270.84,1410
1657,p1101,20101228,9640,9672,9950,9950,9950,9950,9950,278,278,2,19.9,1410
1658,p1101,20101229,9950,9950,9898,9898,9690,9690,9884,-260,-66,564,5575.49,870
1659,p1101,20101230,9690,9884,9882,9976,9882,9910,9908,26,24,80,792.72,866
1660,p1101,20101231,9910,9908,9882,10000,9882,9980,9968,72,60,30,299.09,866
1661,p1102,20100222,,6830,0,0,0,6830,6830,0,0,0,0,0
1662,p1102,20100223,6830,6830,0,0,0,6830,6830,0,0,0,0,0
1663,p1102,20100224,6830,6830,0,0,0,6830,6830,0,0,0,0,0
1664,p1102,20100225,6830,6830,0,0,0,6830,6830,0,0,0,0,0
1665,p1102,20100226,6830,6830,0,0,0,6830,6830,0,0,0,0,0
1666,p1102,20100301,6830,6830,0,0,0,6830,6830,0,0,0,0,0
1667,p1102,20100302,6830,6830,0,0,0,6830,6830,0,0,0,0,0
1668,p1102,20100303,6830,6830,7048,7048,6886,6886,6966,56,136,4,27.87,0
1669,p1102,20100304,6886,6966,0,0,0,6966,6966,0,0,0,0,0
1670,p1102,20100305,6966,6966,6732,6732,6732,6732,6732,-234,-234,2,13.46,2
1671,p1102,20100308,6732,6732,7020,7020,7020,7020,7020,288,288,2,14.04,2
1672,p1102,20100309,7020,7020,0,0,0,7020,7020,0,0,0,0,2
1673,p1102,20100310,7020,7020,7078,7078,7078,7078,7078,58,58,2,14.16,2
1674,p1102,20100311,7078,7078,0,0,0,7078,7078,0,0,0,0,2
1675,p1102,20100312,7078,7078,0,0,0,7078,7078,0,0,0,0,2
1676,p1102,20100315,7078,7078,0,0,0,7078,7078,0,0,0,0,2
1677,p1102,20100316,7078,7078,0,0,0,7078,7078,0,0,0,0,2
1678,p1102,20100317,7078,7078,0,0,0,7078,7078,0,0,0,0,2
1679,p1102,20100318,7078,7078,0,0,0,7078,7078,0,0,0,0,2
1680,p1102,20100319,7078,7078,6732,7032,6730,6900,6794,-178,-284,24,163.09,14
1681,p1102,20100322,6900,6794,6930,6930,6874,6874,6910,80,116,20,138.23,6
1682,p1102,20100323,6874,6910,6940,6940,6940,6940,6940,30,30,2,13.88,6
1683,p1102,20100324,6940,6940,0,0,0,6940,6940,0,0,0,0,6
1684,p1102,20100325,6940,6940,0,0,0,6940,6940,0,0,0,0,6
1685,p1102,20100326,6940,6940,6854,6860,6848,6860,6854,-80,-86,8,54.83,0
1686,p1102,20100329,6860,6854,0,0,0,6854,6854,0,0,0,0,0
1687,p1102,20100330,6854,6854,0,0,0,6854,6854,0,0,0,0,0
1688,p1102,20100331,6854,6854,0,0,0,6854,6854,0,0,0,0,0
1689,p1102,20100401,6854,6854,0,0,0,6854,6854,0,0,0,0,0
1690,p1102,20100402,6854,6854,0,0,0,6854,6854,0,0,0,0,0
1691,p1102,20100406,6854,6854,0,0,0,6854,6854,0,0,0,0,0
1692,p1102,20100407,6854,6854,0,0,0,6854,6854,0,0,0,0,0
1693,p1102,20100408,6854,6854,0,0,0,6854,6854,0,0,0,0,0
1694,p1102,20100409,6854,6854,0,0,0,6854,6854,0,0,0,0,0
1695,p1102,20100412,6854,6854,0,0,0,6854,6854,0,0,0,0,0
1696,p1102,20100413,6854,6854,0,0,0,6854,6854,0,0,0,0,0
1697,p1102,20100414,6854,6854,0,0,0,6854,6854,0,0,0,0,0
1698,p1102,20100415,6854,6854,0,0,0,6854,6854,0,0,0,0,0
1699,p1102,20100416,6854,6854,0,0,0,6854,6854,0,0,0,0,0
1700,p1102,20100419,6854,6854,0,0,0,6854,6854,0,0,0,0,0
1701,p1102,20100420,6854,6854,0,0,0,6854,6854,0,0,0,0,0
1702,p1102,20100421,6854,6854,0,0,0,6854,6854,0,0,0,0,0
1703,p1102,20100422,6854,6854,0,0,0,6854,6854,0,0,0,0,0
1704,p1102,20100423,6854,6854,7190,7190,7190,7190,7190,336,336,4,28.76,4
1705,p1102,20100426,7190,7190,0,0,0,7190,7190,0,0,0,0,4
1706,p1102,20100427,7190,7190,6984,7230,6984,7230,7090,40,-100,8,56.72,4
1707,p1102,20100428,7230,7090,0,0,0,7090,7090,0,0,0,0,4
1708,p1102,20100429,7090,7090,7098,7098,6952,7028,7026,-62,-64,10,70.26,4
1709,p1102,20100430,7028,7026,6872,6998,6872,6970,6940,-56,-86,46,319.28,4
1710,p1102,20100504,6970,6940,0,0,0,6940,6940,0,0,0,0,4
1711,p1102,20100505,6940,6940,0,0,0,6940,6940,0,0,0,0,4
1712,p1102,20100506,6940,6940,0,0,0,6940,6940,0,0,0,0,4
1713,p1102,20100507,6940,6940,6800,6876,6792,6792,6822,-148,-118,6,40.94,6
1714,p1102,20100510,6792,6822,0,0,0,6822,6822,0,0,0,0,6
1715,p1102,20100511,6822,6822,6850,6850,6752,6766,6790,-56,-32,12,81.48,6
1716,p1102,20100512,6766,6790,0,0,0,6790,6790,0,0,0,0,6
1717,p1102,20100513,6790,6790,0,0,0,6790,6790,0,0,0,0,6
1718,p1102,20100514,6790,6790,0,0,0,6790,6790,0,0,0,0,6
1719,p1102,20100517,6790,6790,6600,6628,6574,6628,6600,-162,-190,6,39.6,8
1720,p1102,20100518,6628,6600,6610,6650,6600,6650,6616,50,16,14,92.64,6
1721,p1102,20100519,6650,6616,6700,6700,6700,6700,6700,84,84,2,13.4,6
1722,p1102,20100520,6700,6700,6644,6782,6644,6702,6732,2,32,52,350.1,24
1723,p1102,20100521,6702,6732,0,0,0,6732,6732,0,0,0,0,24
1724,p1102,20100524,6732,6732,0,0,0,6732,6732,0,0,0,0,24
1725,p1102,20100525,6732,6732,0,0,0,6732,6732,0,0,0,0,24
1726,p1102,20100526,6732,6732,0,0,0,6732,6732,0,0,0,0,24
1727,p1102,20100527,6732,6732,6778,6778,6778,6778,6778,46,46,2,13.56,22
1728,p1102,20100528,6778,6778,6792,6792,6792,6792,6792,14,14,2,13.58,20
1729,p1102,20100531,6792,6792,6668,6668,6586,6586,6612,-206,-180,6,39.68,18
1730,p1102,20100601,6586,6612,0,0,0,6612,6612,0,0,0,0,18
1731,p1102,20100602,6612,6612,6580,6700,6578,6628,6636,16,24,56,371.62,24
1732,p1102,20100603,6628,6636,0,0,0,6636,6636,0,0,0,0,24
1733,p1102,20100604,6636,6636,0,0,0,6636,6636,0,0,0,0,24
1734,p1102,20100607,6636,6636,6568,6568,6568,6568,6568,-68,-68,4,26.27,20
1735,p1102,20100608,6568,6568,6560,6560,6560,6560,6560,-8,-8,2,13.12,20
1736,p1102,20100609,6560,6560,0,0,0,6560,6560,0,0,0,0,20
1737,p1102,20100610,6560,6560,6438,6518,6400,6450,6468,-110,-92,28,181.1,12
1738,p1102,20100611,6450,6468,6376,6450,6376,6450,6412,-18,-56,4,25.65,12
1739,p1102,20100617,6450,6412,0,0,0,6412,6412,0,0,0,0,12
1740,p1102,20100618,6412,6412,0,0,0,6412,6412,0,0,0,0,12
1741,p1102,20100621,6412,6412,0,0,0,6412,6412,0,0,0,0,12
1742,p1102,20100622,6412,6412,6486,6628,6486,6570,6560,158,148,6,39.37,12
1743,p1102,20100623,6570,6560,0,0,0,6560,6560,0,0,0,0,12
1744,p1102,20100624,6560,6560,6534,6630,6534,6560,6574,0,14,6,39.45,12
1745,p1102,20100625,6560,6574,0,0,0,6574,6574,0,0,0,0,12
1746,p1102,20100628,6574,6574,0,0,0,6574,6574,0,0,0,0,12
1747,p1102,20100629,6574,6574,6498,6498,6498,6498,6498,-76,-76,2,13,12
1748,p1102,20100630,6498,6498,0,0,0,6498,6498,0,0,0,0,12
1749,p1102,20100701,6498,6498,6352,6400,6350,6350,6370,-148,-128,10,63.71,12
1750,p1102,20100702,6350,6370,6358,6370,6266,6370,6328,0,-42,8,50.63,12
1751,p1102,20100705,6370,6328,0,0,0,6328,6328,0,0,0,0,12
1752,p1102,20100706,6328,6328,0,0,0,6328,6328,0,0,0,0,12
1753,p1102,20100707,6328,6328,6340,6340,6208,6280,6290,-48,-38,8,50.33,12
1754,p1102,20100708,6280,6290,0,0,0,6290,6290,0,0,0,0,12
1755,p1102,20100709,6290,6290,0,0,0,6290,6290,0,0,0,0,12
1756,p1102,20100712,6290,6290,0,0,0,6290,6290,0,0,0,0,12
1757,p1102,20100713,6290,6290,0,0,0,6290,6290,0,0,0,0,12
1758,p1102,20100714,6290,6290,0,0,0,6290,6290,0,0,0,0,12
1759,p1102,20100715,6290,6290,0,0,0,6290,6290,0,0,0,0,12
1760,p1102,20100716,6290,6290,6520,6600,6520,6600,6566,310,276,6,39.4,14
1761,p1102,20100719,6600,6566,6642,6642,6642,6642,6642,76,76,2,13.28,12
1762,p1102,20100720,6642,6642,0,0,0,6642,6642,0,0,0,0,12
1763,p1102,20100721,6642,6642,0,0,0,6642,6642,0,0,0,0,12
1764,p1102,20100722,6642,6642,0,0,0,6642,6642,0,0,0,0,12
1765,p1102,20100723,6642,6642,6642,6752,6642,6752,6698,110,56,6,40.19,12
1766,p1102,20100726,6752,6698,0,0,0,6698,6698,0,0,0,0,12
1767,p1102,20100727,6698,6698,0,0,0,6698,6698,0,0,0,0,12
1768,p1102,20100728,6698,6698,6608,6700,6608,6700,6652,2,-46,6,39.91,12
1769,p1102,20100729,6700,6652,6840,6840,6722,6722,6780,70,128,36,244.12,10
1770,p1102,20100730,6722,6780,6868,6868,6830,6830,6852,50,72,10,68.53,14
1771,p1102,20100802,6830,6852,6870,7010,6870,6960,6932,108,80,16,110.91,8
1772,p1102,20100803,6960,6932,6970,7028,6970,7000,6992,68,60,8,55.95,8
1773,p1102,20100804,7000,6992,0,0,0,6992,6992,0,0,0,0,8
1774,p1102,20100805,6992,6992,6882,6950,6882,6950,6924,-42,-68,10,69.24,12
1775,p1102,20100806,6950,6924,7026,7026,7026,7026,7026,102,102,4,28.1,8
1776,p1102,20100809,7026,7026,7204,7312,7156,7292,7232,266,206,64,462.94,22
1777,p1102,20100810,7292,7232,7186,7242,7110,7242,7204,10,-28,30,216.12,46
1778,p1102,20100811,7242,7204,7102,7208,7102,7208,7150,4,-54,98,700.72,52
1779,p1102,20100812,7208,7150,0,0,0,7150,7150,0,0,0,0,52
1780,p1102,20100813,7150,7150,7188,7188,7188,7188,7188,38,38,6,43.13,52
1781,p1102,20100816,7188,7188,7444,7450,7376,7376,7428,188,240,8,59.43,50
1782,p1102,20100817,7376,7428,7364,7364,7364,7364,7364,-64,-64,2,14.73,50
1783,p1102,20100818,7364,7364,0,0,0,7364,7364,0,0,0,0,50
1784,p1102,20100819,7364,7364,7220,7220,7220,7220,7220,-144,-144,6,43.32,44
1785,p1102,20100820,7220,7220,7164,7164,7090,7104,7118,-116,-102,6,42.72,40
1786,p1102,20100823,7104,7118,0,0,0,7118,7118,0,0,0,0,40
1787,p1102,20100824,7118,7118,7142,7142,7022,7056,7066,-62,-52,8,56.53,38
1788,p1102,20100825,7056,7066,0,0,0,7066,7066,0,0,0,0,38
1789,p1102,20100826,7066,7066,0,0,0,7066,7066,0,0,0,0,38
1790,p1102,20100827,7066,7066,7142,7142,7130,7132,7134,66,68,10,71.35,40
1791,p1102,20100830,7132,7134,7222,7222,7222,7222,7222,88,88,2,14.44,38
1792,p1102,20100831,7222,7222,0,0,0,7222,7222,0,0,0,0,38
1793,p1102,20100901,7222,7222,0,0,0,7222,7222,0,0,0,0,38
1794,p1102,20100902,7222,7222,7140,7140,7046,7062,7090,-160,-132,30,212.71,38
1795,p1102,20100903,7062,7090,7246,7246,7046,7150,7150,60,60,22,157.33,38
1796,p1102,20100906,7150,7150,7278,7278,7278,7278,7278,128,128,6,43.67,36
1797,p1102,20100907,7278,7278,0,0,0,7278,7278,0,0,0,0,36
1798,p1102,20100908,7278,7278,0,0,0,7278,7278,0,0,0,0,36
1799,p1102,20100909,7278,7278,7210,7210,7164,7164,7182,-114,-96,8,57.46,38
1800,p1102,20100910,7164,7182,0,0,0,7182,7182,0,0,0,0,38
1801,p1102,20100913,7182,7182,7222,7222,7222,7222,7222,40,40,6,43.33,32
1802,p1102,20100914,7222,7222,7222,7410,7222,7236,7280,14,58,12,87.37,32
1803,p1102,20100915,7236,7280,0,0,0,7280,7280,0,0,0,0,32
1804,p1102,20100916,7280,7280,0,0,0,7280,7280,0,0,0,0,32
1805,p1102,20100917,7280,7280,0,0,0,7280,7280,0,0,0,0,32
1806,p1102,20100920,7280,7280,7490,7490,7490,7490,7490,210,210,6,44.94,26
1807,p1102,20100921,7490,7490,7588,7588,7588,7588,7588,98,98,2,15.18,28
1808,p1102,20100927,7588,7588,7778,7778,7778,7778,7778,190,190,2,15.56,26
1809,p1102,20100928,7778,7778,0,0,0,7778,7778,0,0,0,0,26
1810,p1102,20100929,7778,7778,0,0,0,7778,7778,0,0,0,0,26
1811,p1102,20100930,7778,7778,0,0,0,7778,7778,0,0,0,0,26
1812,p1102,20101008,7778,7778,0,0,0,7778,7778,0,0,0,0,26
1813,p1102,20101011,7778,7778,8166,8166,8166,8166,8166,388,388,2,16.33,26
1814,p1102,20101012,8166,8166,0,0,0,8166,8166,0,0,0,0,26
1815,p1102,20101013,8166,8166,0,0,0,8166,8166,0,0,0,0,26
1816,p1102,20101014,8166,8166,8284,8284,8284,8284,8284,118,118,6,49.7,24
1817,p1102,20101015,8284,8284,0,0,0,8284,8284,0,0,0,0,24
1818,p1102,20101018,8284,8284,0,0,0,8284,8284,0,0,0,0,24
1819,p1102,20101019,8284,8284,0,0,0,8284,8284,0,0,0,0,24
1820,p1102,20101020,8284,8284,0,0,0,8284,8284,0,0,0,0,24
1821,p1102,20101021,8284,8284,0,0,0,8284,8284,0,0,0,0,24
1822,p1102,20101022,8284,8284,8322,8322,8312,8312,8316,28,32,8,66.53,22
1823,p1102,20101025,8312,8316,0,0,0,8316,8316,0,0,0,0,22
1824,p1102,20101026,8316,8316,0,0,0,8316,8316,0,0,0,0,22
1825,p1102,20101027,8316,8316,8354,8446,8354,8446,8400,130,84,4,33.6,20
1826,p1102,20101028,8446,8400,0,0,0,8400,8400,0,0,0,0,20
1827,p1102,20101029,8400,8400,8816,8816,8166,8404,8468,4,68,18,152.44,22
1828,p1102,20101101,8404,8468,0,0,0,8468,8468,0,0,0,0,22
1829,p1102,20101102,8468,8468,0,0,0,8468,8468,0,0,0,0,22
1830,p1102,20101103,8468,8468,0,0,0,8468,8468,0,0,0,0,22
1831,p1102,20101104,8468,8468,0,0,0,8468,8468,0,0,0,0,22
1832,p1102,20101105,8468,8468,8890,8890,8890,8890,8890,422,422,2,17.78,22
1833,p1102,20101108,8890,8890,9098,9324,8912,9324,9036,434,146,34,307.24,30
1834,p1102,20101109,9324,9036,9478,9478,9158,9384,9310,348,274,30,279.33,28
1835,p1102,20101110,9384,9310,9656,9656,9474,9568,9632,258,322,28,269.7,46
1836,p1102,20101111,9568,9632,0,0,0,9632,9632,0,0,0,0,46
1837,p1102,20101112,9632,9632,9152,9152,9152,9152,9152,-480,-480,6,54.91,42
1838,p1102,20101115,9152,9152,0,0,0,9152,9152,0,0,0,0,42
1839,p1102,20101116,9152,9152,0,0,0,9152,9152,0,0,0,0,42
1840,p1102,20101117,9152,9152,8696,8696,8696,8696,8696,-456,-456,2,17.39,42
1841,p1102,20101118,8696,8696,8560,8560,8292,8538,8464,-158,-232,10,84.65,42
1842,p1102,20101119,8538,8464,8766,8766,8156,8158,8432,-306,-32,22,185.54,54
1843,p1102,20101122,8158,8432,8600,8600,8600,8600,8600,168,168,2,17.2,54
1844,p1102,20101123,8600,8600,8392,8392,8392,8392,8392,-208,-208,4,33.57,54
1845,p1102,20101124,8392,8392,0,0,0,8392,8392,0,0,0,0,54
1846,p1102,20101125,8392,8392,8810,8810,8810,8810,8810,418,418,4,35.24,54
1847,p1102,20101126,8810,8810,9000,9226,8612,8612,8946,-198,136,6,53.68,54
1848,p1102,20101129,8612,8946,8502,8502,8502,8502,8502,-444,-444,2,17,54
1849,p1102,20101130,8502,8502,0,0,0,8502,8502,0,0,0,0,54
1850,p1102,20101201,8502,8502,9000,9012,9000,9012,9006,510,504,36,324.24,34
1851,p1102,20101202,9012,9006,0,0,0,9006,9006,0,0,0,0,34
1852,p1102,20101203,9006,9006,0,0,0,9006,9006,0,0,0,0,34
1853,p1102,20101206,9006,9006,0,0,0,9006,9006,0,0,0,0,34
1854,p1102,20101207,9006,9006,9390,9390,9390,9390,9390,384,384,2,18.78,34
1855,p1102,20101208,9390,9390,0,0,0,9390,9390,0,0,0,0,34
1856,p1102,20101209,9390,9390,9320,9320,9320,9320,9320,-70,-70,2,18.64,34
1857,p1102,20101210,9320,9320,0,0,0,9320,9320,0,0,0,0,34
1858,p1102,20101213,9320,9320,0,0,0,9320,9320,0,0,0,0,34
1859,p1102,20101214,9320,9320,0,0,0,9320,9320,0,0,0,0,34
1860,p1102,20101215,9320,9320,9630,9630,9564,9564,9614,244,294,14,134.62,26
1861,p1102,20101216,9564,9614,9602,9602,9602,9602,9602,-12,-12,2,19.2,24
1862,p1102,20101217,9602,9602,9550,9550,9550,9550,9550,-52,-52,2,19.1,24
1863,p1102,20101220,9550,9550,0,0,0,9550,9550,0,0,0,0,24
1864,p1102,20101221,9550,9550,9410,9410,9410,9410,9410,-140,-140,2,18.82,24
1865,p1102,20101222,9410,9410,0,0,0,9410,9410,0,0,0,0,24
1866,p1102,20101223,9410,9410,9580,9580,9580,9580,9570,170,160,6,57.42,24
1867,p1102,20101224,9580,9570,9680,9700,9680,9700,9690,130,120,4,38.76,22
1868,p1102,20101227,9700,9690,9770,9770,9770,9770,9770,80,80,2,19.54,22
1869,p1102,20101228,9770,9770,0,0,0,9770,9770,0,0,0,0,22
1870,p1102,20101229,9770,9770,9702,9702,9702,9702,9702,-68,-68,2,19.4,22
1871,p1102,20101230,9702,9702,0,0,0,9702,9702,0,0,0,0,22
1872,p1102,20101231,9702,9702,0,0,0,9702,9702,0,0,0,0,22
1873,p1103,20100315,,6854,0,0,0,6854,6854,0,0,0,0,0
1874,p1103,20100316,6854,6854,0,0,0,6854,6854,0,0,0,0,0
1875,p1103,20100317,6854,6854,0,0,0,6854,6854,0,0,0,0,0
1876,p1103,20100318,6854,6854,0,0,0,6854,6854,0,0,0,0,0
1877,p1103,20100319,6854,6854,7040,7040,7030,7030,7034,176,180,4,28.14,0
1878,p1103,20100322,7030,7034,7050,7050,6780,7022,6906,-12,-128,252,1740.36,4
1879,p1103,20100323,7022,6906,0,0,0,6906,6906,0,0,0,0,4
1880,p1103,20100324,6906,6906,0,0,0,6906,6906,0,0,0,0,4
1881,p1103,20100325,6906,6906,0,0,0,6906,6906,0,0,0,0,4
1882,p1103,20100326,6906,6906,0,0,0,6906,6906,0,0,0,0,4
1883,p1103,20100329,6906,6906,0,0,0,6906,6906,0,0,0,0,4
1884,p1103,20100330,6906,6906,6674,7050,6674,6960,6874,54,-32,112,770.07,8
1885,p1103,20100331,6960,6874,0,0,0,6874,6874,0,0,0,0,8
1886,p1103,20100401,6874,6874,0,0,0,6874,6874,0,0,0,0,8
1887,p1103,20100402,6874,6874,0,0,0,6874,6874,0,0,0,0,8
1888,p1103,20100406,6874,6874,0,0,0,6874,6874,0,0,0,0,8
1889,p1103,20100407,6874,6874,7000,7072,7000,7012,7052,138,178,38,268,14
1890,p1103,20100408,7012,7052,7020,7060,7010,7060,7030,8,-22,36,253.11,8
1891,p1103,20100409,7060,7030,0,0,0,7030,7030,0,0,0,0,8
1892,p1103,20100412,7030,7030,0,0,0,7030,7030,0,0,0,0,8
1893,p1103,20100413,7030,7030,7250,7250,7014,7116,7072,86,42,26,183.89,10
1894,p1103,20100414,7116,7072,0,0,0,7072,7072,0,0,0,0,10
1895,p1103,20100415,7072,7072,0,0,0,7072,7072,0,0,0,0,10
1896,p1103,20100416,7072,7072,0,0,0,7072,7072,0,0,0,0,10
1897,p1103,20100419,7072,7072,0,0,0,7072,7072,0,0,0,0,10
1898,p1103,20100420,7072,7072,7018,7018,7018,7018,7018,-54,-54,2,14.04,10
1899,p1103,20100421,7018,7018,7124,7124,7124,7124,7124,106,106,6,42.74,10
1900,p1103,20100422,7124,7124,0,0,0,7124,7124,0,0,0,0,10
1901,p1103,20100423,7124,7124,7136,7136,7136,7136,7136,12,12,2,14.27,8
1902,p1103,20100426,7136,7136,7040,7290,7040,7100,7132,-36,-4,8,57.06,8
1903,p1103,20100427,7100,7132,6998,7190,6998,7180,7138,48,6,16,114.24,6
1904,p1103,20100428,7180,7138,0,0,0,7138,7138,0,0,0,0,6
1905,p1103,20100429,7138,7138,7016,7050,7016,7050,7016,-88,-122,42,294.74,48
1906,p1103,20100430,7050,7016,7290,7290,6948,6990,7008,-26,-8,752,5270.65,684
1907,p1103,20100504,6990,7008,6952,6960,6946,6946,6950,-62,-58,324,2252.2,984
1908,p1103,20100505,6946,6950,6900,6956,6900,6956,6912,6,-38,60,414.74,1026
1909,p1103,20100506,6956,6912,6910,6916,6910,6916,6912,4,0,20,138.24,1028
1910,p1103,20100507,6916,6912,6802,6804,6732,6734,6740,-178,-172,166,1119.13,1170
1911,p1103,20100510,6734,6740,6800,6806,6792,6796,6796,56,56,24,163.12,1168
1912,p1103,20100511,6796,6796,6810,6810,6810,6810,6810,14,14,2,13.62,1168
1913,p1103,20100512,6810,6810,0,0,0,6810,6810,0,0,0,0,1168
1914,p1103,20100513,6810,6810,6762,6762,6750,6762,6760,-48,-50,14,94.64,1168
1915,p1103,20100514,6762,6760,0,0,0,6760,6760,0,0,0,0,1168
1916,p1103,20100517,6760,6760,6616,6630,6542,6626,6558,-134,-202,1006,6598.71,276
1917,p1103,20100518,6626,6558,6600,6800,6594,6662,6678,104,120,32,213.73,264
1918,p1103,20100519,6662,6678,0,0,0,6678,6678,0,0,0,0,264
1919,p1103,20100520,6678,6678,6700,6710,6700,6702,6704,24,26,12,80.45,264
1920,p1103,20100521,6702,6704,6788,6788,6650,6650,6718,-54,14,8,53.75,264
1921,p1103,20100524,6650,6718,6778,6778,6750,6750,6764,32,46,8,54.11,264
1922,p1103,20100525,6750,6764,6656,6656,6656,6656,6656,-108,-108,2,13.31,264
1923,p1103,20100526,6656,6656,6654,6654,6650,6650,6652,-6,-4,4,26.61,266
1924,p1103,20100527,6650,6652,6660,6730,6660,6722,6704,70,52,6,40.22,266
1925,p1103,20100528,6722,6704,6738,6738,6738,6738,6738,34,34,2,13.48,266
1926,p1103,20100531,6738,6738,6736,6736,6672,6700,6722,-38,-16,26,174.79,282
1927,p1103,20100601,6700,6722,6622,6636,6622,6636,6628,-86,-94,4,26.52,282
1928,p1103,20100602,6636,6628,6712,6712,6652,6652,6684,24,56,6,40.11,280
1929,p1103,20100603,6652,6684,0,0,0,6684,6666,0,-18,2,13.33,280
1930,p1103,20100604,6684,6666,0,0,0,6666,6666,0,0,0,0,280
1931,p1103,20100607,6666,6666,0,0,0,6666,6666,0,0,0,0,280
1932,p1103,20100608,6666,6666,6610,6610,6500,6584,6584,-82,-82,32,210.74,294
1933,p1103,20100609,6584,6584,6438,6438,6438,6438,6438,-146,-146,2,12.88,296
1934,p1103,20100610,6438,6438,6420,6516,6420,6450,6472,12,34,28,181.22,282
1935,p1103,20100611,6450,6472,6508,6508,6460,6460,6472,-12,0,8,51.78,282
1936,p1103,20100617,6460,6472,0,0,0,6472,6472,0,0,0,0,282
1937,p1103,20100618,6472,6472,6478,6500,6478,6500,6486,28,14,18,116.75,282
1938,p1103,20100621,6500,6486,6600,6600,6600,6600,6600,114,114,2,13.2,284
1939,p1103,20100622,6600,6600,0,0,0,6600,6600,0,0,0,0,284
1940,p1103,20100623,6600,6600,0,0,0,6600,6600,0,0,0,0,284
1941,p1103,20100624,6600,6600,0,0,0,6600,6600,0,0,0,0,284
1942,p1103,20100625,6600,6600,0,0,0,6600,6600,0,0,0,0,284
1943,p1103,20100628,6600,6600,0,0,0,6600,6600,0,0,0,0,284
1944,p1103,20100629,6600,6600,6550,6550,6504,6504,6544,-96,-56,164,1073.23,236
1945,p1103,20100630,6504,6544,6498,6498,6404,6404,6450,-140,-94,4,25.8,236
1946,p1103,20100701,6404,6450,0,0,0,6450,6450,0,0,0,0,236
1947,p1103,20100702,6450,6450,6366,6400,6366,6400,6382,-50,-68,4,25.53,236
1948,p1103,20100705,6400,6382,6396,6400,6396,6400,6398,18,16,4,25.59,234
1949,p1103,20100706,6400,6398,6300,6300,6300,6300,6300,-98,-98,100,630,232
1950,p1103,20100707,6300,6300,0,0,0,6300,6300,0,0,0,0,232
1951,p1103,20100708,6300,6300,6398,6398,6390,6398,6394,98,94,6,38.37,228
1952,p1103,20100709,6398,6394,6394,6466,6394,6418,6420,24,26,14,89.88,216
1953,p1103,20100712,6418,6420,6464,6470,6460,6460,6462,40,42,18,116.34,210
1954,p1103,20100713,6460,6462,0,0,0,6462,6462,0,0,0,0,210
1955,p1103,20100714,6462,6462,0,0,0,6462,6462,0,0,0,0,210
1956,p1103,20100715,6462,6462,6528,6552,6526,6542,6536,80,74,34,222.22,178
1957,p1103,20100716,6542,6536,6642,6660,6642,6660,6650,124,114,4,26.6,176
1958,p1103,20100719,6660,6650,6646,6646,6646,6646,6646,-4,-4,2,13.29,178
1959,p1103,20100720,6646,6646,6640,6640,6640,6640,6640,-6,-6,2,13.28,178
1960,p1103,20100721,6640,6640,6670,6670,6670,6670,6670,30,30,2,13.34,176
1961,p1103,20100722,6670,6670,6688,6690,6688,6690,6688,20,18,8,53.51,184
1962,p1103,20100723,6690,6688,6772,6774,6772,6774,6772,86,84,20,135.45,164
1963,p1103,20100726,6774,6772,6776,6808,6776,6808,6784,36,12,8,54.27,162
1964,p1103,20100727,6808,6784,0,0,0,6784,6784,0,0,0,0,162
1965,p1103,20100728,6784,6784,0,0,0,6784,6784,0,0,0,0,162
1966,p1103,20100729,6784,6784,6824,6824,6824,6824,6824,40,40,2,13.65,162
1967,p1103,20100730,6824,6824,6960,6960,6900,6900,6946,76,122,42,291.77,158
1968,p1103,20100802,6900,6946,6978,7050,6978,7050,7026,104,80,6,42.16,152
1969,p1103,20100803,7050,7026,7060,7060,7060,7060,7060,34,34,12,84.72,140
1970,p1103,20100804,7060,7060,7100,7100,7100,7100,7100,40,40,12,85.2,128
1971,p1103,20100805,7100,7100,6980,7010,6980,7010,7002,-90,-98,12,84.04,122
1972,p1103,20100806,7010,7002,7210,7210,7210,7210,7210,208,208,6,43.26,122
1973,p1103,20100809,7210,7210,7230,7396,7230,7358,7304,148,94,140,1022.57,210
1974,p1103,20100810,7358,7304,7278,7352,7268,7290,7288,-14,-16,186,1355.67,232
1975,p1103,20100811,7290,7288,7500,7500,7252,7252,7318,-36,30,96,702.66,226
1976,p1103,20100812,7252,7318,7298,7298,7264,7264,7280,-54,-38,4,29.12,226
1977,p1103,20100813,7264,7280,0,0,0,7280,7280,0,0,0,0,226
1978,p1103,20100816,7280,7280,7546,7576,7496,7500,7554,220,274,94,710.2,212
1979,p1103,20100817,7500,7554,7408,7450,7408,7430,7440,-124,-114,40,297.68,206
1980,p1103,20100818,7430,7440,7404,7404,7404,7404,7404,-36,-36,4,29.62,206
1981,p1103,20100819,7404,7404,7252,7388,7252,7344,7290,-60,-114,72,524.93,260
1982,p1103,20100820,7344,7290,7250,7270,7206,7210,7240,-80,-50,100,724.11,258
1983,p1103,20100823,7210,7240,7246,7246,7210,7232,7212,-8,-28,70,504.95,258
1984,p1103,20100824,7232,7212,7244,7244,7182,7182,7212,-30,0,4,28.85,258
1985,p1103,20100825,7182,7212,7238,7238,7100,7114,7146,-98,-66,62,443.09,266
1986,p1103,20100826,7114,7146,7150,7170,7150,7160,7152,14,6,66,472.08,266
1987,p1103,20100827,7160,7152,7294,7294,7224,7260,7246,108,94,54,391.32,274
1988,p1103,20100830,7260,7246,7364,7364,7300,7300,7326,54,80,8,58.61,270
1989,p1103,20100831,7300,7326,7182,7182,7180,7180,7180,-146,-146,34,244.13,300
1990,p1103,20100901,7180,7180,7240,7276,7202,7202,7250,22,70,82,594.55,300
1991,p1103,20100902,7202,7250,7248,7260,7210,7214,7234,-36,-16,46,332.84,298
1992,p1103,20100903,7214,7234,7266,7314,7266,7314,7294,80,60,16,116.71,306
1993,p1103,20100906,7314,7294,7360,7436,7360,7392,7414,98,120,26,192.78,316
1994,p1103,20100907,7392,7414,7350,7398,7350,7398,7382,-16,-32,32,236.24,314
1995,p1103,20100908,7398,7382,7510,7510,7424,7424,7462,42,80,60,447.73,330
1996,p1103,20100909,7424,7462,7370,7370,7196,7312,7282,-150,-180,92,669.97,302
1997,p1103,20100910,7312,7282,7368,7374,7368,7374,7370,92,88,4,29.48,298
1998,p1103,20100913,7374,7370,7322,7322,7322,7322,7322,-48,-48,2,14.64,298
1999,p1103,20100914,7322,7322,7426,7470,7336,7380,7426,58,104,20,148.55,296
2000,p1103,20100915,7380,7426,7378,7378,7378,7378,7378,-48,-48,2,14.76,296
2001,p1103,20100916,7378,7378,7366,7366,7300,7324,7326,-54,-52,8,58.61,296
2002,p1103,20100917,7324,7326,0,0,0,7326,7326,0,0,0,0,296
2003,p1103,20100920,7326,7326,7636,7636,7636,7636,7636,310,310,2,15.27,296
2004,p1103,20100921,7636,7636,7548,7720,7548,7720,7680,84,44,44,337.94,334
2005,p1103,20100927,7720,7680,8136,8136,7862,7862,7984,182,304,10,79.86,338
2006,p1103,20100928,7862,7984,7812,7844,7802,7844,7806,-140,-178,54,421.62,294
2007,p1103,20100929,7844,7806,7728,7754,7692,7754,7726,-52,-80,28,216.36,294
2008,p1103,20100930,7754,7726,7694,7694,7694,7694,7694,-32,-32,6,46.16,294
2009,p1103,20101008,7694,7694,7770,7846,7770,7800,7824,106,130,32,250.37,294
2010,p1103,20101011,7800,7824,8192,8192,8192,8192,8192,368,368,2,16.38,294
2011,p1103,20101012,8192,8192,8192,8238,8178,8238,8198,46,6,30,245.96,314
2012,p1103,20101013,8238,8198,8238,8250,8198,8230,8210,32,12,26,213.46,306
2013,p1103,20101014,8230,8210,8384,8384,8336,8336,8360,126,150,4,33.44,306
2014,p1103,20101015,8336,8360,8296,8296,8296,8296,8296,-64,-64,2,16.59,304
2015,p1103,20101018,8296,8296,8218,8218,8172,8172,8186,-124,-110,12,98.25,292
2016,p1103,20101019,8172,8186,0,0,0,8186,8186,0,0,0,0,292
2017,p1103,20101020,8186,8186,8140,8214,8140,8158,8170,-28,-16,12,98.05,288
2018,p1103,20101021,8158,8170,0,0,0,8170,8170,0,0,0,0,288
2019,p1103,20101022,8170,8170,0,0,0,8170,8170,0,0,0,0,288
2020,p1103,20101025,8170,8170,8578,8578,8578,8578,8578,408,408,28,240.18,266
2021,p1103,20101026,8578,8578,8422,8596,8422,8548,8522,-30,-56,6,51.13,264
2022,p1103,20101027,8548,8522,8496,8496,8378,8378,8440,-144,-82,8,67.53,264
2023,p1103,20101028,8378,8440,0,0,0,8440,8440,0,0,0,0,264
2024,p1103,20101029,8440,8440,0,0,0,8440,8440,0,0,0,0,264
2025,p1103,20101101,8440,8440,0,0,0,8440,8440,0,0,0,0,264
2026,p1103,20101102,8440,8440,0,0,0,8440,8440,0,0,0,0,264
2027,p1103,20101103,8440,8440,0,0,0,8440,8440,0,0,0,0,264
2028,p1103,20101104,8440,8440,0,0,0,8440,8440,0,0,0,0,264
2029,p1103,20101105,8440,8440,8862,8862,8862,8862,8862,422,422,2,17.72,262
2030,p1103,20101108,8862,8862,9300,9300,9212,9212,9256,350,394,4,37.02,262
2031,p1103,20101109,9212,9256,9380,9380,9320,9320,9350,64,94,4,37.4,262
2032,p1103,20101110,9320,9350,9450,9450,9450,9450,9450,100,100,2,18.9,262
2033,p1103,20101111,9450,9450,9476,9476,9216,9460,9358,10,-92,30,280.78,258
2034,p1103,20101112,9460,9358,9150,9152,8924,8924,9086,-434,-272,8,72.69,260
2035,p1103,20101115,8924,9086,9118,9118,8960,9098,9056,12,-30,10,90.56,260
2036,p1103,20101116,9098,9056,8864,8992,8824,8990,8924,-66,-132,10,89.25,258
2037,p1103,20101117,8990,8924,8482,8482,8478,8478,8480,-446,-444,4,33.92,256
2038,p1103,20101118,8478,8480,8904,8904,8400,8552,8578,72,98,22,188.72,256
2039,p1103,20101119,8552,8578,0,0,0,8578,8578,0,0,0,0,256
2040,p1103,20101122,8578,8578,0,0,0,8578,8578,0,0,0,0,256
2041,p1103,20101123,8578,8578,0,0,0,8578,8578,0,0,0,0,256
2042,p1103,20101124,8578,8578,0,0,0,8578,8578,0,0,0,0,256
2043,p1103,20101125,8578,8578,0,0,0,8578,8578,0,0,0,0,256
2044,p1103,20101126,8578,8578,8560,8680,8560,8680,8620,102,42,4,34.48,256
2045,p1103,20101129,8680,8620,8460,8460,8460,8460,8460,-160,-160,2,16.92,254
2046,p1103,20101130,8460,8460,8900,8900,8900,8900,8900,440,440,2,17.8,256
2047,p1103,20101201,8900,8900,8998,8998,8910,8910,8954,10,54,4,35.82,254
2048,p1103,20101202,8910,8954,9376,9490,9080,9208,9282,254,328,12,111.39,254
2049,p1103,20101203,9208,9282,9006,9208,9006,9208,9108,-74,-174,10,91.08,256
2050,p1103,20101206,9208,9108,0,0,0,9108,9108,0,0,0,0,256
2051,p1103,20101207,9108,9108,9300,9302,9300,9302,9262,194,154,8,74.11,254
2052,p1103,20101208,9302,9262,9240,9240,9240,9240,9240,-22,-22,2,18.48,252
2053,p1103,20101209,9240,9240,0,0,0,9240,9240,0,0,0,0,252
2054,p1103,20101210,9240,9240,9150,9150,9150,9150,9150,-90,-90,6,54.9,246
2055,p1103,20101213,9150,9150,0,0,0,9150,9150,0,0,0,0,246
2056,p1103,20101214,9150,9150,9440,9480,9440,9480,9452,330,302,10,94.52,240
2057,p1103,20101215,9480,9452,9430,9520,9362,9520,9450,68,-2,44,415.88,218
2058,p1103,20101216,9520,9450,9390,9390,9390,9390,9390,-60,-60,2,18.78,216
2059,p1103,20101217,9390,9390,9434,9434,9434,9434,9434,44,44,2,18.87,216
2060,p1103,20101220,9434,9434,9452,9452,9360,9360,9380,-74,-54,26,243.92,190
2061,p1103,20101221,9360,9380,9380,9380,9380,9380,9380,0,0,2,18.76,188
2062,p1103,20101222,9380,9380,9380,9380,9380,9380,9380,0,0,24,225.12,164
2063,p1103,20101223,9380,9380,9780,9780,9270,9530,9602,150,222,164,1575.02,168
2064,p1103,20101224,9530,9602,9720,9720,9720,9720,9720,118,118,2,19.44,168
2065,p1103,20101227,9720,9720,9750,9750,9670,9670,9710,-50,-10,8,77.68,168
2066,p1103,20101228,9670,9710,9888,9888,9750,9790,9798,80,88,8,78.4,166
2067,p1103,20101229,9790,9798,9660,9660,9660,9660,9660,-138,-138,2,19.32,166
2068,p1103,20101230,9660,9660,0,0,0,9660,9660,0,0,0,0,166
2069,p1103,20101231,9660,9660,9850,9850,9850,9850,9850,190,190,2,19.7,164
2070,p1104,20100416,,6922,0,0,0,6922,6922,0,0,0,0,0
2071,p1104,20100419,6922,6922,0,0,0,6922,6922,0,0,0,0,0
2072,p1104,20100420,6922,6922,0,0,0,6922,6922,0,0,0,0,0
2073,p1104,20100421,6922,6922,6928,6928,6928,6928,6928,6,6,2,13.86,2
2074,p1104,20100422,6928,6928,7032,7032,7032,7032,7032,104,104,2,14.06,2
2075,p1104,20100423,7032,7032,0,0,0,7032,7032,0,0,0,0,2
2076,p1104,20100426,7032,7032,0,0,0,7032,7032,0,0,0,0,2
2077,p1104,20100427,7032,7032,6986,7250,6986,7220,7126,188,94,8,57.02,2
2078,p1104,20100428,7220,7126,0,0,0,7126,7126,0,0,0,0,2
2079,p1104,20100429,7126,7126,0,0,0,7126,7126,0,0,0,0,2
2080,p1104,20100430,7126,7126,0,0,0,7126,7126,0,0,0,0,2
2081,p1104,20100504,7126,7126,0,0,0,7126,7126,0,0,0,0,2
2082,p1104,20100505,7126,7126,0,0,0,7126,7126,0,0,0,0,2
2083,p1104,20100506,7126,7126,6930,7044,6930,6956,6986,-170,-140,8,55.9,2
2084,p1104,20100507,6956,6986,6912,6912,6912,6912,6912,-74,-74,2,13.82,2
2085,p1104,20100510,6912,6912,0,0,0,6912,6912,0,0,0,0,2
2086,p1104,20100511,6912,6912,0,0,0,6912,6912,0,0,0,0,2
2087,p1104,20100512,6912,6912,6908,6908,6900,6900,6904,-12,-8,8,55.23,2
2088,p1104,20100513,6900,6904,0,0,0,6904,6904,0,0,0,0,2
2089,p1104,20100514,6904,6904,0,0,0,6904,6904,0,0,0,0,2
2090,p1104,20100517,6904,6904,6780,6780,6690,6690,6708,-214,-196,12,80.52,8
2091,p1104,20100518,6690,6708,6682,6720,6682,6720,6700,12,-8,4,26.8,4
2092,p1104,20100519,6720,6700,0,0,0,6700,6700,0,0,0,0,4
2093,p1104,20100520,6700,6700,6704,6704,6704,6704,6704,4,4,2,13.41,2
2094,p1104,20100521,6704,6704,0,0,0,6704,6704,0,0,0,0,2
2095,p1104,20100524,6704,6704,0,0,0,6704,6704,0,0,0,0,2
2096,p1104,20100525,6704,6704,0,0,0,6704,6704,0,0,0,0,2
2097,p1104,20100526,6704,6704,6800,6800,6688,6794,6744,90,40,12,80.94,2
2098,p1104,20100527,6794,6744,0,0,0,6744,6744,0,0,0,0,2
2099,p1104,20100528,6744,6744,0,0,0,6744,6744,0,0,0,0,2
2100,p1104,20100531,6744,6744,6748,6748,6748,6748,6748,4,4,2,13.5,2
2101,p1104,20100601,6748,6748,0,0,0,6748,6748,0,0,0,0,2
2102,p1104,20100602,6748,6748,0,0,0,6748,6748,0,0,0,0,2
2103,p1104,20100603,6748,6748,0,0,0,6748,6748,0,0,0,0,2
2104,p1104,20100604,6748,6748,0,0,0,6748,6748,0,0,0,0,2
2105,p1104,20100607,6748,6748,0,0,0,6748,6748,0,0,0,0,2
2106,p1104,20100608,6748,6748,6748,6748,6748,6748,6748,0,0,2,13.5,2
2107,p1104,20100609,6748,6748,0,0,0,6748,6748,0,0,0,0,2
2108,p1104,20100610,6748,6748,6698,6698,6520,6520,6608,-228,-140,4,26.44,2
2109,p1104,20100611,6520,6608,6512,6514,6512,6514,6512,-94,-96,280,1823.56,282
2110,p1104,20100617,6514,6512,0,0,0,6512,6512,0,0,0,0,282
2111,p1104,20100618,6512,6512,0,0,0,6512,6512,0,0,0,0,282
2112,p1104,20100621,6512,6512,0,0,0,6512,6512,0,0,0,0,282
2113,p1104,20100622,6512,6512,6686,6686,6686,6686,6686,174,174,4,26.74,286
2114,p1104,20100623,6686,6686,6574,6574,6574,6574,6574,-112,-112,2,13.15,284
2115,p1104,20100624,6574,6574,6682,6682,6682,6682,6682,108,108,2,13.36,286
2116,p1104,20100625,6682,6682,0,0,0,6682,6682,0,0,0,0,286
2117,p1104,20100628,6682,6682,6660,6666,6660,6666,6662,-16,-20,4,26.65,286
2118,p1104,20100629,6666,6662,0,0,0,6662,6662,0,0,0,0,286
2119,p1104,20100630,6662,6662,0,0,0,6662,6662,0,0,0,0,286
2120,p1104,20100701,6662,6662,6450,6450,6450,6450,6450,-212,-212,2,12.9,288
2121,p1104,20100702,6450,6450,6428,6428,6428,6428,6428,-22,-22,2,12.86,288
2122,p1104,20100705,6428,6428,6412,6412,6412,6412,6412,-16,-16,2,12.82,288
2123,p1104,20100706,6412,6412,0,0,0,6412,6412,0,0,0,0,288
2124,p1104,20100707,6412,6412,0,0,0,6412,6412,0,0,0,0,288
2125,p1104,20100708,6412,6412,0,0,0,6412,6412,0,0,0,0,288
2126,p1104,20100709,6412,6412,6460,6460,6460,6460,6460,48,48,2,12.92,286
2127,p1104,20100712,6460,6460,0,0,0,6460,6460,0,0,0,0,286
2128,p1104,20100713,6460,6460,0,0,0,6460,6460,0,0,0,0,286
2129,p1104,20100714,6460,6460,0,0,0,6460,6460,0,0,0,0,286
2130,p1104,20100715,6460,6460,0,0,0,6460,6460,0,0,0,0,286
2131,p1104,20100716,6460,6460,0,0,0,6460,6460,0,0,0,0,286
2132,p1104,20100719,6460,6460,6780,6780,6780,6780,6780,320,320,2,13.56,284
2133,p1104,20100720,6780,6780,6696,6696,6696,6696,6696,-84,-84,2,13.39,284
2134,p1104,20100721,6696,6696,0,0,0,6696,6696,0,0,0,0,284
2135,p1104,20100722,6696,6696,6704,6704,6704,6704,6704,8,8,6,40.22,286
2136,p1104,20100723,6704,6704,0,0,0,6704,6704,0,0,0,0,286
2137,p1104,20100726,6704,6704,0,0,0,6704,6704,0,0,0,0,286
2138,p1104,20100727,6704,6704,0,0,0,6704,6704,0,0,0,0,286
2139,p1104,20100728,6704,6704,0,0,0,6704,6704,0,0,0,0,286
2140,p1104,20100729,6704,6704,0,0,0,6704,6704,0,0,0,0,286
2141,p1104,20100730,6704,6704,0,0,0,6704,6704,0,0,0,0,286
2142,p1104,20100802,6704,6704,0,0,0,6704,6704,0,0,0,0,286
2143,p1104,20100803,6704,6704,6758,7038,6758,7038,6878,334,174,14,96.29,284
2144,p1104,20100804,7038,6878,0,0,0,6878,6878,0,0,0,0,284
2145,p1104,20100805,6878,6878,0,0,0,6878,6878,0,0,0,0,284
2146,p1104,20100806,6878,6878,0,0,0,6878,6878,0,0,0,0,284
2147,p1104,20100809,6878,6878,7218,7220,7218,7220,7218,342,340,62,447.63,318
2148,p1104,20100810,7220,7218,7206,7342,7200,7276,7262,58,44,38,275.98,292
2149,p1104,20100811,7276,7262,7252,7256,7252,7256,7252,-6,-10,28,203.1,300
2150,p1104,20100812,7256,7252,0,0,0,7252,7252,0,0,0,0,300
2151,p1104,20100813,7252,7252,0,0,0,7252,7252,0,0,0,0,300
2152,p1104,20100816,7252,7252,7570,7570,7402,7402,7542,150,290,24,181.01,288
2153,p1104,20100817,7402,7542,0,0,0,7542,7542,0,0,0,0,288
2154,p1104,20100818,7542,7542,0,0,0,7542,7542,0,0,0,0,288
2155,p1104,20100819,7542,7542,7320,7320,7320,7320,7320,-222,-222,4,29.28,288
2156,p1104,20100820,7320,7320,0,0,0,7320,7320,0,0,0,0,288
2157,p1104,20100823,7320,7320,7200,7200,7200,7200,7200,-120,-120,2,14.4,286
2158,p1104,20100824,7200,7200,0,0,0,7200,7200,0,0,0,0,286
2159,p1104,20100825,7200,7200,0,0,0,7200,7200,0,0,0,0,286
2160,p1104,20100826,7200,7200,7086,7132,7086,7132,7108,-68,-92,4,28.44,286
2161,p1104,20100827,7132,7108,7228,7228,7128,7128,7168,20,60,40,286.76,306
2162,p1104,20100830,7128,7168,7366,7366,7260,7260,7342,92,174,22,161.55,294
2163,p1104,20100831,7260,7342,7214,7214,7214,7214,7214,-128,-128,2,14.43,292
2164,p1104,20100901,7214,7214,7204,7204,7134,7134,7162,-80,-52,10,71.62,292
2165,p1104,20100902,7134,7162,7134,7232,7134,7168,7168,6,6,74,530.48,318
2166,p1104,20100903,7168,7168,7230,7268,7230,7268,7262,100,94,24,174.32,316
2167,p1104,20100906,7268,7262,7340,7418,7322,7376,7364,114,102,70,515.61,310
2168,p1104,20100907,7376,7364,7360,7360,7360,7360,7360,-4,-4,22,161.92,288
2169,p1104,20100908,7360,7360,0,0,0,7360,7360,0,0,0,0,288
2170,p1104,20100909,7360,7360,7270,7288,7220,7260,7254,-100,-106,14,101.56,290
2171,p1104,20100910,7260,7254,0,0,0,7254,7254,0,0,0,0,290
2172,p1104,20100913,7254,7254,7372,7372,7284,7350,7298,96,44,64,467.14,340
2173,p1104,20100914,7350,7298,0,0,0,7298,7298,0,0,0,0,340
2174,p1104,20100915,7298,7298,7396,7396,7282,7306,7352,8,54,94,691.21,324
2175,p1104,20100916,7306,7352,7264,7358,7264,7308,7330,-44,-22,62,454.55,298
2176,p1104,20100917,7308,7330,0,0,0,7330,7330,0,0,0,0,298
2177,p1104,20100920,7330,7330,7600,7600,7600,7600,7600,270,270,10,76,288
2178,p1104,20100921,7600,7600,0,0,0,7600,7600,0,0,0,0,288
2179,p1104,20100927,7600,7600,0,0,0,7600,7600,0,0,0,0,288
2180,p1104,20100928,7600,7600,7788,7788,7788,7788,7788,188,188,6,46.73,284
2181,p1104,20100929,7788,7788,7726,7726,7718,7718,7722,-70,-66,4,30.89,282
2182,p1104,20100930,7718,7722,7790,7790,7790,7790,7790,68,68,2,15.58,282
2183,p1104,20101008,7790,7790,0,0,0,7790,7790,0,0,0,0,282
2184,p1104,20101011,7790,7790,0,0,0,7790,7790,0,0,0,0,282
2185,p1104,20101012,7790,7790,8178,8178,8152,8152,8160,362,370,6,48.96,282
2186,p1104,20101013,8152,8160,8194,8212,8194,8212,8200,52,40,30,246,268
2187,p1104,20101014,8212,8200,0,0,0,8200,8200,0,0,0,0,268
2188,p1104,20101015,8200,8200,0,0,0,8200,8200,0,0,0,0,268
2189,p1104,20101018,8200,8200,0,0,0,8200,8200,0,0,0,0,268
2190,p1104,20101019,8200,8200,0,0,0,8200,8200,0,0,0,0,268
2191,p1104,20101020,8200,8200,8192,8212,8192,8212,8204,12,4,6,49.23,268
2192,p1104,20101021,8212,8204,8474,8612,8320,8330,8426,126,222,56,471.87,268
2193,p1104,20101022,8330,8426,8428,8428,8370,8370,8398,-56,-28,12,100.79,268
2194,p1104,20101025,8370,8398,8612,8710,8512,8600,8576,202,178,24,205.86,278
2195,p1104,20101026,8600,8576,8506,8506,8506,8506,8506,-70,-70,2,17.01,278
2196,p1104,20101027,8506,8506,8392,8392,8392,8392,8392,-114,-114,2,16.78,278
2197,p1104,20101028,8392,8392,8438,8438,8438,8438,8438,46,46,2,16.88,278
2198,p1104,20101029,8438,8438,8518,8518,8348,8348,8448,-90,10,10,84.49,282
2199,p1104,20101101,8348,8448,0,0,0,8448,8448,0,0,0,0,282
2200,p1104,20101102,8448,8448,0,0,0,8448,8448,0,0,0,0,282
2201,p1104,20101103,8448,8448,8610,8610,8458,8458,8534,10,86,4,34.14,282
2202,p1104,20101104,8458,8534,8574,8788,8574,8654,8576,120,42,154,1320.98,132
2203,p1104,20101105,8654,8576,9004,9004,9004,9004,9004,428,428,2,18.01,132
2204,p1104,20101108,9004,9004,9300,9300,9300,9300,9300,296,296,2,18.6,130
2205,p1104,20101109,9300,9300,0,0,0,9300,9300,0,0,0,0,130
2206,p1104,20101110,9300,9300,0,0,0,9300,9300,0,0,0,0,130
2207,p1104,20101111,9300,9300,9730,9730,9402,9452,9550,152,250,18,171.92,126
2208,p1104,20101112,9452,9550,9162,9162,9076,9076,9154,-474,-396,26,238.03,128
2209,p1104,20101115,9076,9154,0,0,0,9154,9154,0,0,0,0,128
2210,p1104,20101116,9154,9154,0,0,0,9154,9154,0,0,0,0,128
2211,p1104,20101117,9154,9154,0,0,0,9154,9154,0,0,0,0,128
2212,p1104,20101118,9154,9154,8698,8698,8698,8698,8698,-456,-456,8,69.58,136
2213,p1104,20101119,8698,8698,8698,8698,8698,8698,8698,0,0,2,17.4,136
2214,p1104,20101122,8698,8698,0,0,0,8698,8698,0,0,0,0,136
2215,p1104,20101123,8698,8698,0,0,0,8698,8698,0,0,0,0,136
2216,p1104,20101124,8698,8698,0,0,0,8698,8698,0,0,0,0,136
2217,p1104,20101125,8698,8698,8748,8748,8576,8576,8662,-122,-36,4,34.65,134
2218,p1104,20101126,8576,8662,0,0,0,8662,8662,0,0,0,0,134
2219,p1104,20101129,8662,8662,0,0,0,8662,8662,0,0,0,0,134
2220,p1104,20101130,8662,8662,0,0,0,8662,8662,0,0,0,0,134
2221,p1104,20101201,8662,8662,8866,9150,8664,9150,8892,488,230,6,53.36,132
2222,p1104,20101202,9150,8892,0,0,0,8892,8892,0,0,0,0,132
2223,p1104,20101203,8892,8892,0,0,0,8892,9060,0,168,2,18.12,134
2224,p1104,20101206,8892,9060,0,0,0,9060,9060,0,0,0,0,134
2225,p1104,20101207,9060,9060,9320,9320,9320,9320,9262,260,202,4,37.05,134
2226,p1104,20101208,9320,9262,0,0,0,9262,9262,0,0,0,0,134
2227,p1104,20101209,9262,9262,0,0,0,9262,9262,0,0,0,0,134
2228,p1104,20101210,9262,9262,0,0,0,9262,9262,0,0,0,0,134
2229,p1104,20101213,9262,9262,9332,9332,9332,9332,9332,70,70,4,37.33,134
2230,p1104,20101214,9332,9332,0,0,0,9332,9332,0,0,0,0,134
2231,p1104,20101215,9332,9332,9470,9470,9470,9470,9470,138,138,6,56.82,134
2232,p1104,20101216,9470,9470,9492,9492,9472,9490,9484,20,14,6,56.91,134
2233,p1104,20101217,9490,9484,0,0,0,9484,9484,0,0,0,0,134
2234,p1104,20101220,9484,9484,0,0,0,9484,9484,0,0,0,0,134
2235,p1104,20101221,9484,9484,9480,9480,9474,9474,9474,-10,-10,102,966.36,34
2236,p1104,20101222,9474,9474,0,0,0,9474,9474,0,0,0,0,34
2237,p1104,20101223,9474,9474,9610,9670,9610,9670,9646,196,172,6,57.88,32
2238,p1104,20101224,9670,9646,0,0,0,9646,9646,0,0,0,0,32
2239,p1104,20101227,9646,9646,0,0,0,9646,9646,0,0,0,0,32
2240,p1104,20101228,9646,9646,0,0,0,9646,9646,0,0,0,0,32
2241,p1104,20101229,9646,9646,0,0,0,9646,9646,0,0,0,0,32
2242,p1104,20101230,9646,9646,0,0,0,9646,9646,0,0,0,0,32
2243,p1104,20101231,9646,9646,9800,9984,9800,9984,9892,338,246,4,39.57,34
2244,p1105,20100518,,6690,6642,6746,6642,6746,6698,56,8,142,951.4,108
2245,p1105,20100519,6746,6698,6684,6734,6684,6728,6706,30,8,50,335.33,96
2246,p1105,20100520,6728,6706,6806,6806,6770,6778,6784,72,78,14,94.98,96
2247,p1105,20100521,6778,6784,6714,6804,6712,6802,6776,18,-8,70,474.43,98
2248,p1105,20100524,6802,6776,6798,6812,6798,6806,6814,30,38,32,218.06,100
2249,p1105,20100525,6806,6814,6802,6802,6742,6764,6774,-50,-40,18,121.95,104
2250,p1105,20100526,6764,6774,6770,6820,6726,6820,6780,46,6,560,3797.26,440
2251,p1105,20100527,6820,6780,6818,6832,6806,6832,6796,52,16,392,2664.26,448
2252,p1105,20100528,6832,6796,6856,6856,6820,6822,6848,26,52,94,643.81,452
2253,p1105,20100531,6822,6848,6792,6792,6750,6752,6778,-96,-70,456,3091.25,256
2254,p1105,20100601,6752,6778,6750,6796,6730,6780,6746,2,-32,108,728.64,276
2255,p1105,20100602,6780,6746,6780,6812,6772,6812,6784,66,38,172,1167.05,296
2256,p1105,20100603,6812,6784,6818,6818,6778,6804,6800,20,16,166,1129.08,338
2257,p1105,20100604,6804,6800,6812,6840,6796,6824,6820,24,20,210,1432.35,314
2258,p1105,20100607,6824,6820,6750,6750,6612,6628,6650,-192,-170,216,1436.58,304
2259,p1105,20100608,6628,6650,6642,6646,6632,6646,6634,-4,-16,28,185.79,322
2260,p1105,20100609,6646,6634,6646,6646,6512,6594,6564,-40,-70,922,6053.76,670
2261,p1105,20100610,6594,6564,6562,6596,6554,6554,6562,-10,-2,176,1155.2,720
2262,p1105,20100611,6554,6562,6560,6560,6530,6532,6544,-30,-18,142,929.44,696
2263,p1105,20100617,6532,6544,6600,6622,6586,6590,6592,46,48,272,1793.04,938
2264,p1105,20100618,6590,6592,6608,6620,6606,6612,6614,20,22,70,463.05,984
2265,p1105,20100621,6612,6614,6656,6706,6646,6704,6676,90,62,186,1241.99,970
2266,p1105,20100622,6704,6676,6740,6740,6658,6666,6666,-10,-10,126,840.12,1046
2267,p1105,20100623,6666,6666,6634,6670,6634,6668,6656,2,-10,174,1158.39,1010
2268,p1105,20100624,6668,6656,6696,6696,6612,6670,6668,14,12,246,1640.64,1012
2269,p1105,20100625,6670,6668,6656,6666,6644,6650,6654,-18,-14,90,598.99,976
2270,p1105,20100628,6650,6654,6660,6676,6630,6630,6650,-24,-4,204,1356.97,974
2271,p1105,20100629,6630,6650,6622,6626,6534,6548,6566,-102,-84,264,1733.5,1024
2272,p1105,20100630,6548,6566,6548,6548,6480,6498,6494,-68,-72,116,753.41,1018
2273,p1105,20100701,6498,6494,6500,6524,6440,6440,6490,-54,-4,290,1882.36,1040
2274,p1105,20100702,6440,6490,6450,6456,6400,6444,6426,-46,-64,662,4254.99,1386
2275,p1105,20100705,6444,6426,6444,6444,6402,6410,6422,-16,-4,248,1592.82,1410
2276,p1105,20100706,6410,6422,6378,6382,6312,6380,6358,-42,-64,944,6003.52,1650
2277,p1105,20100707,6380,6358,6380,6380,6340,6356,6354,-2,-4,262,1665.12,1640
2278,p1105,20100708,6356,6354,6426,6450,6388,6402,6400,48,46,3268,20916.1,3256
2279,p1105,20100709,6402,6400,6404,6472,6402,6470,6440,70,40,740,4766.53,3094
2280,p1105,20100712,6470,6440,6550,6550,6458,6462,6490,22,50,1476,9581.69,3670
2281,p1105,20100713,6462,6490,6490,6506,6450,6470,6488,-20,-2,824,5346.46,3852
2282,p1105,20100714,6470,6488,6500,6552,6480,6544,6532,56,44,3350,21884.26,3300
2283,p1105,20100715,6544,6532,6552,6580,6532,6556,6568,24,36,1742,11442.86,4290
2284,p1105,20100716,6556,6568,6622,6696,6618,6692,6652,124,84,3270,21752.12,5232
2285,p1105,20100719,6692,6652,6682,6708,6622,6700,6676,48,24,3048,20351.57,5440
2286,p1105,20100720,6700,6676,6690,6710,6636,6700,6680,24,4,5912,39499.09,5982
2287,p1105,20100721,6700,6680,6726,6730,6696,6702,6708,22,28,1804,12102.94,6864
2288,p1105,20100722,6702,6708,6702,6766,6616,6756,6724,48,16,2958,19894.2,6610
2289,p1105,20100723,6756,6724,6802,6808,6778,6796,6794,72,70,3134,21298.07,7488
2290,p1105,20100726,6796,6794,6790,6832,6782,6804,6806,10,12,10446,71108.01,11910
2291,p1105,20100727,6804,6806,6776,6782,6702,6720,6738,-86,-68,5222,35187.19,11430
2292,p1105,20100728,6720,6738,6680,6784,6680,6784,6758,46,20,1920,12978.86,11288
2293,p1105,20100729,6784,6758,6820,6868,6792,6848,6840,90,82,10534,72064.76,12520
2294,p1105,20100730,6848,6840,6898,6906,6850,6868,6882,28,42,5000,34418.02,13172
2295,p1105,20100802,6868,6882,6942,7048,6936,7014,6996,132,114,8644,60487.6,15026
2296,p1105,20100803,7014,6996,7026,7072,6968,7018,7028,22,32,9156,64365.15,15316
2297,p1105,20100804,7018,7028,7080,7120,7050,7080,7086,52,58,9850,69815.16,16530
2298,p1105,20100805,7080,7086,7148,7160,6988,6996,7052,-90,-34,17138,120886.25,18132
2299,p1105,20100806,6996,7052,7032,7240,7006,7230,7120,178,68,32584,232025.62,22616
2300,p1105,20100809,7230,7120,7228,7426,7224,7388,7336,268,216,88420,648750.85,37038
2301,p1105,20100810,7388,7336,7310,7362,7246,7280,7300,-56,-36,69616,508263.5,35424
2302,p1105,20100811,7280,7300,7286,7362,7258,7280,7322,-20,22,80168,587141.81,31500
2303,p1105,20100812,7280,7322,7288,7378,7242,7298,7320,-24,-2,141444,1035543.91,40224
2304,p1105,20100813,7298,7320,7340,7456,7326,7454,7392,134,72,107006,791175.98,48510
2305,p1105,20100816,7454,7392,7516,7556,7462,7468,7502,76,110,90138,676278.76,47794
2306,p1105,20100817,7468,7502,7420,7444,7376,7434,7410,-68,-92,60946,451710.03,47300
2307,p1105,20100818,7434,7410,7464,7490,7300,7330,7384,-80,-26,89064,657796.58,47534
2308,p1105,20100819,7330,7384,7352,7364,7274,7350,7324,-34,-60,83770,613677.56,48722
2309,p1105,20100820,7350,7324,7240,7242,7128,7136,7194,-188,-130,68506,492930.96,47976
2310,p1105,20100823,7136,7194,7162,7232,7150,7200,7202,6,8,149414,1076257.53,60018
2311,p1105,20100824,7200,7202,7176,7248,7132,7156,7204,-46,2,199026,1433827.66,63064
2312,p1105,20100825,7156,7204,7196,7200,7064,7088,7132,-116,-72,261806,1867360.75,72576
2313,p1105,20100826,7088,7132,7110,7148,7096,7134,7118,2,-14,239118,1702413.16,82206
2314,p1105,20100827,7134,7118,7150,7254,7150,7238,7208,120,90,274358,1978116.57,90858
2315,p1105,20100830,7238,7208,7298,7358,7280,7328,7324,120,116,231970,1699213.2,95544
2316,p1105,20100831,7328,7324,7260,7260,7154,7162,7186,-162,-138,253060,1818940.94,99332
2317,p1105,20100901,7162,7186,7170,7264,7124,7160,7190,-26,4,392352,2821281.97,107902
2318,p1105,20100902,7160,7190,7182,7244,7166,7240,7206,50,16,412928,2976123,111388
2319,p1105,20100903,7240,7206,7280,7326,7228,7306,7274,100,68,421264,3064904.28,116110
2320,p1105,20100906,7306,7274,7338,7398,7332,7338,7362,64,88,231294,1703237.5,113198
2321,p1105,20100907,7338,7362,7338,7436,7314,7436,7380,74,18,437704,3230265.59,130750
2322,p1105,20100908,7436,7380,7500,7508,7388,7396,7440,16,60,289734,2155938.88,124432
2323,p1105,20100909,7396,7440,7430,7458,7068,7294,7294,-146,-146,489398,3570482.56,101492
2324,p1105,20100910,7294,7294,7336,7374,7288,7366,7332,72,38,277762,2037104.91,106630
2325,p1105,20100913,7366,7332,7366,7428,7306,7422,7354,90,22,292582,2151660.42,128604
2326,p1105,20100914,7422,7354,7400,7450,7324,7336,7384,-18,30,447626,3306137.1,120178
2327,p1105,20100915,7336,7384,7360,7394,7332,7344,7364,-40,-20,301866,2223376.41,123578
2328,p1105,20100916,7344,7364,7368,7388,7260,7316,7322,-48,-42,328380,2404663.9,109230
2329,p1105,20100917,7316,7322,7340,7348,7292,7326,7324,4,2,214936,1574308.88,109204
2330,p1105,20100920,7326,7324,7438,7668,7438,7602,7588,278,264,358074,2717493.26,115908
2331,p1105,20100921,7602,7588,7596,7604,7510,7596,7570,8,-18,230110,1742357.14,109884
2332,p1105,20100927,7596,7570,7860,7970,7740,7794,7854,224,284,207854,1632784.02,109370
2333,p1105,20100928,7794,7854,7720,7848,7720,7830,7794,-24,-60,168424,1312956.65,115408
2334,p1105,20100929,7830,7794,7748,7780,7604,7684,7686,-110,-108,190706,1466130.96,102862
2335,p1105,20100930,7684,7686,7680,7750,7600,7746,7672,60,-14,141196,1083477.54,100746
2336,p1105,20101008,7746,7672,7740,7860,7672,7752,7796,80,124,242122,1887610.84,121954
2337,p1105,20101011,7752,7796,8184,8184,8184,8184,8178,388,382,9564,78224.36,118652
2338,p1105,20101012,8184,8178,8146,8210,8028,8162,8160,-16,-18,281168,2294412.56,132146
2339,p1105,20101013,8162,8160,8202,8252,8142,8214,8192,54,32,241704,1980481.35,143474
2340,p1105,20101014,8214,8192,8250,8362,8228,8302,8310,110,118,365070,3034001.08,161658
2341,p1105,20101015,8302,8310,8338,8340,8236,8314,8298,4,-12,271774,2255344.02,159414
2342,p1105,20101018,8314,8298,8188,8226,8076,8118,8144,-180,-154,255500,2081203.42,152948
2343,p1105,20101019,8118,8144,8180,8290,8138,8192,8214,48,70,318544,2617112.32,144864
2344,p1105,20101020,8192,8214,8064,8176,8010,8130,8118,-84,-96,265842,2158340.89,143788
2345,p1105,20101021,8130,8118,8346,8428,8250,8294,8342,176,224,410276,3422710.63,144696
2346,p1105,20101022,8294,8342,8288,8370,8272,8328,8340,-14,-2,253268,2112706.23,152450
2347,p1105,20101025,8328,8340,8370,8642,8366,8550,8536,210,196,327574,2796390.5,157334
2348,p1105,20101026,8550,8536,8550,8562,8438,8468,8500,-68,-36,228106,1939274.16,145680
2349,p1105,20101027,8468,8500,8556,8576,8076,8320,8394,-180,-106,208040,1746588.19,135186
2350,p1105,20101028,8320,8394,8402,8480,8340,8480,8404,86,10,151602,1274164.73,123676
2351,p1105,20101029,8480,8404,8410,8450,8282,8318,8368,-86,-36,167230,1399558.21,111704
2352,p1105,20101101,8318,8368,8356,8474,8356,8424,8430,56,62,83516,704163.61,108200
2353,p1105,20101102,8424,8430,8460,8516,8392,8436,8450,6,20,86204,728460.08,104994
2354,p1105,20101103,8436,8450,8450,8490,8360,8396,8438,-54,-12,71924,606904.92,98952
2355,p1105,20101104,8396,8438,8490,8714,8432,8692,8572,254,134,79474,681406.6,90062
2356,p1105,20101105,8692,8572,8800,9000,8790,9000,8960,428,388,39684,355611.47,88828
2357,p1105,20101108,9000,8960,8998,9406,8940,9238,9222,278,262,99932,921749.6,84070
2358,p1105,20101109,9238,9222,9134,9434,9134,9346,9326,124,104,84926,792079.27,78258
2359,p1105,20101110,9346,9326,9560,9560,9322,9330,9444,4,118,57674,544684.21,72146
2360,p1105,20101111,9330,9444,9404,9446,9270,9322,9372,-122,-72,53554,501949.98,66170
2361,p1105,20101112,9322,9372,9450,9450,8904,8920,9022,-452,-350,85706,773367.69,73876
2362,p1105,20101115,8920,9022,8944,9090,8668,8882,8908,-140,-114,82548,735419.19,61122
2363,p1105,20101116,8882,8908,8946,9020,8826,8838,8902,-70,-6,50240,447301.77,56690
2364,p1105,20101117,8838,8902,8458,8550,8458,8458,8486,-444,-416,26066,221245.32,55448
2365,p1105,20101118,8458,8486,8650,8650,8270,8534,8478,48,-8,29554,250577.64,51600
2366,p1105,20101119,8534,8478,8690,8750,8502,8700,8624,222,146,20640,178023.78,47750
2367,p1105,20101122,8700,8624,8530,8560,8450,8478,8518,-146,-106,15610,132972.77,47392
2368,p1105,20101123,8478,8518,8502,8528,8328,8360,8420,-158,-98,15430,129941.25,45894
2369,p1105,20101124,8360,8420,8378,8548,8378,8546,8462,126,42,9402,79571.54,45600
2370,p1105,20101125,8546,8462,8548,8694,8548,8594,8628,132,166,8180,70584.6,44866
2371,p1105,20101126,8594,8628,8628,8642,8410,8516,8516,-112,-112,8596,73212.17,43650
2372,p1105,20101129,8516,8516,8470,8660,8452,8660,8560,144,44,8668,74203.61,42932
2373,p1105,20101130,8660,8560,8698,8728,8534,8728,8640,168,80,13008,112412.08,40640
2374,p1105,20101201,8728,8640,8700,8910,8684,8910,8810,270,170,19840,174828.94,38910
2375,p1105,20101202,8910,8810,9080,9098,9004,9020,9022,210,212,8126,73322.77,38838
2376,p1105,20101203,9020,9022,9010,9088,8980,9050,9032,28,10,4658,42074.55,37704
2377,p1105,20101206,9050,9032,9100,9212,9078,9198,9154,166,122,8144,74550.65,35670
2378,p1105,20101207,9198,9154,9170,9290,9152,9290,9226,136,72,3994,36851.08,35088
2379,p1105,20101208,9290,9226,9230,9230,9042,9046,9132,-180,-94,4130,37722.98,34930
2380,p1105,20101209,9046,9132,9200,9240,9134,9172,9194,40,62,2102,19329.44,34432
2381,p1105,20101210,9172,9194,9152,9204,9112,9188,9150,-6,-44,3050,27911.12,34310
2382,p1105,20101213,9188,9150,9168,9406,9168,9386,9320,236,170,3738,34841.79,33072
2383,p1105,20101214,9386,9320,9406,9470,9366,9470,9426,150,106,4894,46137.12,32704
2384,p1105,20101215,9470,9426,9408,9558,9372,9382,9450,-44,24,5380,50851.68,31020
2385,p1105,20101216,9382,9450,9400,9454,9366,9398,9416,-52,-34,4216,39704.1,30736
2386,p1105,20101217,9398,9416,9382,9476,9380,9440,9446,24,30,1348,12735.51,30864
2387,p1105,20101220,9440,9446,9480,9530,9274,9376,9428,-70,-18,6176,58228.91,30746
2388,p1105,20101221,9376,9428,9420,9498,9406,9482,9448,54,20,2230,21073.34,29868
2389,p1105,20101222,9482,9448,9528,9540,9440,9478,9498,30,50,4076,38714.91,28640
2390,p1105,20101223,9478,9498,9520,9662,9520,9614,9592,116,94,8844,84845.32,23936
2391,p1105,20101224,9614,9592,9640,9700,9530,9638,9606,46,14,1584,15218.82,23686
2392,p1105,20101227,9638,9606,9598,9710,9560,9694,9662,88,56,3170,30628.88,22824
2393,p1105,20101228,9694,9662,9750,9840,9750,9804,9802,142,140,3748,36740.38,21514
2394,p1105,20101229,9804,9802,9800,9800,9686,9716,9742,-86,-60,8384,81678.68,21088
2395,p1105,20101230,9716,9742,9694,9788,9630,9764,9720,22,-22,5934,57689.98,20792
2396,p1105,20101231,9764,9720,9760,9822,9702,9818,9782,98,62,2026,19820.84,20558
2397,p1106,20100618,,6520,0,0,0,6520,6520,0,0,0,0,0
2398,p1106,20100621,6520,6520,0,0,0,6520,6520,0,0,0,0,0
2399,p1106,20100622,6520,6520,0,0,0,6520,6520,0,0,0,0,0
2400,p1106,20100623,6520,6520,0,0,0,6520,6520,0,0,0,0,0
2401,p1106,20100624,6520,6520,0,0,0,6520,6520,0,0,0,0,0
2402,p1106,20100625,6520,6520,6600,6860,6600,6730,6642,210,122,582,3866.45,2
2403,p1106,20100628,6730,6642,0,0,0,6642,6642,0,0,0,0,2
2404,p1106,20100629,6642,6642,0,0,0,6642,6642,0,0,0,0,2
2405,p1106,20100630,6642,6642,0,0,0,6642,6642,0,0,0,0,2
2406,p1106,20100701,6642,6642,0,0,0,6642,6642,0,0,0,0,2
2407,p1106,20100702,6642,6642,0,0,0,6642,6642,0,0,0,0,2
2408,p1106,20100705,6642,6642,6580,6580,6580,6580,6580,-62,-62,2,13.16,4
2409,p1106,20100706,6580,6580,6422,6422,6398,6398,6406,-182,-174,6,38.44,8
2410,p1106,20100707,6398,6406,6306,6456,6306,6440,6382,34,-24,36,229.76,4
2411,p1106,20100708,6440,6382,6500,6500,6500,6500,6500,118,118,4,26,4
2412,p1106,20100709,6500,6500,6480,6480,6480,6480,6480,-20,-20,2,12.96,2
2413,p1106,20100712,6480,6480,6542,6542,6542,6542,6542,62,62,2,13.08,0
2414,p1106,20100713,6542,6542,0,0,0,6542,6542,0,0,0,0,0
2415,p1106,20100714,6542,6542,0,0,0,6542,6542,0,0,0,0,0
2416,p1106,20100715,6542,6542,0,0,0,6542,6542,0,0,0,0,0
2417,p1106,20100716,6542,6542,0,0,0,6542,6542,0,0,0,0,0
2418,p1106,20100719,6542,6542,0,0,0,6542,6542,0,0,0,0,0
2419,p1106,20100720,6542,6542,0,0,0,6542,6542,0,0,0,0,0
2420,p1106,20100721,6542,6542,0,0,0,6542,6542,0,0,0,0,0
2421,p1106,20100722,6542,6542,6720,6820,6720,6800,6784,258,242,8,54.28,2
2422,p1106,20100723,6800,6784,6664,6664,6664,6664,6664,-120,-120,2,13.33,4
2423,p1106,20100726,6664,6664,0,0,0,6664,6664,0,0,0,0,4
2424,p1106,20100727,6664,6664,0,0,0,6664,6664,0,0,0,0,4
2425,p1106,20100728,6664,6664,0,0,0,6664,6664,0,0,0,0,4
2426,p1106,20100729,6664,6664,6860,6860,6860,6860,6860,196,196,2,13.72,6
2427,p1106,20100730,6860,6860,0,0,0,6860,6860,0,0,0,0,6
2428,p1106,20100802,6860,6860,0,0,0,6860,6860,0,0,0,0,6
2429,p1106,20100803,6860,6860,0,0,0,6860,6860,0,0,0,0,6
2430,p1106,20100804,6860,6860,7098,7100,7064,7064,7086,204,226,6,42.52,8
2431,p1106,20100805,7064,7086,7036,7036,7010,7010,7020,-76,-66,6,42.13,10
2432,p1106,20100806,7010,7020,7090,7090,6930,6930,7030,-90,10,12,84.37,12
2433,p1106,20100809,6930,7030,7300,7362,7300,7362,7320,332,290,6,43.92,12
2434,p1106,20100810,7362,7320,7210,7220,7210,7220,7214,-100,-106,200,1443,212
2435,p1106,20100811,7220,7214,7250,7300,7176,7176,7254,-38,40,320,2321.35,518
2436,p1106,20100812,7176,7254,7298,7384,7224,7322,7286,68,32,128,932.85,478
2437,p1106,20100813,7322,7286,7338,7422,7332,7422,7386,136,100,176,1300.24,640
2438,p1106,20100816,7422,7386,7600,7600,7452,7452,7580,66,194,160,1213.1,516
2439,p1106,20100817,7452,7580,7546,7546,7408,7442,7464,-138,-116,36,268.76,516
2440,p1106,20100818,7442,7464,7458,7458,7344,7344,7400,-120,-64,4,29.6,520
2441,p1106,20100819,7344,7400,7300,7300,7300,7300,7300,-100,-100,2,14.6,520
2442,p1106,20100820,7300,7300,7210,7284,7200,7200,7214,-100,-86,26,187.6,540
2443,p1106,20100823,7200,7214,7274,7274,7188,7188,7230,-26,16,48,347.09,550
2444,p1106,20100824,7188,7230,0,0,0,7230,7230,0,0,0,0,550
2445,p1106,20100825,7230,7230,7206,7224,7150,7150,7208,-80,-22,30,216.28,536
2446,p1106,20100826,7150,7208,7122,7192,7122,7192,7156,-16,-52,4,28.63,536
2447,p1106,20100827,7192,7156,7232,7232,7232,7232,7232,76,76,4,28.93,538
2448,p1106,20100830,7232,7232,7378,7378,7370,7370,7372,138,140,6,44.24,536
2449,p1106,20100831,7370,7372,7220,7220,7220,7220,7220,-152,-152,2,14.44,536
2450,p1106,20100901,7220,7220,7214,7214,7166,7186,7184,-34,-36,24,172.44,532
2451,p1106,20100902,7186,7184,7240,7248,7184,7232,7220,48,36,446,3220.98,618
2452,p1106,20100903,7232,7220,7254,7326,7254,7308,7304,88,84,318,2322.77,576
2453,p1106,20100906,7308,7304,7448,7450,7216,7418,7410,114,106,218,1615.65,464
2454,p1106,20100907,7418,7410,7400,7464,7370,7464,7418,54,8,12,89.04,456
2455,p1106,20100908,7464,7418,0,0,0,7418,7418,0,0,0,0,456
2456,p1106,20100909,7418,7418,7462,7488,7180,7296,7280,-122,-138,106,771.73,456
2457,p1106,20100910,7296,7280,7384,7388,7360,7360,7378,80,98,12,88.55,452
2458,p1106,20100913,7360,7378,7324,7442,7324,7442,7350,64,-28,36,264.61,476
2459,p1106,20100914,7442,7350,7478,7478,7356,7358,7408,8,58,14,103.74,470
2460,p1106,20100915,7358,7408,0,0,0,7408,7408,0,0,0,0,470
2461,p1106,20100916,7408,7408,7320,7370,7320,7362,7362,-46,-46,104,765.74,502
2462,p1106,20100917,7362,7362,7334,7334,7322,7334,7326,-28,-36,66,483.54,436
2463,p1106,20100920,7334,7326,7500,7560,7500,7560,7530,234,204,4,30.12,438
2464,p1106,20100921,7560,7530,7640,7640,7548,7580,7592,50,62,44,334.06,450
2465,p1106,20100927,7580,7592,7950,7950,7822,7848,7856,256,264,96,754.22,522
2466,p1106,20100928,7848,7856,7780,7780,7780,7780,7780,-76,-76,200,1556,322
2467,p1106,20100929,7780,7780,7744,7794,7686,7710,7738,-70,-42,152,1176.29,242
2468,p1106,20100930,7710,7738,0,0,0,7738,7738,0,0,0,0,242
2469,p1106,20101008,7738,7738,0,0,0,7738,7738,0,0,0,0,242
2470,p1106,20101011,7738,7738,0,0,0,7738,7738,0,0,0,0,242
2471,p1106,20101012,7738,7738,8124,8124,8124,8124,8124,386,386,12,97.49,248
2472,p1106,20101013,8124,8124,0,0,0,8124,8124,0,0,0,0,248
2473,p1106,20101014,8124,8124,8372,8372,8372,8372,8372,248,248,2,16.74,246
2474,p1106,20101015,8372,8372,8276,8370,8276,8352,8338,-20,-34,76,633.76,258
2475,p1106,20101018,8352,8338,8234,8248,8108,8196,8172,-142,-166,116,947.97,272
2476,p1106,20101019,8196,8172,8264,8348,8250,8278,8272,106,100,20,165.45,280
2477,p1106,20101020,8278,8272,8134,8248,8134,8210,8164,-62,-108,60,489.9,280
2478,p1106,20101021,8210,8164,8298,8458,8298,8342,8374,178,210,28,234.48,278
2479,p1106,20101022,8342,8374,8262,8404,8262,8366,8322,-8,-52,52,432.8,260
2480,p1106,20101025,8366,8322,8506,8640,8404,8634,8474,312,152,70,593.23,248
2481,p1106,20101026,8634,8474,8460,8522,8460,8522,8470,48,-4,12,101.64,246
2482,p1106,20101027,8522,8470,8552,8580,8250,8450,8536,-20,66,62,529.29,262
2483,p1106,20101028,8450,8536,0,0,0,8536,8536,0,0,0,0,262
2484,p1106,20101029,8536,8536,0,0,0,8536,8536,0,0,0,0,262
2485,p1106,20101101,8536,8536,8450,8450,8450,8450,8450,-86,-86,2,16.9,260
2486,p1106,20101102,8450,8450,0,0,0,8450,8450,0,0,0,0,260
2487,p1106,20101103,8450,8450,8464,8540,8464,8464,8476,14,26,40,339.05,246
2488,p1106,20101104,8464,8476,0,0,0,8476,8476,0,0,0,0,246
2489,p1106,20101105,8476,8476,8898,8898,8898,8898,8898,422,422,2,17.8,244
2490,p1106,20101108,8898,8898,9296,9340,9296,9340,9318,442,420,4,37.27,246
2491,p1106,20101109,9340,9318,9340,9488,9340,9350,9400,32,82,16,150.43,242
2492,p1106,20101110,9350,9400,0,0,0,9400,9400,0,0,0,0,242
2493,p1106,20101111,9400,9400,0,0,0,9400,9400,0,0,0,0,242
2494,p1106,20101112,9400,9400,9056,9066,8938,8940,8988,-460,-412,14,125.83,242
2495,p1106,20101115,8940,8988,8790,8790,8790,8790,8790,-198,-198,2,17.58,240
2496,p1106,20101116,8790,8790,8930,9120,8930,8970,9030,180,240,24,216.74,232
2497,p1106,20101117,8970,9030,0,0,0,9030,9030,0,0,0,0,232
2498,p1106,20101118,9030,9030,8580,8580,8580,8580,8580,-450,-450,6,51.48,226
2499,p1106,20101119,8580,8580,0,0,0,8580,8580,0,0,0,0,226
2500,p1106,20101122,8580,8580,0,0,0,8580,8580,0,0,0,0,226
2501,p1106,20101123,8580,8580,0,0,0,8580,8580,0,0,0,0,226
2502,p1106,20101124,8580,8580,0,0,0,8580,8580,0,0,0,0,226
2503,p1106,20101125,8580,8580,0,0,0,8580,8580,0,0,0,0,226
2504,p1106,20101126,8580,8580,0,0,0,8580,8580,0,0,0,0,226
2505,p1106,20101129,8580,8580,0,0,0,8580,8580,0,0,0,0,226
2506,p1106,20101130,8580,8580,9086,9086,8622,9006,8904,426,324,18,160.29,236
2507,p1106,20101201,9006,8904,0,0,0,8904,8904,0,0,0,0,236
2508,p1106,20101202,8904,8904,9002,9002,9002,9002,9002,98,98,10,90.02,228
2509,p1106,20101203,9002,9002,0,0,0,9002,9002,0,0,0,0,228
2510,p1106,20101206,9002,9002,9244,9244,9102,9102,9172,100,170,4,36.69,230
2511,p1106,20101207,9102,9172,9298,9298,9252,9252,9266,80,94,6,55.6,230
2512,p1106,20101208,9252,9266,0,0,0,9266,9266,0,0,0,0,230
2513,p1106,20101209,9266,9266,0,0,0,9266,9266,0,0,0,0,230
2514,p1106,20101210,9266,9266,9214,9214,9214,9214,9214,-52,-52,2,18.43,228
2515,p1106,20101213,9214,9214,9386,9386,9386,9386,9386,172,172,2,18.77,228
2516,p1106,20101214,9386,9386,9410,9410,9410,9410,9410,24,24,4,37.64,228
2517,p1106,20101215,9410,9410,0,0,0,9410,9410,0,0,0,0,228
2518,p1106,20101216,9410,9410,0,0,0,9410,9410,0,0,0,0,228
2519,p1106,20101217,9410,9410,0,0,0,9410,9410,0,0,0,0,228
2520,p1106,20101220,9410,9410,0,0,0,9410,9410,0,0,0,0,228
2521,p1106,20101221,9410,9410,0,0,0,9410,9410,0,0,0,0,228
2522,p1106,20101222,9410,9410,9054,9508,9054,9508,9280,98,-130,4,37.12,230
2523,p1106,20101223,9508,9280,9698,9698,9698,9698,9698,418,418,2,19.4,230
2524,p1106,20101224,9698,9698,0,0,0,9698,9698,0,0,0,0,230
2525,p1106,20101227,9698,9698,9700,9700,9324,9650,9606,-48,-92,20,192.14,238
2526,p1106,20101228,9650,9606,9880,9880,9750,9750,9814,144,208,4,39.26,238
2527,p1106,20101229,9750,9814,0,0,0,9814,9814,0,0,0,0,238
2528,p1106,20101230,9814,9814,9718,9718,9700,9700,9714,-114,-100,6,58.29,236
2529,p1106,20101231,9700,9714,9898,9898,9772,9772,9776,58,62,204,1994.54,36
2530,p1107,20100715,,6488,6466,6466,6466,6466,6466,-22,-22,2,12.93,2
2531,p1107,20100716,6466,6466,0,0,0,6466,6466,0,0,0,0,2
2532,p1107,20100719,6466,6466,0,0,0,6466,6466,0,0,0,0,2
2533,p1107,20100720,6466,6466,6700,6700,6700,6700,6700,234,234,2,13.4,4
2534,p1107,20100721,6700,6700,0,0,0,6700,6700,0,0,0,0,4
2535,p1107,20100722,6700,6700,6722,6722,6722,6722,6722,22,22,2,13.44,6
2536,p1107,20100723,6722,6722,6818,6818,6818,6818,6818,96,96,2,13.64,6
2537,p1107,20100726,6818,6818,6762,6798,6762,6790,6782,-28,-36,6,40.7,10
2538,p1107,20100727,6790,6782,6770,6770,6704,6718,6742,-64,-40,10,67.42,6
2539,p1107,20100728,6718,6742,6796,6796,6752,6780,6776,38,34,6,40.66,6
2540,p1107,20100729,6780,6776,6958,6958,6958,6958,6958,182,182,2,13.92,6
2541,p1107,20100730,6958,6958,7098,7098,6900,6900,6998,-58,40,4,28,8
2542,p1107,20100802,6900,6998,0,0,0,6998,6998,0,0,0,0,8
2543,p1107,20100803,6998,6998,7002,7060,7002,7060,7038,62,40,6,42.24,6
2544,p1107,20100804,7060,7038,0,0,0,7038,7038,0,0,0,0,6
2545,p1107,20100805,7038,7038,0,0,0,7038,7038,0,0,0,0,6
2546,p1107,20100806,7038,7038,7230,7230,7230,7230,7230,192,192,2,14.46,8
2547,p1107,20100809,7230,7230,7346,7378,7316,7378,7316,148,86,440,3219.72,430
2548,p1107,20100810,7378,7316,7300,7350,7280,7280,7312,-36,-4,12,87.76,430
2549,p1107,20100811,7280,7312,7220,7220,7220,7220,7220,-92,-92,80,577.6,510
2550,p1107,20100812,7220,7220,7302,7340,7302,7340,7320,120,100,8,58.57,514
2551,p1107,20100813,7340,7320,0,0,0,7320,7320,0,0,0,0,514
2552,p1107,20100816,7320,7320,7644,7644,7450,7450,7532,130,212,10,75.32,514
2553,p1107,20100817,7450,7532,0,0,0,7532,7532,0,0,0,0,514
2554,p1107,20100818,7532,7532,7370,7370,7370,7370,7370,-162,-162,4,29.48,510
2555,p1107,20100819,7370,7370,7330,7362,7330,7362,7338,-8,-32,8,58.7,510
2556,p1107,20100820,7362,7338,7200,7200,7200,7200,7200,-138,-138,2,14.4,510
2557,p1107,20100823,7200,7200,7348,7348,7132,7200,7220,0,20,8,57.76,516
2558,p1107,20100824,7200,7220,0,0,0,7220,7220,0,0,0,0,516
2559,p1107,20100825,7220,7220,7254,7254,7156,7156,7214,-64,-6,38,274.16,514
2560,p1107,20100826,7156,7214,0,0,0,7214,7214,0,0,0,0,514
2561,p1107,20100827,7214,7214,0,0,0,7214,7214,0,0,0,0,514
2562,p1107,20100830,7214,7214,0,0,0,7214,7214,0,0,0,0,514
2563,p1107,20100831,7214,7214,7226,7282,7126,7282,7214,68,0,8,57.71,514
2564,p1107,20100901,7282,7214,0,0,0,7214,7214,0,0,0,0,514
2565,p1107,20100902,7214,7214,7198,7198,7198,7198,7198,-16,-16,2,14.4,514
2566,p1107,20100903,7198,7198,0,0,0,7198,7198,0,0,0,0,514
2567,p1107,20100906,7198,7198,7256,7480,7256,7480,7364,282,166,12,88.38,514
2568,p1107,20100907,7480,7364,0,0,0,7364,7364,0,0,0,0,514
2569,p1107,20100908,7364,7364,7502,7502,7388,7388,7484,24,120,120,898.1,632
2570,p1107,20100909,7388,7484,7330,7366,7180,7356,7328,-128,-156,30,219.9,632
2571,p1107,20100910,7356,7328,0,0,0,7328,7328,0,0,0,0,632
2572,p1107,20100913,7328,7328,7448,7448,7448,7448,7448,120,120,4,29.79,632
2573,p1107,20100914,7448,7448,7400,7426,7400,7426,7412,-22,-36,4,29.65,634
2574,p1107,20100915,7426,7412,0,0,0,7412,7412,0,0,0,0,634
2575,p1107,20100916,7412,7412,7350,7350,7350,7350,7350,-62,-62,100,735,734
2576,p1107,20100917,7350,7350,0,0,0,7350,7350,0,0,0,0,734
2577,p1107,20100920,7350,7350,7672,7702,7630,7658,7660,308,310,14,107.25,734
2578,p1107,20100921,7658,7660,7642,7642,7642,7642,7642,-18,-18,100,764.2,834
2579,p1107,20100927,7642,7642,7860,7860,7860,7860,7860,218,218,4,31.44,834
2580,p1107,20100928,7860,7860,0,0,0,7860,7860,0,0,0,0,834
2581,p1107,20100929,7860,7860,7816,7816,7760,7792,7792,-68,-68,26,202.59,812
2582,p1107,20100930,7792,7792,7654,7654,7654,7654,7654,-138,-138,2,15.31,810
2583,p1107,20101008,7654,7654,0,0,0,7654,7654,0,0,0,0,810
2584,p1107,20101011,7654,7654,0,0,0,7654,7654,0,0,0,0,810
2585,p1107,20101012,7654,7654,8034,8034,8034,8034,8034,380,380,2,16.07,812
2586,p1107,20101013,8034,8034,8200,8200,8200,8200,8200,166,166,2,16.4,812
2587,p1107,20101014,8200,8200,8406,8406,8406,8406,8406,206,206,2,16.81,810
2588,p1107,20101015,8406,8406,0,0,0,8406,8406,0,0,0,0,810
2589,p1107,20101018,8406,8406,0,0,0,8406,8406,0,0,0,0,810
2590,p1107,20101019,8406,8406,0,0,0,8406,8406,0,0,0,0,810
2591,p1107,20101020,8406,8406,8210,8210,8210,8210,8210,-196,-196,2,16.42,810
2592,p1107,20101021,8210,8210,0,0,0,8210,8210,0,0,0,0,810
2593,p1107,20101022,8210,8210,0,0,0,8210,8210,0,0,0,0,810
2594,p1107,20101025,8210,8210,8620,8620,8550,8600,8588,390,378,50,429.44,826
2595,p1107,20101026,8600,8588,8390,8580,8390,8580,8550,-8,-38,26,222.32,806
2596,p1107,20101027,8580,8550,8410,8450,8408,8418,8418,-132,-132,70,589.34,746
2597,p1107,20101028,8418,8418,8514,8514,8514,8514,8514,96,96,120,1021.68,626
2598,p1107,20101029,8514,8514,8720,8720,8250,8250,8540,-264,26,10,85.41,630
2599,p1107,20101101,8250,8540,8360,8786,8360,8626,8596,86,56,70,601.82,630
2600,p1107,20101102,8626,8596,8698,8700,8620,8620,8674,24,78,10,86.75,630
2601,p1107,20101103,8620,8674,8698,8698,8660,8660,8696,-14,22,162,1409,792
2602,p1107,20101104,8660,8696,8730,8730,8730,8730,8730,34,34,2,17.46,790
2603,p1107,20101105,8730,8730,9166,9166,9166,9166,9166,436,436,2,18.33,788
2604,p1107,20101108,9166,9166,9300,9300,9300,9300,9300,134,134,2,18.6,786
2605,p1107,20101109,9300,9300,9730,9730,9476,9476,9602,176,302,4,38.41,788
2606,p1107,20101110,9476,9602,10078,10078,9606,9646,9736,44,134,30,292.08,800
2607,p1107,20101111,9646,9736,9698,9698,9660,9660,9672,-76,-64,8,77.38,800
2608,p1107,20101112,9660,9672,9360,9388,9190,9190,9248,-482,-424,14,129.48,800
2609,p1107,20101115,9190,9248,9000,9110,8786,8786,8918,-462,-330,30,267.55,794
2610,p1107,20101116,8786,8918,8960,9074,8960,9070,9034,152,116,6,54.21,790
2611,p1107,20101117,9070,9034,8600,8600,8600,8600,8600,-434,-434,4,34.4,790
2612,p1107,20101118,8600,8600,0,0,0,8600,8600,0,0,0,0,790
2613,p1107,20101119,8600,8600,8766,8766,8766,8766,8766,166,166,152,1332.43,938
2614,p1107,20101122,8766,8766,0,0,0,8766,8766,0,0,0,0,938
2615,p1107,20101123,8766,8766,8702,8702,8406,8464,8534,-302,-232,10,85.34,938
2616,p1107,20101124,8464,8534,8588,8588,8588,8588,8546,54,12,10,85.46,938
2617,p1107,20101125,8588,8546,0,0,0,8546,8546,0,0,0,0,938
2618,p1107,20101126,8546,8546,8562,8562,8562,8562,8562,16,16,2,17.12,940
2619,p1107,20101129,8562,8562,8700,8700,8698,8698,8698,136,136,70,608.92,870
2620,p1107,20101130,8698,8698,8650,8702,8650,8702,8660,4,-38,250,2165.1,1120
2621,p1107,20101201,8702,8660,8800,8896,8800,8896,8800,236,140,252,2217.79,868
2622,p1107,20101202,8896,8800,0,0,0,8800,8800,0,0,0,0,868
2623,p1107,20101203,8800,8800,0,0,0,8800,8800,0,0,0,0,868
2624,p1107,20101206,8800,8800,0,0,0,8800,8800,0,0,0,0,868
2625,p1107,20101207,8800,8800,9290,9300,9214,9300,9286,500,486,22,204.33,866
2626,p1107,20101208,9300,9286,0,0,0,9286,9286,0,0,0,0,866
2627,p1107,20101209,9286,9286,0,0,0,9286,9286,0,0,0,0,866
2628,p1107,20101210,9286,9286,9136,9202,9136,9202,9180,-84,-106,300,2754.59,1166
2629,p1107,20101213,9202,9180,0,0,0,9180,9180,0,0,0,0,1166
2630,p1107,20101214,9180,9180,9210,9210,9210,9210,9210,30,30,4,36.84,1162
2631,p1107,20101215,9210,9210,0,0,0,9210,9210,0,0,0,0,1162
2632,p1107,20101216,9210,9210,9400,9400,9400,9400,9400,190,190,2,18.8,1164
2633,p1107,20101217,9400,9400,0,0,0,9400,9400,0,0,0,0,1164
2634,p1107,20101220,9400,9400,9464,9504,9464,9504,9472,104,72,102,966.19,1064
2635,p1107,20101221,9504,9472,9440,9440,9440,9440,9440,-32,-32,200,1888,1264
2636,p1107,20101222,9440,9440,9468,9498,9420,9498,9494,58,54,106,1006.42,1362
2637,p1107,20101223,9498,9494,0,0,0,9494,9494,0,0,0,0,1362
2638,p1107,20101224,9494,9494,0,0,0,9494,9494,0,0,0,0,1362
2639,p1107,20101227,9494,9494,0,0,0,9494,9570,0,76,2,19.14,1364
2640,p1107,20101228,9494,9570,0,0,0,9570,9570,0,0,0,0,1364
2641,p1107,20101229,9570,9570,9750,9814,9576,9814,9746,244,176,334,3255.28,1036
2642,p1107,20101230,9814,9746,9630,9630,9630,9630,9630,-116,-116,402,3871.66,634
2643,p1107,20101231,9630,9630,9786,9898,9786,9802,9790,172,160,610,5972.91,30
2644,p1108,20100816,,7318,0,0,0,7318,7318,0,0,0,0,0
2645,p1108,20100817,7318,7318,0,0,0,7318,7318,0,0,0,0,0
2646,p1108,20100818,7318,7318,0,0,0,7318,7318,0,0,0,0,0
2647,p1108,20100819,7318,7318,0,0,0,7318,7318,0,0,0,0,0
2648,p1108,20100820,7318,7318,0,0,0,7318,7318,0,0,0,0,0
2649,p1108,20100823,7318,7318,0,0,0,7318,7318,0,0,0,0,0
2650,p1108,20100824,7318,7318,7200,7302,7200,7302,7250,-16,-68,406,2943.83,6
2651,p1108,20100825,7302,7250,7260,7260,7260,7260,7260,10,10,6,43.56,6
2652,p1108,20100826,7260,7260,0,0,0,7260,7260,0,0,0,0,6
2653,p1108,20100827,7260,7260,7300,7300,7300,7300,7300,40,40,6,43.8,6
2654,p1108,20100830,7300,7300,7392,7392,7392,7392,7392,92,92,2,14.78,4
2655,p1108,20100831,7392,7392,0,0,0,7392,7392,0,0,0,0,4
2656,p1108,20100901,7392,7392,0,0,0,7392,7392,0,0,0,0,4
2657,p1108,20100902,7392,7392,0,0,0,7392,7392,0,0,0,0,4
2658,p1108,20100903,7392,7392,0,0,0,7392,7392,0,0,0,0,4
2659,p1108,20100906,7392,7392,7382,7520,7382,7520,7450,128,58,4,29.8,4
2660,p1108,20100907,7520,7450,7642,7642,7642,7642,7642,192,192,6,45.85,10
2661,p1108,20100908,7642,7642,7514,7584,7514,7584,7530,-58,-112,8,60.25,6
2662,p1108,20100909,7584,7530,7370,7404,7156,7404,7334,-126,-196,12,88.02,6
2663,p1108,20100910,7404,7334,7416,7416,7416,7416,7416,82,82,2,14.83,4
2664,p1108,20100913,7416,7416,0,0,0,7416,7416,0,0,0,0,4
2665,p1108,20100914,7416,7416,7430,7430,7430,7430,7430,14,14,2,14.86,4
2666,p1108,20100915,7430,7430,0,0,0,7430,7430,0,0,0,0,4
2667,p1108,20100916,7430,7430,7420,7420,7420,7420,7420,-10,-10,2,14.84,6
2668,p1108,20100917,7420,7420,7302,7494,7302,7446,7400,26,-20,30,222.01,14
2669,p1108,20100920,7446,7400,7576,7758,7576,7720,7692,320,292,14,107.71,16
2670,p1108,20100921,7720,7692,7692,7692,7670,7670,7690,-22,-2,142,1092.22,154
2671,p1108,20100927,7670,7690,7888,7888,7888,7888,7888,198,198,2,15.78,152
2672,p1108,20100928,7888,7888,7814,7868,7814,7868,7840,-20,-48,4,31.36,152
2673,p1108,20100929,7868,7840,0,0,0,7840,7840,0,0,0,0,152
2674,p1108,20100930,7840,7840,7728,7780,7728,7780,7754,-60,-86,4,31.02,152
2675,p1108,20101008,7780,7754,0,0,0,7754,7754,0,0,0,0,152
2676,p1108,20101011,7754,7754,0,0,0,7754,7754,0,0,0,0,152
2677,p1108,20101012,7754,7754,8138,8138,8138,8138,8138,384,384,4,32.55,154
2678,p1108,20101013,8138,8138,0,0,0,8138,8138,0,0,0,0,154
2679,p1108,20101014,8138,8138,8514,8514,8412,8412,8446,274,308,6,50.68,154
2680,p1108,20101015,8412,8446,8422,8422,8418,8418,8420,-28,-26,4,33.68,152
2681,p1108,20101018,8418,8420,8068,8068,8068,8068,8068,-352,-352,2,16.14,152
2682,p1108,20101019,8068,8068,8202,8202,8202,8202,8202,134,134,140,1148.28,12
2683,p1108,20101020,8202,8202,0,0,0,8202,8202,0,0,0,0,12
2684,p1108,20101021,8202,8202,0,0,0,8202,8202,0,0,0,0,12
2685,p1108,20101022,8202,8202,0,0,0,8202,8202,0,0,0,0,12
2686,p1108,20101025,8202,8202,0,0,0,8202,8202,0,0,0,0,12
2687,p1108,20101026,8202,8202,8612,8612,8516,8516,8588,314,386,8,68.7,16
2688,p1108,20101027,8516,8588,8782,8782,8510,8510,8614,-78,26,18,155.06,14
2689,p1108,20101028,8510,8614,8624,8624,8346,8520,8496,-94,-118,26,220.9,12
2690,p1108,20101029,8520,8496,8582,8582,8498,8498,8540,2,44,20,170.8,12
2691,p1108,20101101,8498,8540,0,0,0,8540,8540,0,0,0,0,12
2692,p1108,20101102,8540,8540,8750,8750,8650,8650,8696,110,156,26,226.1,14
2693,p1108,20101103,8650,8696,0,0,0,8696,8696,0,0,0,0,14
2694,p1108,20101104,8696,8696,8850,8850,8850,8850,8850,154,154,2,17.7,14
2695,p1108,20101105,8850,8850,0,0,0,8850,8850,0,0,0,0,14
2696,p1108,20101108,8850,8850,0,0,0,8850,8850,0,0,0,0,14
2697,p1108,20101109,8850,8850,0,0,0,8850,8850,0,0,0,0,14
2698,p1108,20101110,8850,8850,9292,9292,9292,9292,9292,442,442,8,74.34,8
2699,p1108,20101111,9292,9292,8828,9754,8828,9544,9300,252,8,10,93.01,10
2700,p1108,20101112,9544,9300,9172,9278,8896,8896,9052,-404,-248,16,144.84,10
2701,p1108,20101115,8896,9052,9504,9504,8662,8802,9090,-250,38,24,218.17,10
2702,p1108,20101116,8802,9090,0,0,0,9090,9090,0,0,0,0,10
2703,p1108,20101117,9090,9090,0,0,0,9090,9090,0,0,0,0,10
2704,p1108,20101118,9090,9090,8790,8790,8790,8790,8790,-300,-300,2,17.58,10
2705,p1108,20101119,8790,8790,8664,8836,8586,8760,8732,-30,-58,12,104.79,10
2706,p1108,20101122,8760,8732,0,0,0,8732,8732,0,0,0,0,10
2707,p1108,20101123,8732,8732,8296,8650,8296,8650,8406,-82,-326,24,201.75,10
2708,p1108,20101124,8650,8406,8666,8684,8580,8580,8614,174,208,22,189.52,10
2709,p1108,20101125,8580,8614,0,0,0,8614,8614,0,0,0,0,10
2710,p1108,20101126,8614,8614,8550,8756,8550,8662,8644,48,30,28,242.08,10
2711,p1108,20101129,8662,8644,8998,8998,8578,8578,8788,-66,144,12,105.46,10
2712,p1108,20101130,8578,8788,0,0,0,8788,8788,0,0,0,0,10
2713,p1108,20101201,8788,8788,0,0,0,8788,8788,0,0,0,0,10
2714,p1108,20101202,8788,8788,9310,9310,9182,9182,9246,394,458,4,36.98,14
2715,p1108,20101203,9182,9246,8990,9218,8990,9048,9106,-198,-140,14,127.5,12
2716,p1108,20101206,9048,9106,0,0,0,9106,9106,0,0,0,0,12
2717,p1108,20101207,9106,9106,9122,9598,9122,9340,9246,234,140,818,7564.43,810
2718,p1108,20101208,9340,9246,0,0,0,9246,9246,0,0,0,0,810
2719,p1108,20101209,9246,9246,9346,9374,9064,9130,9248,-116,2,24,221.98,814
2720,p1108,20101210,9130,9248,0,0,0,9248,9248,0,0,0,0,814
2721,p1108,20101213,9248,9248,9370,9498,9222,9498,9362,250,114,34,318.32,812
2722,p1108,20101214,9498,9362,9530,9530,9346,9412,9408,50,46,8,75.27,812
2723,p1108,20101215,9412,9408,9242,9548,9242,9490,9458,82,50,12,113.5,812
2724,p1108,20101216,9490,9458,9312,9406,9312,9406,9358,-52,-100,4,37.44,812
2725,p1108,20101217,9406,9358,9480,9480,9400,9400,9426,42,68,6,56.56,810
2726,p1108,20101220,9400,9426,9454,9588,9298,9422,9476,-4,50,838,7942,16
2727,p1108,20101221,9422,9476,9344,9438,9344,9420,9378,-56,-98,18,168.81,12
2728,p1108,20101222,9420,9378,9460,9460,9460,9460,9460,82,82,4,37.84,8
2729,p1108,20101223,9460,9460,9548,9548,9500,9500,9524,40,64,4,38.1,6
2730,p1108,20101224,9500,9524,9356,9618,9356,9618,9486,94,-38,4,37.95,6
2731,p1108,20101227,9618,9486,9784,9784,9602,9706,9696,220,210,36,349.06,10
2732,p1108,20101228,9706,9696,9840,9840,9840,9840,9840,144,144,4,39.36,10
2733,p1108,20101229,9840,9840,9752,9950,9572,9670,9730,-170,-110,14,136.23,8
2734,p1108,20101230,9670,9730,0,0,0,9730,9730,0,0,0,0,8
2735,p1108,20101231,9730,9730,0,0,0,9730,9730,0,0,0,0,8
2736,p1109,20100915,,7358,7514,7514,7412,7452,7438,94,80,114,848.07,60
2737,p1109,20100916,7452,7438,7440,7476,7358,7420,7422,-18,-16,140,1039.28,74
2738,p1109,20100917,7420,7422,7430,7442,7396,7430,7420,8,-2,60,445.25,88
2739,p1109,20100920,7430,7420,7680,7790,7662,7742,7760,322,340,1220,9468.34,888
2740,p1109,20100921,7742,7760,7712,7734,7652,7702,7698,-58,-62,558,4296.31,868
2741,p1109,20100927,7702,7698,8000,8040,7860,7924,7952,226,254,784,6234.5,1232
2742,p1109,20100928,7924,7952,7854,7930,7854,7910,7896,-42,-56,312,2464.08,1378
2743,p1109,20100929,7910,7896,7848,7848,7684,7760,7738,-136,-158,776,6006.05,1012
2744,p1109,20100930,7760,7738,7688,7820,7672,7820,7774,82,36,412,3203.32,1166
2745,p1109,20101008,7820,7774,7800,7934,7780,7856,7880,82,106,1182,9314.83,1454
2746,p1109,20101011,7856,7880,8274,8274,8274,8274,8274,394,394,50,413.7,1438
2747,p1109,20101012,8274,8274,8176,8310,8142,8246,8224,-28,-50,1996,16415.68,1488
2748,p1109,20101013,8246,8224,8200,8324,8200,8272,8254,48,30,3404,28097.58,2046
2749,p1109,20101014,8272,8254,8358,8410,8300,8354,8372,100,118,2392,20029.13,3262
2750,p1109,20101015,8354,8372,8374,8374,8310,8348,8348,-24,-24,2712,22641.17,4698
2751,p1109,20101018,8348,8348,8218,8248,8090,8120,8138,-228,-210,5184,42189.08,5586
2752,p1109,20101019,8120,8138,8162,8270,8128,8190,8208,52,70,8016,65803.02,8468
2753,p1109,20101020,8190,8208,8104,8194,8018,8158,8146,-50,-62,2874,23415.06,9234
2754,p1109,20101021,8158,8146,8360,8442,8270,8320,8362,174,216,13242,110754.34,15034
2755,p1109,20101022,8320,8362,8322,8444,8306,8404,8402,42,40,16966,142573.98,23400
2756,p1109,20101025,8404,8402,8470,8720,8460,8672,8636,270,234,38370,331414.34,31036
2757,p1109,20101026,8672,8636,8650,8692,8572,8580,8622,-56,-14,36584,315481.68,33404
2758,p1109,20101027,8580,8622,8638,8680,8260,8412,8508,-210,-114,46394,394743.17,25120
2759,p1109,20101028,8412,8508,8500,8674,8480,8666,8588,158,80,79716,684747.45,47206
2760,p1109,20101029,8666,8588,8626,8650,8464,8464,8544,-124,-44,172088,1470361.95,58300
2761,p1109,20101101,8464,8544,8550,8674,8522,8618,8616,74,72,172374,1485485.66,75426
2762,p1109,20101102,8618,8616,8650,8740,8570,8664,8660,48,44,267186,2314231.01,78678
2763,p1109,20101103,8664,8660,8678,8730,8590,8638,8674,-22,14,226684,1966279.93,88104
2764,p1109,20101104,8638,8674,8700,8988,8666,8962,8840,288,166,460408,4070824.63,146838
2765,p1109,20101105,8962,8840,9052,9282,9052,9282,9236,442,396,239840,2215291.2,157672
2766,p1109,20101108,9282,9236,9266,9688,9186,9466,9468,230,232,646260,6119155.45,158014
2767,p1109,20101109,9466,9468,9420,9706,9380,9574,9566,106,98,715358,6843613.4,169758
2768,p1109,20101110,9574,9566,9650,9772,9526,9556,9660,-10,94,642002,6202541.38,165450
2769,p1109,20101111,9556,9660,9620,9718,9512,9574,9634,-86,-26,553812,5335685.54,189812
2770,p1109,20101112,9574,9634,9574,9600,9154,9154,9260,-480,-374,458192,4243313.5,150842
2771,p1109,20101115,9154,9260,9034,9262,8806,9044,9050,-216,-210,700560,6340515.42,140144
2772,p1109,20101116,9044,9050,9128,9176,8934,8954,9044,-96,-6,558954,5056090.73,141342
2773,p1109,20101117,8954,9044,8592,8630,8592,8592,8596,-452,-448,83740,719940.32,130298
2774,p1109,20101118,8592,8596,8660,8732,8352,8656,8572,60,-24,555788,4764572.98,123414
2775,p1109,20101119,8656,8572,8820,8860,8610,8830,8752,258,180,531958,4656694.51,148520
2776,p1109,20101122,8830,8752,8560,8682,8538,8558,8622,-194,-130,401660,3463858.22,141210
2777,p1109,20101123,8558,8622,8600,8640,8410,8448,8504,-174,-118,473372,4026482.2,133882
2778,p1109,20101124,8448,8504,8522,8660,8510,8658,8586,154,82,357452,3069379.57,131646
2779,p1109,20101125,8658,8586,8650,8808,8650,8688,8742,102,156,356416,3116218.7,122880
2780,p1109,20101126,8688,8742,8732,8746,8494,8626,8618,-116,-124,527458,4546513.13,138318
2781,p1109,20101129,8626,8618,8600,8776,8540,8776,8664,158,46,414928,3595737.78,167390
2782,p1109,20101130,8776,8664,8750,8850,8624,8844,8738,180,74,435758,3807792.8,166504
2783,p1109,20101201,8844,8738,8804,9010,8792,8984,8920,246,182,595126,5308603.75,192878
2784,p1109,20101202,8984,8920,9106,9156,9052,9066,9092,146,172,313958,2854788.52,192328
2785,p1109,20101203,9066,9092,9046,9134,9026,9084,9074,-8,-18,302122,2741920.49,178210
2786,p1109,20101206,9084,9074,9150,9240,9080,9230,9176,156,102,388348,3563769.18,195246
2787,p1109,20101207,9230,9176,9202,9354,9178,9352,9270,176,94,514188,4766861.39,217504
2788,p1109,20101208,9352,9270,9190,9260,9060,9072,9172,-198,-98,431526,3958330.47,187692
2789,p1109,20101209,9072,9172,9238,9284,9158,9210,9226,38,54,366354,3380488.43,188032
2790,p1109,20101210,9210,9226,9188,9218,9132,9196,9170,-30,-56,269338,2469866.04,186894
2791,p1109,20101213,9196,9170,9150,9450,9150,9414,9342,244,172,319524,2985349.56,211606
2792,p1109,20101214,9414,9342,9450,9490,9380,9464,9432,122,90,308760,2912557.07,209248
2793,p1109,20101215,9464,9432,9412,9556,9334,9350,9446,-82,14,398414,3763899.71,200094
2794,p1109,20101216,9350,9446,9376,9406,9318,9352,9364,-94,-82,228882,2143252.57,199746
2795,p1109,20101217,9352,9364,9352,9450,9338,9400,9410,36,46,241226,2270106.07,188230
2796,p1109,20101220,9400,9410,9452,9514,9204,9340,9400,-70,-10,332634,3127336.41,176984
2797,p1109,20101221,9340,9400,9440,9482,9370,9466,9422,66,22,279556,2634427.9,177328
2798,p1109,20101222,9466,9422,9520,9530,9410,9444,9472,22,50,202356,1917057.14,171354
2799,p1109,20101223,9444,9472,9488,9676,9472,9648,9586,176,114,283236,2715600.89,174010
2800,p1109,20101224,9648,9586,9698,9706,9526,9656,9624,70,38,219074,2108606.64,163776
2801,p1109,20101227,9656,9624,9600,9766,9576,9734,9698,110,74,315972,3064590.64,166406
2802,p1109,20101228,9734,9698,9800,9890,9766,9814,9838,116,140,256362,2522416.46,160038
2803,p1109,20101229,9814,9838,9796,9820,9640,9672,9720,-166,-118,250426,2434619.04,153228
2804,p1109,20101230,9672,9720,9638,9776,9582,9770,9674,50,-46,212312,2053919.3,154752
2805,p1109,20101231,9770,9674,9708,9830,9682,9786,9766,112,92,167614,1637087,152554
2806,p1110,20101022,,8146,0,0,0,8146,8146,0,0,0,0,0
2807,p1110,20101025,8146,8146,0,0,0,8146,8146,0,0,0,0,0
2808,p1110,20101026,8146,8146,0,0,0,8146,8146,0,0,0,0,0
2809,p1110,20101027,8146,8146,0,0,0,8146,8146,0,0,0,0,0
2810,p1110,20101028,8146,8146,8774,8774,8430,8502,8582,356,436,12,103,4
2811,p1110,20101029,8502,8582,8580,8580,8500,8500,8540,-82,-42,4,34.16,0
2812,p1110,20101101,8500,8540,0,0,0,8540,8540,0,0,0,0,0
2813,p1110,20101102,8540,8540,0,0,0,8540,8540,0,0,0,0,0
2814,p1110,20101103,8540,8540,0,0,0,8540,8540,0,0,0,0,0
2815,p1110,20101104,8540,8540,8966,8966,8966,8966,8966,426,426,2,17.93,2
2816,p1110,20101105,8966,8966,0,0,0,8966,8966,0,0,0,0,2
2817,p1110,20101108,8966,8966,9344,9344,9244,9244,9246,278,280,82,758.21,80
2818,p1110,20101109,9244,9246,9498,9704,9450,9450,9516,204,270,84,799.47,0
2819,p1110,20101110,9450,9516,9682,9682,9542,9646,9622,130,106,6,57.74,2
2820,p1110,20101111,9646,9622,9540,9732,9482,9540,9604,-82,-18,28,268.95,6
2821,p1110,20101112,9540,9604,9234,9394,9124,9170,9234,-434,-370,16,147.76,2
2822,p1110,20101115,9170,9234,0,0,0,9234,9234,0,0,0,0,2
2823,p1110,20101116,9234,9234,0,0,0,9234,9234,0,0,0,0,2
2824,p1110,20101117,9234,9234,0,0,0,9234,9234,0,0,0,0,2
2825,p1110,20101118,9234,9234,0,0,0,9234,9234,0,0,0,0,2
2826,p1110,20101119,9234,9234,8858,8926,8858,8926,8906,-308,-328,16,142.5,14
2827,p1110,20101122,8926,8906,8998,8998,8468,8600,8664,-306,-242,10,86.65,8
2828,p1110,20101123,8600,8664,8450,8714,8442,8554,8574,-110,-90,42,360.16,8
2829,p1110,20101124,8554,8574,8670,8704,8580,8640,8638,66,64,68,587.48,14
2830,p1110,20101125,8640,8638,8806,8822,8806,8822,8816,184,178,8,70.54,10
2831,p1110,20101126,8822,8816,8706,8710,8614,8660,8672,-156,-144,18,156.13,10
2832,p1110,20101129,8660,8672,8744,8790,8744,8790,8754,118,82,10,87.55,10
2833,p1110,20101130,8790,8754,8778,8890,8700,8890,8772,136,18,92,807.18,34
2834,p1110,20101201,8890,8772,8968,9060,8854,9060,8912,288,140,38,338.7,36
2835,p1110,20101202,9060,8912,9084,9084,9046,9046,9064,134,152,4,36.26,38
2836,p1110,20101203,9046,9064,8984,9126,8984,9102,9072,38,8,20,181.47,30
2837,p1110,20101206,9102,9072,9170,9238,9122,9238,9162,166,90,18,164.92,28
2838,p1110,20101207,9238,9162,9282,9418,9272,9418,9366,256,204,64,599.44,54
2839,p1110,20101208,9418,9366,9270,9290,9174,9200,9234,-166,-132,66,609.51,24
2840,p1110,20101209,9200,9234,0,0,0,9234,9234,0,0,0,0,24
2841,p1110,20101210,9234,9234,9224,9224,9224,9224,9224,-10,-10,2,18.45,24
2842,p1110,20101213,9224,9224,9368,9452,9368,9450,9422,226,198,12,113.07,24
2843,p1110,20101214,9450,9422,9528,9528,9524,9524,9526,102,104,8,76.21,26
2844,p1110,20101215,9524,9526,9584,9586,9386,9428,9546,-98,20,28,267.33,24
2845,p1110,20101216,9428,9546,9480,9480,9480,9480,9480,-66,-66,2,18.96,24
2846,p1110,20101217,9480,9480,9466,9466,9400,9460,9440,-20,-40,24,226.59,24
2847,p1110,20101220,9460,9440,9460,9504,9314,9372,9390,-68,-50,18,169.02,28
2848,p1110,20101221,9372,9390,9454,9536,9454,9536,9494,146,104,4,37.98,30
2849,p1110,20101222,9536,9494,9534,9560,9534,9560,9546,66,52,4,38.19,28
2850,p1110,20101223,9560,9546,9648,9648,9552,9586,9604,40,58,8,76.84,26
2851,p1110,20101224,9586,9604,9770,9770,9692,9692,9738,88,134,12,116.86,20
2852,p1110,20101227,9692,9738,9860,9860,9860,9860,9860,122,122,2,19.72,22
2853,p1110,20101228,9860,9860,9870,9920,9870,9920,9904,60,44,16,158.48,14
2854,p1110,20101229,9920,9904,9756,9868,9720,9720,9780,-184,-124,6,58.69,14
2855,p1110,20101230,9720,9780,0,0,0,9780,9780,0,0,0,0,14
2856,p1110,20101231,9780,9780,9866,9866,9780,9780,9822,0,42,4,39.29,14
2857,p1111,20101115,,9152,0,0,0,9152,9152,0,0,0,0,0
2858,p1111,20101116,9152,9152,8860,8860,8860,8860,8860,-292,-292,140,1240.4,140
2859,p1111,20101117,8860,8860,0,0,0,8860,8860,0,0,0,0,140
2860,p1111,20101118,8860,8860,8600,8800,8600,8800,8742,-60,-118,140,1224,280
2861,p1111,20101119,8800,8742,0,0,0,8742,8742,0,0,0,0,280
2862,p1111,20101122,8742,8742,0,0,0,8742,8742,0,0,0,0,280
2863,p1111,20101123,8742,8742,0,0,0,8742,8742,0,0,0,0,280
2864,p1111,20101124,8742,8742,0,0,0,8742,8742,0,0,0,0,280
2865,p1111,20101125,8742,8742,8998,9142,8704,9142,8948,400,206,6,53.69,282
2866,p1111,20101126,9142,8948,8522,8722,8522,8600,8602,-348,-346,96,825.93,372
2867,p1111,20101129,8600,8602,8690,8690,8690,8690,8690,88,88,60,521.4,432
2868,p1111,20101130,8690,8690,8580,8580,8580,8580,8580,-110,-110,130,1115.4,302
2869,p1111,20101201,8580,8580,8846,9092,8846,9070,8984,490,404,10,89.84,302
2870,p1111,20101202,9070,8984,9140,9140,9140,9140,9140,156,156,50,457,352
2871,p1111,20101203,9140,9140,9126,9126,9126,9126,9126,-14,-14,2,18.25,352
2872,p1111,20101206,9126,9126,9644,9644,8690,9242,9266,116,140,12,111.21,356
2873,p1111,20101207,9242,9266,9200,9380,9200,9340,9330,74,64,20,186.6,348
2874,p1111,20101208,9340,9330,9250,9298,9136,9298,9228,-32,-102,6,55.37,348
2875,p1111,20101209,9298,9228,0,0,0,9228,9228,0,0,0,0,348
2876,p1111,20101210,9228,9228,0,0,0,9228,9228,0,0,0,0,348
2877,p1111,20101213,9228,9228,9398,9398,9398,9398,9398,170,170,2,18.8,348
2878,p1111,20101214,9398,9398,9166,9634,8836,9452,9298,54,-100,208,1934.36,362
2879,p1111,20101215,9452,9298,9456,9578,9450,9450,9522,152,224,28,266.66,364
2880,p1111,20101216,9450,9522,9400,9446,9362,9446,9402,-76,-120,6,56.42,364
2881,p1111,20101217,9446,9402,9478,9478,9478,9478,9478,76,76,2,18.96,362
2882,p1111,20101220,9478,9478,9426,9426,9426,9426,9426,-52,-52,2,18.85,362
2883,p1111,20101221,9426,9426,0,0,0,9426,9426,0,0,0,0,362
2884,p1111,20101222,9426,9426,0,0,0,9426,9426,0,0,0,0,362
2885,p1111,20101223,9426,9426,9700,9700,9700,9700,9700,274,274,4,38.8,360
2886,p1111,20101224,9700,9700,9844,9844,9844,9844,9844,144,144,2,19.69,362
2887,p1111,20101227,9844,9844,9722,9820,9722,9820,9770,-24,-74,4,39.08,364
2888,p1111,20101228,9820,9770,9842,9860,9820,9820,9840,50,70,6,59.04,360
2889,p1111,20101229,9820,9840,9752,9778,9752,9778,9762,-62,-78,10,97.64,360
2890,p1111,20101230,9778,9762,9690,9858,9690,9858,9690,96,-72,202,1957.72,162
2891,p1111,20101231,9858,9690,9812,9812,9792,9792,9802,102,112,4,39.21,160
2892,p1112,20101215,,9342,0,0,0,9342,9342,0,0,0,0,0
2893,p1112,20101216,9342,9342,0,0,0,9342,9342,0,0,0,0,0
2894,p1112,20101217,9342,9342,0,0,0,9342,9342,0,0,0,0,0
2895,p1112,20101220,9342,9342,0,0,0,9342,9342,0,0,0,0,0
2896,p1112,20101221,9342,9342,0,0,0,9342,9342,0,0,0,0,0
2897,p1112,20101222,9342,9342,0,0,0,9342,9342,0,0,0,0,0
2898,p1112,20101223,9342,9342,0,0,0,9342,9342,0,0,0,0,0
2899,p1112,20101224,9342,9342,0,0,0,9342,9342,0,0,0,0,0
2900,p1112,20101227,9342,9342,0,0,0,9342,9342,0,0,0,0,0
2901,p1112,20101228,9342,9342,0,0,0,9342,9342,0,0,0,0,0
2902,p1112,20101229,9342,9342,0,0,0,9342,9342,0,0,0,0,0
2903,p1112,20101230,9342,9342,0,0,0,9342,9342,0,0,0,0,0
2904,p1112,20101231,9342,9342,0,0,0,9342,9342,0,0,0,0,0