   ,合约,日期,前收盘价,前结算价,开盘价,最高价,最低价,收盘价,结算价,涨跌1,涨跌2,成交量,成交金额,持仓量
1,p1201,20120104,7548,7536,7690,7700,7690,7700,7698,164,162,66,5081520,3696
2,p1201,20120105,7700,7698,7668,7668,7668,7668,7668,-30,-30,10,766800,3696
3,p1201,20120106,7668,7668,7602,7638,7602,7638,7632,-30,-36,26,1984440,3696
4,p1201,20120109,7638,7632,7640,7650,7640,7650,7644,18,12,134,10244320,3696
5,p1201,20120110,7650,7644,7688,7690,7688,7690,7634,46,-10,320,24432240,3696
6,p1201,20120111,7690,7634,0,0,0,7634,7634,0,0,0,0,3696
7,p1201,20120112,7634,7634,0,0,0,7634,7634,0,0,0,0,3696
8,p1201,20120113,7634,7634,0,0,0,7634,7634,0,0,0,0,3696
9,p1201,20120116,7634,7634,7350,7350,7350,7350,7350,-284,-284,10,735000,3686
10,p1201,20120117,7350,7350,0,0,0,7350,7640,0,290,0,0,0
11,p1202,20120104,7728,7728,7700,7700,7700,7700,7700,-28,-28,2,154000,18
12,p1202,20120105,7700,7700,7650,7650,7650,7650,7650,-50,-50,2,153000,18
13,p1202,20120106,7650,7650,7686,7686,7686,7686,7686,36,36,2,153720,18
14,p1202,20120109,7686,7686,7602,7602,7602,7602,7602,-84,-84,2,152040,18
15,p1202,20120110,7602,7602,7618,7618,7618,7618,7618,16,16,2,152360,18
16,p1202,20120111,7618,7618,7666,7666,7666,7666,7666,48,48,2,153320,18
17,p1202,20120112,7666,7666,0,0,0,7666,7666,0,0,0,0,18
18,p1202,20120113,7666,7666,0,0,0,7666,7666,0,0,0,0,18
19,p1202,20120116,7666,7666,0,0,0,7666,7666,0,0,0,0,18
20,p1202,20120117,7666,7666,0,0,0,7666,7666,0,0,0,0,18
21,p1202,20120118,7666,7666,7284,7288,7284,7284,7284,-382,-382,16,1165680,18
22,p1202,20120119,7284,7284,0,0,0,7284,7284,0,0,0,0,18
23,p1202,20120120,7284,7284,7198,7198,6844,6864,6922,-420,-362,12,830680,18
24,p1202,20120130,6864,6922,7008,7008,6990,6990,6998,68,76,6,419920,20
25,p1202,20120131,6990,6998,7278,7278,6650,6650,6858,-348,-140,6,411560,18
26,p1202,20120201,6650,6858,0,0,0,6858,6858,0,0,0,0,18
27,p1202,20120202,6858,6858,0,0,0,6858,6858,0,0,0,0,18
28,p1202,20120203,6858,6858,0,0,0,6858,6858,0,0,0,0,18
29,p1202,20120206,6858,6858,6998,7000,6998,7000,6998,142,140,14,979760,18
30,p1202,20120207,7000,6998,0,0,0,6998,6998,0,0,0,0,18
31,p1202,20120208,6998,6998,0,0,0,6998,6998,0,0,0,0,18
32,p1202,20120209,6998,6998,0,0,0,6998,6998,0,0,0,0,18
33,p1202,20120210,6998,6998,0,0,0,6998,6998,0,0,0,0,18
34,p1202,20120213,6998,6998,0,0,0,6998,6998,0,0,0,0,18
35,p1202,20120214,6998,6998,0,0,0,6998,6998,0,0,0,0,0
36,p1203,20120104,7810,7810,0,0,0,7810,7810,0,0,0,0,14
37,p1203,20120105,7810,7810,0,0,0,7810,7810,0,0,0,0,14
38,p1203,20120106,7810,7810,0,0,0,7810,7810,0,0,0,0,14
39,p1203,20120109,7810,7810,0,0,0,7810,7810,0,0,0,0,14
40,p1203,20120110,7810,7810,8124,8124,7802,7802,7934,-8,124,8,634720,14
41,p1203,20120111,7802,7934,0,0,0,7934,7934,0,0,0,0,14
42,p1203,20120112,7934,7934,0,0,0,7934,7934,0,0,0,0,14
43,p1203,20120113,7934,7934,0,0,0,7934,7934,0,0,0,0,14
44,p1203,20120116,7934,7934,0,0,0,7934,7934,0,0,0,0,14
45,p1203,20120117,7934,7934,0,0,0,7934,7934,0,0,0,0,14
46,p1203,20120118,7934,7934,7960,7960,7538,7538,7774,-396,-160,8,621960,14
47,p1203,20120119,7538,7774,0,0,0,7774,7774,0,0,0,0,14
48,p1203,20120120,7774,7774,0,0,0,7774,7774,0,0,0,0,14
49,p1203,20120130,7774,7774,0,0,0,7774,7774,0,0,0,0,14
50,p1203,20120131,7774,7774,0,0,0,7774,7774,0,0,0,0,14
51,p1203,20120201,7774,7774,0,0,0,7774,7774,0,0,0,0,14
52,p1203,20120202,7774,7774,0,0,0,7774,7774,0,0,0,0,14
53,p1203,20120203,7774,7774,0,0,0,7774,7774,0,0,0,0,14
54,p1203,20120206,7774,7774,0,0,0,7774,7774,0,0,0,0,14
55,p1203,20120207,7774,7774,0,0,0,7774,7774,0,0,0,0,14
56,p1203,20120208,7774,7774,0,0,0,7774,7774,0,0,0,0,14
57,p1203,20120209,7774,7774,0,0,0,7774,7774,0,0,0,0,14
58,p1203,20120210,7774,7774,0,0,0,7774,7774,0,0,0,0,14
59,p1203,20120213,7774,7774,0,0,0,7774,7774,0,0,0,0,14
60,p1203,20120214,7774,7774,7998,7998,7386,7386,7692,-388,-82,20,1538400,20
61,p1203,20120215,7386,7692,7600,8060,7308,7308,7576,-384,-116,16,1212320,14
62,p1203,20120216,7308,7576,0,0,0,7576,7576,0,0,0,0,14
63,p1203,20120217,7576,7576,7202,7202,7198,7198,7198,-378,-378,16,1151840,14
64,p1203,20120220,7198,7198,7200,7200,7200,7200,7200,2,2,2,144000,14
65,p1203,20120221,7200,7200,0,0,0,7200,7200,0,0,0,0,14
66,p1203,20120222,7200,7200,0,0,0,7200,7200,0,0,0,0,14
67,p1203,20120223,7200,7200,0,0,0,7200,7200,0,0,0,0,14
68,p1203,20120224,7200,7200,0,0,0,7200,7200,0,0,0,0,14
69,p1203,20120227,7200,7200,0,0,0,7200,7200,0,0,0,0,14
70,p1203,20120228,7200,7200,0,0,0,7200,7200,0,0,0,0,14
71,p1203,20120229,7200,7200,7200,7200,7200,7200,7200,0,0,2,144000,14
72,p1203,20120301,7200,7200,0,0,0,7200,7200,0,0,0,0,14
73,p1203,20120302,7200,7200,0,0,0,7200,7200,0,0,0,0,14
74,p1203,20120305,7200,7200,0,0,0,7200,7200,0,0,0,0,14
75,p1203,20120306,7200,7200,0,0,0,7200,7200,0,0,0,0,14
76,p1203,20120307,7200,7200,0,0,0,7200,7200,0,0,0,0,14
77,p1203,20120308,7200,7200,0,0,0,7200,7200,0,0,0,0,14
78,p1203,20120309,7200,7200,0,0,0,7200,7200,0,0,0,0,14
79,p1203,20120312,7200,7200,0,0,0,7200,7200,0,0,0,0,14
80,p1203,20120313,7200,7200,0,0,0,7200,7200,0,0,0,0,14
81,p1203,20120314,7200,7200,0,0,0,7200,7200,0,0,0,0,0
82,p1204,20120104,8042,8042,0,0,0,8042,8042,0,0,0,0,0
83,p1204,20120105,8042,8042,0,0,0,8042,8042,0,0,0,0,0
84,p1204,20120106,8042,8042,0,0,0,8042,8042,0,0,0,0,0
85,p1204,20120109,8042,8042,0,0,0,8042,8042,0,0,0,0,0
86,p1204,20120110,8042,8042,0,0,0,8042,8042,0,0,0,0,0
87,p1204,20120111,8042,8042,0,0,0,8042,8042,0,0,0,0,0
88,p1204,20120112,8042,8042,0,0,0,8042,8042,0,0,0,0,0
89,p1204,20120113,8042,8042,0,0,0,8042,8042,0,0,0,0,0
90,p1204,20120116,8042,8042,0,0,0,8042,8042,0,0,0,0,0
91,p1204,20120117,8042,8042,0,0,0,8042,8042,0,0,0,0,0
92,p1204,20120118,8042,8042,0,0,0,8042,8042,0,0,0,0,0
93,p1204,20120119,8042,8042,0,0,0,8042,8042,0,0,0,0,0
94,p1204,20120120,8042,8042,0,0,0,8042,8042,0,0,0,0,0
95,p1204,20120130,8042,8042,0,0,0,8042,8042,0,0,0,0,0
96,p1204,20120131,8042,8042,0,0,0,8042,8042,0,0,0,0,0
97,p1204,20120201,8042,8042,0,0,0,8042,8042,0,0,0,0,0
98,p1204,20120202,8042,8042,7716,7728,7716,7724,7722,-318,-320,8,617840,4
99,p1204,20120203,7724,7722,0,0,0,7722,7722,0,0,0,0,4
100,p1204,20120206,7722,7722,7790,7790,7790,7790,7790,68,68,4,311600,0
101,p1204,20120207,7790,7790,8170,8170,7698,8020,7962,230,172,6,477760,0
102,p1204,20120208,8020,7962,0,0,0,7962,7962,0,0,0,0,0
103,p1204,20120209,7962,7962,8228,8228,8228,8228,8228,266,266,2,164560,2
104,p1204,20120210,8228,8228,7900,7900,7900,7900,7900,-328,-328,2,158000,2
105,p1204,20120213,7900,7900,0,0,0,7900,7900,0,0,0,0,2
106,p1204,20120214,7900,7900,8004,8100,8004,8100,8052,200,152,4,322080,0
107,p1204,20120215,8100,8052,0,0,0,8052,8052,0,0,0,0,0
108,p1204,20120216,8052,8052,0,0,0,8052,8052,0,0,0,0,0
109,p1204,20120217,8052,8052,0,0,0,8052,8052,0,0,0,0,0
110,p1204,20120220,8052,8052,0,0,0,8052,8052,0,0,0,0,0
111,p1204,20120221,8052,8052,0,0,0,8052,8052,0,0,0,0,0
112,p1204,20120222,8052,8052,0,0,0,8052,8052,0,0,0,0,0
113,p1204,20120223,8052,8052,0,0,0,8052,8052,0,0,0,0,0
114,p1204,20120224,8052,8052,0,0,0,8052,8052,0,0,0,0,0
115,p1204,20120227,8052,8052,0,0,0,8052,8052,0,0,0,0,0
116,p1204,20120228,8052,8052,0,0,0,8052,8052,0,0,0,0,0
117,p1204,20120229,8052,8052,0,0,0,8052,8052,0,0,0,0,0
118,p1204,20120301,8052,8052,0,0,0,8052,8052,0,0,0,0,0
119,p1204,20120302,8052,8052,0,0,0,8052,8052,0,0,0,0,0
120,p1204,20120305,8052,8052,0,0,0,8052,8052,0,0,0,0,0
121,p1204,20120306,8052,8052,0,0,0,8052,8052,0,0,0,0,0
122,p1204,20120307,8052,8052,7818,7818,7818,7818,7818,-234,-234,2,156360,2
123,p1204,20120308,7818,7818,7898,7898,7898,7898,7898,80,80,2,157960,2
124,p1204,20120309,7898,7898,7818,7818,7818,7818,7818,-80,-80,2,156360,0
125,p1204,20120312,7818,7818,0,0,0,7818,7818,0,0,0,0,0
126,p1204,20120313,7818,7818,0,0,0,7818,7818,0,0,0,0,0
127,p1204,20120314,7818,7818,0,0,0,7818,7818,0,0,0,0,0
128,p1204,20120315,7818,7818,0,0,0,7818,7818,0,0,0,0,0
129,p1204,20120316,7818,7818,0,0,0,7818,7818,0,0,0,0,0
130,p1204,20120319,7818,7818,0,0,0,7818,7818,0,0,0,0,0
131,p1204,20120320,7818,7818,0,0,0,7818,7818,0,0,0,0,0
132,p1204,20120321,7818,7818,0,0,0,7818,7818,0,0,0,0,0
133,p1204,20120322,7818,7818,0,0,0,7818,7818,0,0,0,0,0
134,p1204,20120323,7818,7818,0,0,0,7818,7818,0,0,0,0,0
135,p1204,20120326,7818,7818,0,0,0,7818,7818,0,0,0,0,0
136,p1204,20120327,7818,7818,0,0,0,7818,7818,0,0,0,0,0
137,p1204,20120328,7818,7818,0,0,0,7818,7818,0,0,0,0,0
138,p1204,20120329,7818,7818,0,0,0,7818,7818,0,0,0,0,0
139,p1204,20120330,7818,7818,0,0,0,7818,7818,0,0,0,0,0
140,p1204,20120405,7818,7818,0,0,0,7818,7818,0,0,0,0,0
141,p1204,20120406,7818,7818,0,0,0,7818,7818,0,0,0,0,0
142,p1204,20120409,7818,7818,0,0,0,7818,7818,0,0,0,0,0
143,p1204,20120410,7818,7818,0,0,0,7818,7818,0,0,0,0,0
144,p1204,20120411,7818,7818,0,0,0,7818,7818,0,0,0,0,0
145,p1204,20120412,7818,7818,0,0,0,7818,7818,0,0,0,0,0
146,p1204,20120413,7818,7818,0,0,0,7818,7818,0,0,0,0,0
147,p1204,20120416,7818,7818,0,0,0,7818,7818,0,0,0,0,0
148,p1204,20120417,7818,7818,0,0,0,7818,7818,0,0,0,0,0
149,p1204,20120418,7818,7818,0,0,0,7818,7818,0,0,0,0,0
150,p1205,20120104,8002,7982,8100,8140,8072,8086,8108,104,126,55714,4517817080,149786
151,p1205,20120105,8086,8108,8102,8148,8056,8096,8098,-12,-10,46408,3758605480,147470
152,p1205,20120106,8096,8098,8010,8088,8010,8076,8050,-22,-48,23944,1927505520,142040
153,p1205,20120109,8076,8050,8040,8096,8026,8080,8068,30,18,17006,1372258120,139186
154,p1205,20120110,8080,8068,8126,8156,8100,8106,8134,38,66,23294,1894935800,133446
155,p1205,20120111,8106,8134,8096,8140,8080,8124,8110,-10,-24,18282,1482709640,132946
156,p1205,20120112,8124,8110,8066,8100,8066,8090,8086,-20,-24,9596,775997920,131210
157,p1205,20120113,8090,8086,8016,8052,7992,7996,8016,-90,-70,15306,1227155200,129616
158,p1205,20120116,7996,8016,7936,7950,7830,7880,7874,-136,-142,29908,2354961520,122828
159,p1205,20120117,7880,7874,7910,7948,7882,7948,7918,74,44,14530,1150667600,119850
160,p1205,20120118,7948,7918,7946,7954,7884,7886,7922,-32,4,9596,760256040,120142
161,p1205,20120119,7886,7922,7918,7954,7896,7954,7922,32,0,6720,532475280,118252
162,p1205,20120120,7954,7922,7960,8016,7960,8006,7988,84,66,8412,672044480,118074
163,p1205,20120130,8006,7988,8030,8032,7982,7992,8014,4,26,6748,540844120,117352
164,p1205,20120131,7992,8014,7920,7950,7920,7944,7936,-70,-78,6760,536513920,117752
165,p1205,20120201,7944,7936,7940,8006,7940,7976,7980,40,44,5118,408514360,116942
166,p1205,20120202,7976,7980,7998,8066,7982,8048,8038,68,58,14854,1194184280,112106
167,p1205,20120203,8048,8038,8046,8070,8032,8038,8048,0,10,6904,555734600,112336
168,p1205,20120206,8038,8048,8070,8122,8070,8114,8102,66,54,10892,882516720,109354
169,p1205,20120207,8114,8102,8120,8134,8048,8072,8094,-30,-8,5652,457517560,108094
170,p1205,20120208,8072,8094,8056,8138,8056,8134,8104,40,10,9948,806232400,104648
171,p1205,20120209,8134,8104,8126,8160,8112,8146,8140,42,36,16362,1332051600,98532
172,p1205,20120210,8146,8140,8136,8140,8072,8082,8096,-58,-44,8260,668768600,95694
173,p1205,20120213,8082,8096,8118,8174,8108,8154,8146,58,50,6274,511117240,93458
174,p1205,20120214,8154,8146,8180,8186,8134,8142,8160,-4,14,2850,232599520,92922
175,p1205,20120215,8142,8160,8162,8194,8136,8138,8168,-22,8,5058,413145080,91354
176,p1205,20120216,8138,8168,8158,8158,8056,8098,8094,-70,-74,5468,442642480,90238
177,p1205,20120217,8098,8094,8110,8158,8110,8144,8140,50,46,4854,395144960,91314
178,p1205,20120220,8144,8140,8180,8246,8152,8164,8186,24,46,7034,575873040,90974
179,p1205,20120221,8164,8186,8164,8196,8134,8188,8164,2,-22,6854,559691480,89684
180,p1205,20120222,8188,8164,8196,8204,8164,8174,8172,10,8,4044,330532960,88828
181,p1205,20120223,8174,8172,8168,8168,8116,8158,8134,-14,-38,6878,559513120,87796
182,p1205,20120224,8158,8134,8164,8164,8090,8148,8124,14,-10,11650,946562000,86582
183,p1205,20120227,8148,8124,8148,8180,8148,8164,8168,40,44,4728,386274920,86390
184,p1205,20120228,8164,8168,8176,8210,8176,8208,8194,40,26,4334,355184640,85018
185,p1205,20120229,8208,8194,8200,8200,8164,8182,8178,-12,-16,1518,124147640,84484
186,p1205,20120301,8182,8178,8140,8174,8104,8118,8140,-60,-38,6184,503399120,81622
187,p1205,20120302,8118,8140,8120,8170,8120,8152,8152,12,12,3920,319628560,79498
188,p1205,20120305,8152,8152,8170,8188,8130,8158,8154,6,2,4794,390944560,76622
189,p1205,20120306,8158,8154,8150,8150,8114,8120,8126,-34,-28,5524,448961320,72840
190,p1205,20120307,8120,8126,8090,8106,8070,8096,8088,-30,-38,4444,359448600,69578
191,p1205,20120308,8096,8088,8092,8156,8092,8152,8124,64,36,2524,205085320,68154
192,p1205,20120309,8152,8124,8178,8330,8178,8330,8276,206,152,8048,666168880,69142
193,p1205,20120312,8330,8276,8286,8326,8252,8272,8296,-4,20,7598,630378600,67284
194,p1205,20120313,8272,8296,8268,8304,8238,8296,8272,0,-24,14260,1179771800,60544
195,p1205,20120314,8296,8272,8330,8368,8280,8294,8318,22,46,5350,445082320,57904
196,p1205,20120315,8294,8318,8310,8362,8300,8320,8338,2,20,2350,195949360,56988
197,p1205,20120316,8320,8338,8360,8396,8336,8340,8364,2,26,1520,127160120,56082
198,p1205,20120319,8340,8364,8352,8394,8350,8368,8368,4,4,1428,119515840,55636
199,p1205,20120320,8368,8368,8346,8356,8286,8294,8306,-74,-62,4320,358835080,52474
200,p1205,20120321,8294,8306,8290,8306,8270,8280,8290,-26,-16,4018,333168720,49646
201,p1205,20120322,8280,8290,8320,8332,8270,8270,8300,-20,10,2302,191106160,48848
202,p1205,20120323,8270,8300,8320,8382,8286,8380,8334,80,34,6966,580564360,43654
203,p1205,20120326,8380,8334,8400,8490,8400,8490,8458,156,124,3504,296415720,41770
204,p1205,20120327,8490,8458,8482,8482,8444,8464,8458,6,0,3626,306756680,39302
205,p1205,20120328,8464,8458,8458,8486,8402,8434,8452,-24,-6,7544,637661480,33630
206,p1205,20120329,8434,8452,8440,8450,8352,8370,8398,-82,-54,5552,466294920,30324
207,p1205,20120330,8370,8398,8350,8356,8292,8300,8332,-98,-66,8652,720929400,22648
208,p1205,20120405,8300,8332,8600,8622,8522,8606,8580,274,248,5208,446946920,20742
209,p1205,20120406,8606,8580,8680,8710,8658,8708,8672,128,92,3480,301850920,19336
210,p1205,20120409,8708,8672,8708,8750,8692,8708,8722,36,50,1596,139230840,17974
211,p1205,20120410,8708,8722,8690,8750,8682,8750,8718,28,-4,866,75499080,17664
212,p1205,20120411,8750,8718,8700,8700,8622,8638,8654,-80,-64,1156,100045920,17506
213,p1205,20120412,8638,8654,8650,8678,8610,8670,8642,16,-12,2608,225425960,15968
214,p1205,20120413,8670,8642,8710,8744,8690,8690,8700,48,58,762,66303840,15398
215,p1205,20120416,8690,8700,8604,8610,8526,8564,8568,-136,-132,2240,191945600,13642
216,p1205,20120417,8564,8568,8578,8580,8560,8574,8574,6,6,598,51277400,13140
217,p1205,20120418,8574,8574,8590,8618,8510,8554,8576,-20,2,576,49404120,12886
218,p1205,20120419,8554,8576,8514,8548,8514,8548,8542,-28,-34,596,50911320,12854
219,p1205,20120420,8548,8542,8542,8550,8512,8520,8522,-22,-20,2094,178457840,12270
220,p1205,20120423,8520,8522,8560,8602,8560,8586,8588,64,66,1234,105993360,11320
221,p1205,20120424,8586,8588,8584,8584,8510,8528,8550,-60,-38,2894,247481160,8570
222,p1205,20120425,8528,8550,8550,8550,8490,8490,8518,-60,-32,860,73265600,7754
223,p1205,20120426,8490,8518,8470,8528,8458,8478,8508,-40,-10,230,19569760,7592
224,p1205,20120427,8478,8508,8508,8522,8476,8492,8514,-16,6,678,57732120,7540
225,p1205,20120502,8492,8514,8530,8530,8500,8510,8518,-4,4,434,36975600,7540
226,p1205,20120503,8510,8518,8418,8482,8418,8444,8454,-74,-64,58,4904080,7506
227,p1205,20120504,8444,8454,8410,8442,8410,8440,8432,-14,-22,252,21252640,7254
228,p1205,20120507,8440,8432,8350,8350,8330,8330,8338,-102,-94,144,12008000,7114
229,p1205,20120508,8330,8338,8330,8330,8330,8330,8330,-8,-8,30,2499000,7084
230,p1205,20120509,8330,8330,0,0,0,8330,8330,0,0,0,0,7084
231,p1205,20120510,8330,8330,8388,8430,8388,8430,8408,100,78,224,18835800,6860
232,p1205,20120511,8430,8408,8280,8280,8256,8256,8270,-152,-138,160,13232800,6700
233,p1205,20120514,8256,8270,8180,8180,8000,8148,8020,-122,-250,1160,93041840,5660
234,p1205,20120515,8148,8020,8300,8300,8000,8000,8170,-20,150,1120,89960000,0
235,p1206,20120104,7966,7966,8124,8124,8124,8124,8124,158,158,2,162480,2
236,p1206,20120105,8124,8124,0,0,0,8124,8124,0,0,0,0,2
237,p1206,20120106,8124,8124,0,0,0,8124,8124,0,0,0,0,2
238,p1206,20120109,8124,8124,0,0,0,8124,8124,0,0,0,0,2
239,p1206,20120110,8124,8124,0,0,0,8124,8124,0,0,0,0,2
240,p1206,20120111,8124,8124,0,0,0,8124,8124,0,0,0,0,2
241,p1206,20120112,8124,8124,0,0,0,8124,8124,0,0,0,0,2
242,p1206,20120113,8124,8124,0,0,0,8124,8124,0,0,0,0,2
243,p1206,20120116,8124,8124,8124,8124,7880,7976,8022,-148,-102,18,1444040,10
244,p1206,20120117,7976,8022,7976,7976,7976,7976,7976,-46,-46,6,478560,10
245,p1206,20120118,7976,7976,0,0,0,7976,7976,0,0,0,0,10
246,p1206,20120119,7976,7976,0,0,0,7976,7976,0,0,0,0,10
247,p1206,20120120,7976,7976,7994,7994,7994,7994,7994,18,18,4,319760,10
248,p1206,20120130,7994,7994,8036,8100,8030,8100,8048,106,54,8,643920,6
249,p1206,20120131,8100,8048,0,0,0,8048,8048,0,0,0,0,6
250,p1206,20120201,8048,8048,0,0,0,8048,8048,0,0,0,0,6
251,p1206,20120202,8048,8048,8228,8228,8010,8066,8100,18,52,6,486080,4
252,p1206,20120203,8066,8100,0,0,0,8100,8100,0,0,0,0,4
253,p1206,20120206,8100,8100,0,0,0,8100,8100,0,0,0,0,4
254,p1206,20120207,8100,8100,8102,8102,8102,8102,8102,2,2,2,162040,2
255,p1206,20120208,8102,8102,0,0,0,8102,8102,0,0,0,0,2
256,p1206,20120209,8102,8102,8242,8242,8242,8242,8242,140,140,2,164840,4
257,p1206,20120210,8242,8242,8102,8120,8102,8120,8110,-122,-132,4,324440,2
258,p1206,20120213,8120,8110,0,0,0,8110,8110,0,0,0,0,2
259,p1206,20120214,8110,8110,0,0,0,8110,8110,0,0,0,0,2
260,p1206,20120215,8110,8110,0,0,0,8110,8110,0,0,0,0,2
261,p1206,20120216,8110,8110,0,0,0,8110,8110,0,0,0,0,2
262,p1206,20120217,8110,8110,0,0,0,8110,8110,0,0,0,0,2
263,p1206,20120220,8110,8110,0,0,0,8110,8110,0,0,0,0,2
264,p1206,20120221,8110,8110,8466,8466,8466,8466,8466,356,356,4,338640,6
265,p1206,20120222,8466,8466,0,0,0,8466,8466,0,0,0,0,6
266,p1206,20120223,8466,8466,8244,8274,8244,8274,8258,-192,-208,4,330360,4
267,p1206,20120224,8274,8258,0,0,0,8258,8258,0,0,0,0,4
268,p1206,20120227,8258,8258,8200,8324,8200,8324,8256,66,-2,24,1981440,16
269,p1206,20120228,8324,8256,8326,8326,8266,8296,8290,40,34,12,994920,8
270,p1206,20120229,8296,8290,8260,8260,8260,8260,8260,-30,-30,4,330400,4
271,p1206,20120301,8260,8260,0,0,0,8260,8260,0,0,0,0,4
272,p1206,20120302,8260,8260,0,0,0,8260,8260,0,0,0,0,4
273,p1206,20120305,8260,8260,0,0,0,8260,8260,0,0,0,0,4
274,p1206,20120306,8260,8260,0,0,0,8260,8260,0,0,0,0,4
275,p1206,20120307,8260,8260,0,0,0,8260,8260,0,0,0,0,4
276,p1206,20120308,8260,8260,0,0,0,8260,8260,0,0,0,0,4
277,p1206,20120309,8260,8260,8378,8446,8302,8446,8378,186,118,20,1675920,6
278,p1206,20120312,8446,8378,8400,8796,7960,8370,8320,-8,-58,70,5825040,32
279,p1206,20120313,8370,8320,8360,8360,8232,8232,8346,-88,26,20,1669440,14
280,p1206,20120314,8232,8346,8448,8448,8318,8318,8372,-28,26,24,2009480,14
281,p1206,20120315,8318,8372,8408,8408,8350,8370,8392,-2,20,40,3357080,14
282,p1206,20120316,8370,8392,0,0,0,8392,8392,0,0,0,0,14
283,p1206,20120319,8392,8392,0,0,0,8392,8392,0,0,0,0,14
284,p1206,20120320,8392,8392,8364,8364,8348,8348,8356,-44,-36,4,334240,12
285,p1206,20120321,8348,8356,8340,8350,8340,8350,8346,-6,-10,12,1001520,14
286,p1206,20120322,8350,8346,8356,8356,8356,8356,8356,10,10,2,167120,14
287,p1206,20120323,8356,8356,8442,8560,8332,8412,8466,56,110,398,33696040,22
288,p1206,20120326,8412,8466,8528,8608,8528,8560,8574,94,108,24,2058160,20
289,p1206,20120327,8560,8574,8492,8502,8472,8472,8492,-102,-82,18,1528760,24
290,p1206,20120328,8472,8492,8584,8584,8442,8488,8500,-4,8,14,1190160,24
291,p1206,20120329,8488,8500,8382,8382,8382,8382,8382,-118,-118,2,167640,24
292,p1206,20120330,8382,8382,8276,8366,8276,8292,8308,-90,-74,26,2160560,24
293,p1206,20120405,8292,8308,8482,8516,8482,8516,8502,208,194,24,2040760,24
294,p1206,20120406,8516,8502,8608,8678,8608,8642,8640,140,138,20,1728280,24
295,p1206,20120409,8642,8640,8688,8692,8688,8692,8690,52,50,4,347600,24
296,p1206,20120410,8692,8690,8566,8678,8566,8678,8626,-12,-64,48,4141200,24
297,p1206,20120411,8678,8626,8566,8698,8540,8540,8600,-86,-26,30,2580400,24
298,p1206,20120412,8540,8600,0,0,0,8600,8600,0,0,0,0,24
299,p1206,20120413,8600,8600,8778,8778,8778,8778,8778,178,178,2,175560,26
300,p1206,20120416,8778,8778,0,0,0,8778,8778,0,0,0,0,26
301,p1206,20120417,8778,8778,0,0,0,8778,8778,0,0,0,0,26
302,p1206,20120418,8778,8778,8618,8756,8618,8670,8700,-108,-78,8,696000,28
303,p1206,20120419,8670,8700,8600,8600,8600,8600,8600,-100,-100,2,172000,28
304,p1206,20120420,8600,8600,8480,8638,8480,8638,8580,38,-20,30,2574000,28
305,p1206,20120423,8638,8580,8918,8918,8642,8642,8730,62,150,12,1047680,24
306,p1206,20120424,8642,8730,8530,8686,8530,8570,8594,-160,-136,30,2578600,24
307,p1206,20120425,8570,8594,8504,8592,8490,8490,8528,-104,-66,6,511720,24
308,p1206,20120426,8490,8528,8500,8568,8442,8442,8502,-86,-26,6,510200,26
309,p1206,20120427,8442,8502,8602,8636,8500,8500,8574,-2,72,10,857520,26
310,p1206,20120502,8500,8574,0,0,0,8574,8574,0,0,0,0,26
311,p1206,20120503,8574,8574,0,0,0,8574,8574,0,0,0,0,26
312,p1206,20120504,8574,8574,0,0,0,8574,8574,0,0,0,0,26
313,p1206,20120507,8574,8574,8380,8380,8302,8302,8372,-272,-202,24,2009640,2
314,p1206,20120508,8302,8372,8236,8378,8236,8310,8308,-62,-64,12,996960,2
315,p1206,20120509,8310,8308,0,0,0,8308,8308,0,0,0,0,2
316,p1206,20120510,8308,8308,8196,8304,8196,8258,8252,-50,-56,6,495160,2
317,p1206,20120511,8258,8252,0,0,0,8252,8252,0,0,0,0,2
318,p1206,20120514,8252,8252,0,0,0,8252,8252,0,0,0,0,2
319,p1206,20120515,8252,8252,0,0,0,8252,8252,0,0,0,0,2
320,p1206,20120516,8252,8252,0,0,0,8252,8252,0,0,0,0,2
321,p1206,20120517,8252,8252,0,0,0,8252,8252,0,0,0,0,2
322,p1206,20120518,8252,8252,8000,8000,8000,8000,8000,-252,-252,2,160000,0
323,p1206,20120521,8000,8000,0,0,0,8000,8000,0,0,0,0,0
324,p1206,20120522,8000,8000,0,0,0,8000,8000,0,0,0,0,0
325,p1206,20120523,8000,8000,0,0,0,8000,8000,0,0,0,0,0
326,p1206,20120524,8000,8000,0,0,0,8000,8000,0,0,0,0,0
327,p1206,20120525,8000,8000,0,0,0,8000,8000,0,0,0,0,0
328,p1206,20120528,8000,8000,0,0,0,8000,8000,0,0,0,0,0
329,p1206,20120529,8000,8000,0,0,0,8000,8000,0,0,0,0,0
330,p1206,20120530,8000,8000,0,0,0,8000,8000,0,0,0,0,0
331,p1206,20120531,8000,8000,0,0,0,8000,8000,0,0,0,0,0
332,p1206,20120601,8000,8000,0,0,0,8000,8000,0,0,0,0,0
333,p1206,20120604,8000,8000,0,0,0,8000,8000,0,0,0,0,0
334,p1206,20120605,8000,8000,0,0,0,8000,8000,0,0,0,0,0
335,p1206,20120606,8000,8000,0,0,0,8000,8000,0,0,0,0,0
336,p1206,20120607,8000,8000,0,0,0,8000,8000,0,0,0,0,0
337,p1206,20120608,8000,8000,0,0,0,8000,8000,0,0,0,0,0
338,p1206,20120611,8000,8000,0,0,0,8000,8000,0,0,0,0,0
339,p1206,20120612,8000,8000,0,0,0,8000,8000,0,0,0,0,0
340,p1206,20120613,8000,8000,0,0,0,8000,8000,0,0,0,0,0
341,p1206,20120614,8000,8000,0,0,0,8000,8000,0,0,0,0,0
342,p1207,20120104,7860,7860,0,0,0,7860,7860,0,0,0,0,6
343,p1207,20120105,7860,7860,0,0,0,7860,7860,0,0,0,0,6
344,p1207,20120106,7860,7860,0,0,0,7860,7860,0,0,0,0,6
345,p1207,20120109,7860,7860,0,0,0,7860,7860,0,0,0,0,6
346,p1207,20120110,7860,7860,8150,8150,8150,8150,8150,290,290,2,163000,6
347,p1207,20120111,8150,8150,0,0,0,8150,8150,0,0,0,0,6
348,p1207,20120112,8150,8150,0,0,0,8150,8150,0,0,0,0,6
349,p1207,20120113,8150,8150,8078,8136,8046,8136,8096,-14,-54,16,1295360,8
350,p1207,20120116,8136,8096,7904,7904,7904,7904,7904,-192,-192,4,316160,8
351,p1207,20120117,7904,7904,0,0,0,7904,7904,0,0,0,0,8
352,p1207,20120118,7904,7904,7996,7996,7996,7996,7996,92,92,2,159920,8
353,p1207,20120119,7996,7996,0,0,0,7996,7996,0,0,0,0,8
354,p1207,20120120,7996,7996,0,0,0,7996,7996,0,0,0,0,8
355,p1207,20120130,7996,7996,0,0,0,7996,7996,0,0,0,0,8
356,p1207,20120131,7996,7996,0,0,0,7996,7996,0,0,0,0,8
357,p1207,20120201,7996,7996,0,0,0,7996,7996,0,0,0,0,8
358,p1207,20120202,7996,7996,0,0,0,7996,7996,0,0,0,0,8
359,p1207,20120203,7996,7996,0,0,0,7996,7996,0,0,0,0,8
360,p1207,20120206,7996,7996,0,0,0,7996,7996,0,0,0,0,8
361,p1207,20120207,7996,7996,0,0,0,7996,7996,0,0,0,0,8
362,p1207,20120208,7996,7996,0,0,0,7996,7996,0,0,0,0,8
363,p1207,20120209,7996,7996,0,0,0,7996,7996,0,0,0,0,8
364,p1207,20120210,7996,7996,0,0,0,7996,7996,0,0,0,0,8
365,p1207,20120213,7996,7996,0,0,0,7996,7996,0,0,0,0,8
366,p1207,20120214,7996,7996,0,0,0,7996,7996,0,0,0,0,8
367,p1207,20120215,7996,7996,0,0,0,7996,7996,0,0,0,0,8
368,p1207,20120216,7996,7996,0,0,0,7996,7996,0,0,0,0,8
369,p1207,20120217,7996,7996,0,0,0,7996,7996,0,0,0,0,8
370,p1207,20120220,7996,7996,8256,8256,8256,8256,8256,260,260,4,330240,6
371,p1207,20120221,8256,8256,8436,8436,8222,8240,8286,-16,30,12,994440,2
372,p1207,20120222,8240,8286,0,0,0,8286,8286,0,0,0,0,2
373,p1207,20120223,8286,8286,8380,8380,8380,8380,8380,94,94,2,167600,2
374,p1207,20120224,8380,8380,0,0,0,8380,8380,0,0,0,0,2
375,p1207,20120227,8380,8380,0,0,0,8380,8380,0,0,0,0,2
376,p1207,20120228,8380,8380,0,0,0,8380,8380,0,0,0,0,2
377,p1207,20120229,8380,8380,0,0,0,8380,8380,0,0,0,0,2
378,p1207,20120301,8380,8380,0,0,0,8380,8380,0,0,0,0,2
379,p1207,20120302,8380,8380,0,0,0,8380,8380,0,0,0,0,2
380,p1207,20120305,8380,8380,0,0,0,8380,8380,0,0,0,0,2
381,p1207,20120306,8380,8380,0,0,0,8380,8380,0,0,0,0,2
382,p1207,20120307,8380,8380,0,0,0,8380,8380,0,0,0,0,2
383,p1207,20120308,8380,8380,0,0,0,8380,8380,0,0,0,0,2
384,p1207,20120309,8380,8380,0,0,0,8380,8380,0,0,0,0,2
385,p1207,20120312,8380,8380,0,0,0,8380,8380,0,0,0,0,2
386,p1207,20120313,8380,8380,0,0,0,8380,8380,0,0,0,0,2
387,p1207,20120314,8380,8380,8528,8576,8526,8556,8540,176,160,16,1366480,8
388,p1207,20120315,8556,8540,8532,8536,8520,8536,8528,-4,-12,6,511760,4
389,p1207,20120316,8536,8528,8560,8560,8560,8560,8560,32,32,2,171200,4
390,p1207,20120319,8560,8560,0,0,0,8560,8560,0,0,0,0,4
391,p1207,20120320,8560,8560,0,0,0,8560,8560,0,0,0,0,4
392,p1207,20120321,8560,8560,8464,8464,8464,8464,8464,-96,-96,2,169280,2
393,p1207,20120322,8464,8464,8418,8560,8418,8428,8468,-36,4,18,1524360,2
394,p1207,20120323,8428,8468,0,0,0,8468,8468,0,0,0,0,2
395,p1207,20120326,8468,8468,0,0,0,8468,8468,0,0,0,0,2
396,p1207,20120327,8468,8468,8420,8590,8420,8544,8534,76,66,44,3755720,28
397,p1207,20120328,8544,8534,8510,8510,8510,8510,8510,-24,-24,6,510600,28
398,p1207,20120329,8510,8510,8452,8452,8452,8452,8452,-58,-58,4,338080,28
399,p1207,20120330,8452,8452,8320,8410,8320,8366,8364,-86,-88,24,2007680,28
400,p1207,20120405,8366,8364,8514,8612,8504,8560,8554,196,190,26,2224360,28
401,p1207,20120406,8560,8554,8700,8700,8700,8700,8700,146,146,2,174000,28
402,p1207,20120409,8700,8700,8726,8726,8726,8726,8726,26,26,2,174520,28
403,p1207,20120410,8726,8726,8706,8810,8706,8806,8754,80,28,28,2451520,28
404,p1207,20120411,8806,8754,8664,8664,8664,8664,8664,-90,-90,2,173280,26
405,p1207,20120412,8664,8664,0,0,0,8664,8664,0,0,0,0,26
406,p1207,20120413,8664,8664,0,0,0,8664,8664,0,0,0,0,26
407,p1207,20120416,8664,8664,8600,8662,8526,8576,8592,-88,-72,16,1374840,28
408,p1207,20120417,8576,8592,8522,8664,8522,8600,8594,8,2,30,2578600,28
409,p1207,20120418,8600,8594,8622,8678,8562,8634,8614,40,20,38,3273800,30
410,p1207,20120419,8634,8614,8610,8610,8600,8600,8606,-14,-8,6,516400,26
411,p1207,20120420,8600,8606,8704,8704,8574,8636,8632,30,26,12,1036000,24
412,p1207,20120423,8636,8632,8972,8972,8710,8710,8806,78,174,6,528440,24
413,p1207,20120424,8710,8806,8620,8620,8518,8582,8572,-224,-234,6,514400,24
414,p1207,20120425,8582,8572,0,0,0,8572,8572,0,0,0,0,24
415,p1207,20120426,8572,8572,0,0,0,8572,8572,0,0,0,0,24
416,p1207,20120427,8572,8572,0,0,0,8572,8572,0,0,0,0,24
417,p1207,20120502,8572,8572,0,0,0,8572,8572,0,0,0,0,24
418,p1207,20120503,8572,8572,0,0,0,8572,8572,0,0,0,0,24
419,p1207,20120504,8572,8572,0,0,0,8572,8572,0,0,0,0,24
420,p1207,20120507,8572,8572,8330,8368,8330,8368,8334,-204,-238,20,1666800,8
421,p1207,20120508,8368,8334,8306,8422,8306,8388,8372,54,38,24,2009280,8
422,p1207,20120509,8388,8372,0,0,0,8372,8372,0,0,0,0,8
423,p1207,20120510,8372,8372,8416,8416,8416,8416,8416,44,44,2,168320,8
424,p1207,20120511,8416,8416,0,0,0,8416,8416,0,0,0,0,8
425,p1207,20120514,8416,8416,8262,8262,8216,8216,8222,-200,-194,18,1480200,4
426,p1207,20120515,8216,8222,0,0,0,8222,8222,0,0,0,0,4
427,p1207,20120516,8222,8222,0,0,0,8222,8222,0,0,0,0,4
428,p1207,20120517,8222,8222,8026,8116,8026,8100,8072,-122,-150,12,968800,4
429,p1207,20120518,8100,8072,0,0,0,8072,8072,0,0,0,0,4
430,p1207,20120521,8072,8072,7924,8022,7924,8022,7982,-50,-90,8,638600,4
431,p1207,20120522,8022,7982,0,0,0,7982,7982,0,0,0,0,4
432,p1207,20120523,7982,7982,0,0,0,7982,7982,0,0,0,0,4
433,p1207,20120524,7982,7982,0,0,0,7982,7982,0,0,0,0,4
434,p1207,20120525,7982,7982,7876,7876,7876,7876,7876,-106,-106,2,157520,6
435,p1207,20120528,7876,7876,7918,7930,7918,7930,7924,54,48,4,316960,2
436,p1207,20120529,7930,7924,7822,8124,7820,7984,7962,60,38,24,1910960,2
437,p1207,20120530,7984,7962,7954,7954,7886,7886,7920,-76,-42,8,633600,2
438,p1207,20120531,7886,7920,0,0,0,7920,7920,0,0,0,0,2
439,p1207,20120601,7920,7920,0,0,0,7920,7920,0,0,0,0,2
440,p1207,20120604,7920,7920,0,0,0,7920,7920,0,0,0,0,2
441,p1207,20120605,7920,7920,0,0,0,7920,7920,0,0,0,0,2
442,p1207,20120606,7920,7920,0,0,0,7920,7920,0,0,0,0,2
443,p1207,20120607,7920,7920,0,0,0,7920,7920,0,0,0,0,2
444,p1207,20120608,7920,7920,0,0,0,7920,7920,0,0,0,0,2
445,p1207,20120611,7920,7920,0,0,0,7920,7920,0,0,0,0,2
446,p1207,20120612,7920,7920,0,0,0,7920,7920,0,0,0,0,2
447,p1207,20120613,7920,7920,0,0,0,7920,7920,0,0,0,0,2
448,p1207,20120614,7920,7920,0,0,0,7920,7920,0,0,0,0,2
449,p1207,20120615,7920,7920,0,0,0,7920,7920,0,0,0,0,2
450,p1207,20120618,7920,7920,0,0,0,7920,7920,0,0,0,0,2
451,p1207,20120619,7920,7920,0,0,0,7920,7920,0,0,0,0,2
452,p1207,20120620,7920,7920,0,0,0,7920,7920,0,0,0,0,2
453,p1207,20120621,7920,7920,0,0,0,7920,7920,0,0,0,0,2
454,p1207,20120625,7920,7920,0,0,0,7920,7920,0,0,0,0,2
455,p1207,20120626,7920,7920,0,0,0,7920,7920,0,0,0,0,2
456,p1207,20120627,7920,7920,7604,7604,7604,7604,7604,-316,-316,2,152080,2
457,p1207,20120628,7604,7604,7690,7690,7690,7690,7690,86,86,2,153800,0
458,p1207,20120629,7690,7690,0,0,0,7690,7690,0,0,0,0,0
459,p1207,20120702,7690,7690,0,0,0,7690,7690,0,0,0,0,0
460,p1207,20120703,7690,7690,0,0,0,7690,7690,0,0,0,0,0
461,p1207,20120704,7690,7690,0,0,0,7690,7690,0,0,0,0,0
462,p1207,20120705,7690,7690,0,0,0,7690,7690,0,0,0,0,0
463,p1207,20120706,7690,7690,0,0,0,7690,7690,0,0,0,0,0
464,p1207,20120709,7690,7690,0,0,0,7690,7690,0,0,0,0,0
465,p1207,20120710,7690,7690,0,0,0,7690,7690,0,0,0,0,0
466,p1207,20120711,7690,7690,0,0,0,7690,7690,0,0,0,0,0
467,p1207,20120712,7690,7690,0,0,0,7690,7690,0,0,0,0,0
468,p1207,20120713,7690,7690,0,0,0,7690,7690,0,0,0,0,0
469,p1208,20120104,7984,7984,0,0,0,7984,7984,0,0,0,0,0
470,p1208,20120105,7984,7984,0,0,0,7984,7984,0,0,0,0,0
471,p1208,20120106,7984,7984,0,0,0,7984,7984,0,0,0,0,0
472,p1208,20120109,7984,7984,0,0,0,7984,7984,0,0,0,0,0
473,p1208,20120110,7984,7984,8006,8268,8006,8268,8136,284,152,8,650960,4
474,p1208,20120111,8268,8136,0,0,0,8136,8136,0,0,0,0,4
475,p1208,20120112,8136,8136,0,0,0,8136,8136,0,0,0,0,4
476,p1208,20120113,8136,8136,0,0,0,8136,8136,0,0,0,0,4
477,p1208,20120116,8136,8136,0,0,0,8136,8136,0,0,0,0,4
478,p1208,20120117,8136,8136,0,0,0,8136,8136,0,0,0,0,4
479,p1208,20120118,8136,8136,0,0,0,8136,8136,0,0,0,0,4
480,p1208,20120119,8136,8136,8142,8142,7884,7918,7982,-218,-154,22,1756200,0
481,p1208,20120120,7918,7982,0,0,0,7982,7982,0,0,0,0,0
482,p1208,20120130,7982,7982,0,0,0,7982,7982,0,0,0,0,0
483,p1208,20120131,7982,7982,0,0,0,7982,7982,0,0,0,0,0
484,p1208,20120201,7982,7982,0,0,0,7982,7982,0,0,0,0,0
485,p1208,20120202,7982,7982,0,0,0,7982,7982,0,0,0,0,0
486,p1208,20120203,7982,7982,0,0,0,7982,7982,0,0,0,0,0
487,p1208,20120206,7982,7982,0,0,0,7982,7982,0,0,0,0,0
488,p1208,20120207,7982,7982,8012,8100,8012,8100,8056,118,74,4,322240,4
489,p1208,20120208,8100,8056,0,0,0,8056,8056,0,0,0,0,4
490,p1208,20120209,8056,8056,0,0,0,8056,8056,0,0,0,0,4
491,p1208,20120210,8056,8056,0,0,0,8056,8056,0,0,0,0,4
492,p1208,20120213,8056,8056,8428,8428,8132,8260,8282,204,226,274,22697000,8
493,p1208,20120214,8260,8282,8178,8260,8178,8230,8226,-52,-56,10,822760,4
494,p1208,20120215,8230,8226,8200,8200,8200,8200,8200,-26,-26,4,328000,4
495,p1208,20120216,8200,8200,0,0,0,8200,8200,0,0,0,0,4
496,p1208,20120217,8200,8200,0,0,0,8200,8200,0,0,0,0,4
497,p1208,20120220,8200,8200,0,0,0,8200,8200,0,0,0,0,4
498,p1208,20120221,8200,8200,0,0,0,8200,8200,0,0,0,0,4
499,p1208,20120222,8200,8200,0,0,0,8200,8200,0,0,0,0,4
500,p1208,20120223,8200,8200,0,0,0,8200,8200,0,0,0,0,4
501,p1208,20120224,8200,8200,0,0,0,8200,8200,0,0,0,0,4
502,p1208,20120227,8200,8200,0,0,0,8200,8200,0,0,0,0,4
503,p1208,20120228,8200,8200,0,0,0,8200,8200,0,0,0,0,4
504,p1208,20120229,8200,8200,0,0,0,8200,8200,0,0,0,0,4
505,p1208,20120301,8200,8200,0,0,0,8200,8200,0,0,0,0,4
506,p1208,20120302,8200,8200,8308,8310,8200,8270,8266,70,66,10,826680,4
507,p1208,20120305,8270,8266,8308,8366,8232,8304,8328,38,62,18,1499080,10
508,p1208,20120306,8304,8328,8218,8250,8218,8250,8230,-78,-98,14,1152440,4
509,p1208,20120307,8250,8230,8098,8204,8098,8150,8150,-80,-80,12,978080,4
510,p1208,20120308,8150,8150,8106,8252,8106,8196,8184,46,34,12,982160,4
511,p1208,20120309,8196,8184,8460,8460,8460,8460,8460,276,276,2,169200,4
512,p1208,20120312,8460,8460,8456,8456,8456,8456,8456,-4,-4,2,169120,6
513,p1208,20120313,8456,8456,8546,8546,8460,8460,8502,4,46,4,340120,6
514,p1208,20120314,8460,8502,8540,8550,8540,8550,8544,48,42,4,341800,6
515,p1208,20120315,8550,8544,8720,8720,8402,8518,8554,-26,10,14,1197680,6
516,p1208,20120316,8518,8554,0,0,0,8554,8554,0,0,0,0,6
517,p1208,20120319,8554,8554,0,0,0,8554,8554,0,0,0,0,6
518,p1208,20120320,8554,8554,0,0,0,8554,8554,0,0,0,0,6
519,p1208,20120321,8554,8554,0,0,0,8554,8554,0,0,0,0,6
520,p1208,20120322,8554,8554,8496,8560,8496,8502,8518,-52,-36,18,1533480,6
521,p1208,20120323,8502,8518,8496,8658,8496,8658,8550,140,32,20,1710000,8
522,p1208,20120326,8658,8550,8534,8742,8534,8660,8644,110,94,32,2766240,10
523,p1208,20120327,8660,8644,8700,8700,8606,8606,8652,-38,8,4,346120,8
524,p1208,20120328,8606,8652,0,0,0,8652,8652,0,0,0,0,8
525,p1208,20120329,8652,8652,8668,8668,8668,8668,8668,16,16,2,173360,10
526,p1208,20120330,8668,8668,8352,8562,8352,8520,8478,-148,-190,6,508680,10
527,p1208,20120405,8520,8478,8650,8788,8650,8652,8722,174,244,38,3314600,6
528,p1208,20120406,8652,8722,8814,8838,8814,8838,8822,116,100,6,529320,8
529,p1208,20120409,8838,8822,8842,8936,8826,8826,8868,4,46,24,2128320,8
530,p1208,20120410,8826,8868,0,0,0,8868,8868,0,0,0,0,8
531,p1208,20120411,8868,8868,0,0,0,8868,8868,0,0,0,0,8
532,p1208,20120412,8868,8868,8868,8918,8868,8912,8912,44,44,84,7486520,64
533,p1208,20120413,8912,8912,8988,8988,8988,8988,8988,76,76,2,179760,62
534,p1208,20120416,8988,8988,8868,8868,8724,8730,8792,-258,-196,74,6507520,6
535,p1208,20120417,8730,8792,0,0,0,8792,8792,0,0,0,0,6
536,p1208,20120418,8792,8792,8856,8856,8676,8746,8752,-46,-40,32,2801120,8
537,p1208,20120419,8746,8752,8726,8726,8726,8726,8726,-26,-26,2,174520,8
538,p1208,20120420,8726,8726,0,0,0,8726,8726,0,0,0,0,8
539,p1208,20120423,8726,8726,0,0,0,8726,8726,0,0,0,0,8
540,p1208,20120424,8726,8726,8580,8726,8580,8698,8668,-28,-58,30,2600400,8
541,p1208,20120425,8698,8668,8580,8724,8580,8642,8648,-26,-20,36,3113520,8
542,p1208,20120426,8642,8648,0,0,0,8648,8648,0,0,0,0,8
543,p1208,20120427,8648,8648,0,0,0,8648,8648,0,0,0,0,8
544,p1208,20120502,8648,8648,0,0,0,8648,8648,0,0,0,0,8
545,p1208,20120503,8648,8648,0,0,0,8648,8648,0,0,0,0,8
546,p1208,20120504,8648,8648,8636,8636,8636,8636,8636,-12,-12,20,1727200,28
547,p1208,20120507,8636,8636,0,0,0,8636,8636,0,0,0,0,28
548,p1208,20120508,8636,8636,0,0,0,8636,8636,0,0,0,0,28
549,p1208,20120509,8636,8636,0,0,0,8636,8636,0,0,0,0,28
550,p1208,20120510,8636,8636,8606,8606,8552,8552,8578,-84,-58,4,343160,28
551,p1208,20120511,8552,8578,8422,8424,8394,8420,8412,-158,-166,10,841200,24
552,p1208,20120514,8420,8412,8292,8292,8256,8256,8268,-156,-144,12,992320,24
553,p1208,20120515,8256,8268,8256,8256,8118,8150,8174,-118,-94,6,490480,24
554,p1208,20120516,8150,8174,8160,8160,8148,8148,8152,-26,-22,6,489120,22
555,p1208,20120517,8148,8152,8126,8186,8106,8170,8146,18,-6,128,10427440,20
556,p1208,20120518,8170,8146,8022,8022,8022,8022,8022,-124,-124,4,320880,24
557,p1208,20120521,8022,8022,7992,8100,7992,8100,8050,78,28,10,805040,16
558,p1208,20120522,8100,8050,8108,8108,8108,8108,8108,58,58,2,162160,16
559,p1208,20120523,8108,8108,0,0,0,8108,8108,0,0,0,0,16
560,p1208,20120524,8108,8108,7960,7960,7840,7840,7900,-268,-208,4,316000,16
561,p1208,20120525,7840,7900,0,0,0,7900,7900,0,0,0,0,16
562,p1208,20120528,7900,7900,7964,7964,7964,7964,7964,64,64,2,159280,14
563,p1208,20120529,7964,7964,0,0,0,7964,7964,0,0,0,0,14
564,p1208,20120530,7964,7964,0,0,0,7964,7964,0,0,0,0,14
565,p1208,20120531,7964,7964,0,0,0,7964,7964,0,0,0,0,14
566,p1208,20120601,7964,7964,0,0,0,7964,7964,0,0,0,0,14
567,p1208,20120604,7964,7964,7722,7722,7722,7722,7722,-242,-242,2,154440,14
568,p1208,20120605,7722,7722,0,0,0,7722,7722,0,0,0,0,14
569,p1208,20120606,7722,7722,0,0,0,7722,7722,0,0,0,0,14
570,p1208,20120607,7722,7722,7756,7756,7756,7756,7756,34,34,2,155120,12
571,p1208,20120608,7756,7756,0,0,0,7756,7756,0,0,0,0,12
572,p1208,20120611,7756,7756,0,0,0,7756,7756,0,0,0,0,12
573,p1208,20120612,7756,7756,0,0,0,7756,7756,0,0,0,0,12
574,p1208,20120613,7756,7756,0,0,0,7756,7756,0,0,0,0,12
575,p1208,20120614,7756,7756,0,0,0,7756,7756,0,0,0,0,12
576,p1208,20120615,7756,7756,0,0,0,7756,7756,0,0,0,0,12
577,p1208,20120618,7756,7756,7728,7728,7650,7668,7688,-88,-68,14,1076560,22
578,p1208,20120619,7668,7688,7720,7780,7706,7780,7736,92,48,12,928400,14
579,p1208,20120620,7780,7736,7836,7836,7836,7836,7836,100,100,2,156720,12
580,p1208,20120621,7836,7836,0,0,0,7836,7836,0,0,0,0,12
581,p1208,20120625,7836,7836,7906,7906,7906,7906,7906,70,70,4,316240,8
582,p1208,20120626,7906,7906,0,0,0,7906,7906,0,0,0,0,8
583,p1208,20120627,7906,7906,7750,7980,7750,7850,7860,-56,-46,42,3301200,8
584,p1208,20120628,7850,7860,0,0,0,7860,7860,0,0,0,0,8
585,p1208,20120629,7860,7860,0,0,0,7860,7860,0,0,0,0,8
586,p1208,20120702,7860,7860,0,0,0,7860,7860,0,0,0,0,8
587,p1208,20120703,7860,7860,0,0,0,7860,7860,0,0,0,0,8
588,p1208,20120704,7860,7860,7962,7966,7962,7962,7962,102,102,10,796360,12
589,p1208,20120705,7962,7962,0,0,0,7962,7962,0,0,0,0,12
590,p1208,20120706,7962,7962,0,0,0,7962,7962,0,0,0,0,12
591,p1208,20120709,7962,7962,0,0,0,7962,7962,0,0,0,0,12
592,p1208,20120710,7962,7962,0,0,0,7962,7962,0,0,0,0,12
593,p1208,20120711,7962,7962,0,0,0,7962,7962,0,0,0,0,12
594,p1208,20120712,7962,7962,0,0,0,7962,7962,0,0,0,0,12
595,p1208,20120713,7962,7962,0,0,0,7962,7962,0,0,0,0,12
596,p1208,20120716,7962,7962,0,0,0,7962,7962,0,0,0,0,12
597,p1208,20120717,7962,7962,0,0,0,7962,7962,0,0,0,0,12
598,p1208,20120718,7962,7962,7886,7886,7850,7850,7868,-112,-94,4,314720,12
599,p1208,20120719,7850,7868,7554,7718,7554,7718,7608,-150,-260,6,456520,12
600,p1208,20120720,7718,7608,7736,7790,7736,7790,7772,182,164,6,466320,12
601,p1208,20120723,7790,7772,0,0,0,7772,7772,0,0,0,0,12
602,p1208,20120724,7772,7772,0,0,0,7772,7772,0,0,0,0,12
603,p1208,20120725,7772,7772,0,0,0,7772,7772,0,0,0,0,12
604,p1208,20120726,7772,7772,7470,7490,7470,7490,7480,-282,-292,8,598400,8
605,p1208,20120727,7490,7480,0,0,0,7480,7480,0,0,0,0,8
606,p1208,20120730,7480,7480,7770,7770,7770,7770,7770,290,290,2,155400,6
607,p1208,20120731,7770,7770,8236,8236,8236,8236,8236,466,466,2,164720,6
608,p1208,20120801,8236,8236,0,0,0,8236,8236,0,0,0,0,6
609,p1208,20120802,8236,8236,0,0,0,8236,8236,0,0,0,0,6
610,p1208,20120803,8236,8236,8000,8000,8000,8000,8000,-236,-236,2,160000,6
611,p1208,20120806,8000,8000,0,0,0,8000,8000,0,0,0,0,6
612,p1208,20120807,8000,8000,0,0,0,8000,8000,0,0,0,0,6
613,p1208,20120808,8000,8000,0,0,0,8000,8000,0,0,0,0,6
614,p1208,20120809,8000,8000,0,0,0,8000,8000,0,0,0,0,6
615,p1208,20120810,8000,8000,0,0,0,8000,8000,0,0,0,0,6
616,p1208,20120813,8000,8000,0,0,0,8000,8000,0,0,0,0,6
617,p1208,20120814,8000,8000,0,0,0,8000,8000,0,0,0,0,0
618,p1209,20120104,8038,8014,8090,8250,8090,8124,8148,110,134,44404,3618295920,101004
619,p1209,20120105,8124,8148,8140,8190,8086,8150,8142,2,-6,68782,5601243160,107652
620,p1209,20120106,8150,8142,8100,8146,8064,8130,8106,-12,-36,63322,5132935120,113866
621,p1209,20120109,8130,8106,8080,8158,8074,8136,8128,30,22,80404,6535357760,114552
622,p1209,20120110,8136,8128,8188,8220,8162,8162,8198,34,70,82518,6766094560,117526
623,p1209,20120111,8162,8198,8162,8198,8132,8172,8166,-26,-32,77544,6332680280,119246
624,p1209,20120112,8172,8166,8122,8158,8120,8140,8142,-26,-24,50932,4147084720,124800
625,p1209,20120113,8140,8142,8092,8110,8032,8040,8066,-102,-76,67744,5465192160,130532
626,p1209,20120116,8040,8066,7980,7980,7826,7920,7922,-146,-144,72612,5752730680,134678
627,p1209,20120117,7920,7922,7960,7990,7924,7986,7960,64,38,79574,6334179400,131782
628,p1209,20120118,7986,7960,7970,7994,7918,7922,7956,-38,-4,80378,6395126400,134180
629,p1209,20120119,7922,7956,7956,7994,7928,7984,7960,28,4,66138,5265268040,128958
630,p1209,20120120,7984,7960,8004,8056,7998,8044,8030,84,70,49542,3978382640,126184
631,p1209,20120130,8044,8030,8052,8072,8016,8026,8048,-4,18,52186,4200157800,127908
632,p1209,20120131,8026,8048,7950,7990,7950,7976,7970,-72,-78,57572,4589053560,132212
633,p1209,20120201,7976,7970,7990,8052,7984,8010,8020,40,50,63116,5062509240,132134
634,p1209,20120202,8010,8020,8018,8106,8018,8092,8078,72,58,111332,8995031960,137448
635,p1209,20120203,8092,8078,8098,8120,8070,8084,8092,6,14,79004,6394061560,141440
636,p1209,20120206,8084,8092,8144,8180,8130,8168,8160,76,68,85146,6949195400,148458
637,p1209,20120207,8168,8160,8180,8196,8100,8134,8148,-26,-12,96070,7829419840,145926
638,p1209,20120208,8134,8148,8150,8230,8134,8230,8176,82,28,122210,9994086960,150938
639,p1209,20120209,8230,8176,8200,8268,8200,8246,8238,70,62,150364,12387039280,152666
640,p1209,20120210,8246,8238,8232,8234,8176,8190,8194,-48,-44,82294,6743911080,153148
641,p1209,20120213,8190,8194,8218,8290,8210,8270,8256,76,62,136920,11305250920,154436
642,p1209,20120214,8270,8256,8302,8312,8250,8260,8276,4,20,93920,7773499240,154262
643,p1209,20120215,8260,8276,8282,8312,8260,8262,8284,-14,8,109942,9109104000,157152
644,p1209,20120216,8262,8284,8260,8278,8172,8218,8214,-66,-70,120152,9870766080,155134
645,p1209,20120217,8218,8214,8240,8296,8240,8286,8276,72,62,85110,7044894320,155406
646,p1209,20120220,8286,8276,8350,8410,8326,8334,8366,58,90,146592,12265654120,179216
647,p1209,20120221,8334,8366,8360,8370,8302,8366,8340,0,-26,131620,10978096720,185058
648,p1209,20120222,8366,8340,8394,8394,8350,8366,8366,26,26,75796,6341738920,191210
649,p1209,20120223,8366,8366,8362,8366,8312,8364,8334,-2,-32,80786,6733909360,191958
650,p1209,20120224,8364,8334,8364,8374,8312,8348,8340,14,6,110988,9258485000,197852
651,p1209,20120227,8348,8340,8378,8414,8358,8388,8392,48,52,94108,7898926400,201538
652,p1209,20120228,8388,8392,8408,8438,8398,8434,8416,42,24,69506,5850249680,194630
653,p1209,20120229,8434,8416,8412,8420,8380,8408,8398,-8,-18,64278,5399150840,192112
654,p1209,20120301,8408,8398,8360,8376,8296,8298,8338,-100,-60,129632,10811031760,187580
655,p1209,20120302,8298,8338,8336,8360,8326,8350,8344,12,6,66482,5547933800,185604
656,p1209,20120305,8350,8344,8376,8390,8324,8358,8356,14,12,73882,6173682920,186498
657,p1209,20120306,8358,8356,8350,8350,8310,8322,8326,-34,-30,62306,5187612200,188050
658,p1209,20120307,8322,8326,8280,8290,8252,8262,8270,-64,-56,59848,4950434960,185994
659,p1209,20120308,8262,8270,8272,8346,8264,8340,8310,70,40,107276,8916580240,195886
660,p1209,20120309,8340,8310,8370,8570,8366,8568,8504,258,194,323004,27474204280,235146
661,p1209,20120312,8568,8504,8550,8582,8500,8530,8544,26,40,268502,22941285200,253894
662,p1209,20120313,8530,8544,8520,8608,8510,8596,8566,52,22,208692,17878963640,268030
663,p1209,20120314,8596,8566,8650,8688,8562,8582,8624,16,58,282606,24375465120,257900
664,p1209,20120315,8582,8624,8610,8664,8572,8614,8628,-10,4,276508,23859503400,256708
665,p1209,20120316,8614,8628,8670,8694,8610,8624,8654,-4,26,178796,15474563280,259004
666,p1209,20120319,8624,8654,8654,8690,8636,8658,8666,4,12,138356,11990143560,256632
667,p1209,20120320,8658,8666,8640,8644,8536,8542,8586,-124,-80,183290,15737311400,233878
668,p1209,20120321,8542,8586,8512,8554,8500,8532,8532,-54,-54,115306,9839423560,235586
669,p1209,20120322,8532,8532,8550,8594,8506,8508,8550,-24,18,167466,14319132880,233092
670,p1209,20120323,8508,8550,8524,8644,8522,8642,8584,92,34,178606,15333133920,233876
671,p1209,20120326,8642,8584,8696,8770,8668,8766,8740,182,156,238792,20872598000,269254
672,p1209,20120327,8766,8740,8760,8770,8708,8742,8732,2,-8,161820,14132163840,250806
673,p1209,20120328,8742,8732,8712,8774,8676,8716,8730,-16,-2,233098,20350014640,238762
674,p1209,20120329,8716,8730,8710,8734,8620,8664,8678,-66,-52,241496,20959969240,227584
675,p1209,20120330,8664,8678,8618,8636,8570,8574,8600,-104,-78,135300,11638419920,217416
676,p1209,20120405,8574,8600,8810,8888,8766,8876,8828,276,228,186252,16442462240,226602
677,p1209,20120406,8876,8828,8898,8982,8882,8968,8932,140,104,221622,19796335920,227696
678,p1209,20120409,8968,8932,9030,9030,8944,8956,8978,24,46,176162,15817188400,225380
679,p1209,20120410,8956,8978,8950,9034,8928,9026,8972,48,-6,192478,17270262520,231284
680,p1209,20120411,9026,8972,8952,8954,8864,8908,8906,-64,-66,191622,17066419680,219348
681,p1209,20120412,8908,8906,8938,8948,8892,8932,8922,26,16,174530,15572441640,225364
682,p1209,20120413,8932,8922,9000,9026,8964,8980,8992,58,70,212410,19102726680,236686
683,p1209,20120416,8980,8992,8850,8890,8822,8856,8856,-136,-136,191804,16988945160,235224
684,p1209,20120417,8856,8856,8850,8876,8842,8862,8858,6,2,131816,11676775080,234102
685,p1209,20120418,8862,8858,8896,8916,8790,8854,8858,-4,0,284784,25226393800,229546
686,p1209,20120419,8854,8858,8820,8844,8806,8842,8826,-16,-32,144524,12758099480,234652
687,p1209,20120420,8842,8826,8836,8850,8802,8820,8820,-6,-6,166120,14654411800,234470
688,p1209,20120423,8820,8820,8900,8928,8874,8878,8900,58,80,127652,11361406800,232814
689,p1209,20120424,8878,8900,8850,8858,8770,8786,8812,-114,-88,186352,16422737320,242864
690,p1209,20120425,8786,8812,8852,8862,8752,8756,8790,-56,-22,238194,20941858880,248708
691,p1209,20120426,8756,8790,8766,8788,8726,8774,8758,-16,-32,270504,23694500880,232532
692,p1209,20120427,8774,8758,8798,8798,8760,8774,8776,16,18,99450,8728686400,219834
693,p1209,20120502,8774,8776,8770,8778,8712,8730,8736,-46,-40,127394,11130085560,219562
694,p1209,20120503,8730,8736,8702,8714,8630,8634,8672,-102,-64,129226,11206520120,218988
695,p1209,20120504,8634,8672,8600,8652,8596,8650,8630,-22,-42,104284,9001001360,210462
696,p1209,20120507,8650,8630,8572,8586,8510,8540,8540,-90,-90,130218,11122771200,207730
697,p1209,20120508,8540,8540,8562,8614,8554,8582,8590,42,50,111838,9608936520,206418
698,p1209,20120509,8582,8590,8548,8570,8512,8564,8538,-26,-52,94146,8039778880,203134
699,p1209,20120510,8564,8538,8552,8662,8542,8650,8608,112,70,236426,20355650480,212072
700,p1209,20120511,8650,8608,8620,8648,8432,8438,8526,-170,-82,262726,22404911600,201418
701,p1209,20120514,8438,8526,8444,8444,8264,8286,8334,-240,-192,240426,20040986280,190326
702,p1209,20120515,8286,8334,8240,8256,8170,8230,8214,-104,-120,174364,14325648560,194112
703,p1209,20120516,8230,8214,8228,8270,8090,8118,8192,-96,-22,200634,16437245080,184150
704,p1209,20120517,8118,8192,8170,8200,8080,8156,8150,-36,-42,206160,16803588840,173632
705,p1209,20120518,8156,8150,8120,8124,7966,7974,8024,-176,-126,300324,24098879800,179762
706,p1209,20120521,7974,8024,8028,8110,7996,8076,8062,52,38,200188,16139296320,162100
707,p1209,20120522,8076,8062,8056,8118,8056,8090,8090,28,28,165582,13396036720,159030
708,p1209,20120523,8090,8090,7998,8000,7890,7910,7946,-180,-144,193914,15410086320,163372
709,p1209,20120524,7910,7946,7900,7928,7828,7926,7884,-20,-62,221750,17486967080,172068
710,p1209,20120525,7926,7884,7922,7948,7856,7942,7912,58,28,233862,18503314880,170802
711,p1209,20120528,7942,7912,7980,8040,7958,8022,8000,110,88,161244,12900507640,156068
712,p1209,20120529,8022,8000,8004,8062,7986,8052,8020,52,20,144484,11589288040,151342
713,p1209,20120530,8052,8020,8020,8036,7968,7982,8002,-38,-18,125762,10065699000,147656
714,p1209,20120531,7982,8002,7922,7950,7896,7906,7930,-96,-72,69458,5508179240,146306
715,p1209,20120601,7906,7930,7872,7898,7788,7800,7838,-130,-92,114672,8989481760,141962
716,p1209,20120604,7800,7838,7798,7798,7536,7570,7630,-268,-208,146594,11187831920,137432
717,p1209,20120605,7570,7630,7630,7700,7610,7652,7650,22,20,83366,6377926360,126474
718,p1209,20120606,7652,7650,7652,7746,7642,7686,7710,36,60,96470,7438060120,121860
719,p1209,20120607,7686,7710,7750,7802,7710,7734,7760,24,50,51900,4028227600,118530
720,p1209,20120608,7734,7760,7796,7796,7450,7720,7718,-40,-42,68066,5254369040,115604
721,p1209,20120611,7720,7718,7772,7880,7764,7858,7838,140,120,56130,4399532080,103606
722,p1209,20120612,7858,7838,7800,7800,7738,7784,7760,-54,-78,35828,2780284800,102112
723,p1209,20120613,7784,7760,7788,7788,7738,7748,7758,-12,-2,23880,1852972640,97706
724,p1209,20120614,7748,7758,7700,7700,7576,7576,7622,-182,-136,33130,2525621320,98808
725,p1209,20120615,7576,7622,7588,7640,7552,7610,7604,-12,-18,29796,2265721240,94488
726,p1209,20120618,7610,7604,7640,7718,7638,7674,7678,70,74,33664,2584828840,92326
727,p1209,20120619,7674,7678,7710,7748,7670,7714,7722,36,44,26114,2016610920,87414
728,p1209,20120620,7714,7722,7792,7906,7766,7898,7840,176,118,27032,2119716760,79820
729,p1209,20120621,7898,7840,7768,7874,7768,7840,7834,0,-6,25340,1985551120,74690
730,p1209,20120625,7840,7834,7890,7990,7858,7866,7936,32,102,19910,1580454560,71962
731,p1209,20120626,7866,7936,7916,7930,7832,7850,7874,-86,-62,12754,1004497520,69226
732,p1209,20120627,7850,7874,7852,7878,7800,7850,7840,-24,-34,7610,596751640,67772
733,p1209,20120628,7850,7840,7860,7880,7810,7814,7832,-26,-8,5818,455725560,66336
734,p1209,20120629,7814,7832,7798,7896,7784,7896,7854,64,22,5998,471114920,64916
735,p1209,20120702,7896,7854,8002,8050,7934,7946,7960,92,106,10244,815477000,60030
736,p1209,20120703,7946,7960,7960,8004,7944,8000,7986,40,26,7568,604510400,58174
737,p1209,20120704,8000,7986,8022,8054,7968,8010,8028,24,42,6892,553330360,55568
738,p1209,20120705,8010,8028,8002,8066,7986,8028,8020,0,-8,6994,561019000,52874
739,p1209,20120706,8028,8020,8128,8128,8014,8018,8060,-2,40,10764,867663640,47350
740,p1209,20120709,8018,8060,7992,8116,7990,8092,8060,32,0,5030,405483240,45940
741,p1209,20120710,8092,8060,8064,8090,8010,8018,8052,-42,-8,2780,223861640,45476
742,p1209,20120711,8018,8052,8030,8084,7914,7964,7996,-88,-56,5238,418914680,44320
743,p1209,20120712,7964,7996,7932,7944,7840,7852,7872,-144,-124,6472,509482600,40624
744,p1209,20120713,7852,7872,7872,7902,7826,7900,7866,28,-6,2132,167738280,40032
745,p1209,20120716,7900,7866,7968,8100,7968,8076,8060,210,194,2032,163790200,39302
746,p1209,20120717,8076,8060,8060,8114,7940,7982,7996,-78,-64,1236,98853240,38676
747,p1209,20120718,7982,7996,8018,8018,7842,7872,7906,-124,-90,3836,303294880,35994
748,p1209,20120719,7872,7906,7902,7932,7650,7906,7900,0,-6,4390,346838960,35046
749,p1209,20120720,7906,7900,7922,7960,7862,7922,7916,22,16,4002,316822720,32416
750,p1209,20120723,7922,7916,7886,7886,7720,7728,7742,-188,-174,1822,141093600,31088
751,p1209,20120724,7728,7742,7434,7600,7434,7548,7556,-194,-186,1980,149623240,29514
752,p1209,20120725,7548,7556,7508,7580,7496,7510,7550,-46,-6,814,61467320,29272
753,p1209,20120726,7510,7550,7540,7580,7500,7560,7540,10,-10,1422,107247200,28424
754,p1209,20120727,7560,7540,7544,7634,7544,7634,7568,94,28,1970,149107520,26918
755,p1209,20120730,7634,7568,7672,7750,7660,7700,7718,132,150,1172,90462200,26312
756,p1209,20120731,7700,7718,7700,7730,7652,7698,7676,-20,-42,1376,105640480,25104
757,p1209,20120801,7698,7676,7680,7738,7680,7710,7716,34,40,6592,508691520,21362
758,p1209,20120802,7710,7716,7650,7650,7558,7590,7584,-126,-132,3656,277293880,18082
759,p1209,20120803,7590,7584,7600,7626,7552,7594,7606,10,22,2024,153982440,16842
760,p1209,20120806,7594,7606,7572,7690,7572,7650,7652,44,46,1800,137742360,16486
761,p1209,20120807,7650,7652,7650,7696,7650,7684,7676,32,24,380,29169560,16220
762,p1209,20120808,7684,7676,7668,7668,7612,7622,7626,-54,-50,498,37980440,15800
763,p1209,20120809,7622,7626,7634,7706,7634,7700,7672,74,46,3522,270230680,12496
764,p1209,20120810,7700,7672,7748,7748,7592,7628,7634,-44,-38,2492,190285320,10098
765,p1209,20120813,7628,7634,7680,7680,7584,7584,7638,-50,4,1706,130317440,8428
766,p1209,20120814,7584,7638,7568,7568,7440,7510,7512,-128,-126,886,66562680,7686
767,p1209,20120815,7510,7512,7510,7550,7476,7514,7522,2,10,772,58074000,6996
768,p1209,20120816,7514,7522,7550,7550,7440,7440,7482,-82,-40,1062,79465280,6092
769,p1209,20120817,7440,7482,7464,7502,7460,7460,7492,-22,10,1630,122132040,5306
770,p1209,20120820,7460,7492,7448,7448,7414,7442,7432,-50,-60,292,21704320,5312
771,p1209,20120821,7442,7432,7452,7452,7410,7428,7426,-4,-6,360,26737320,5274
772,p1209,20120822,7428,7426,7434,7542,7432,7512,7502,86,76,2050,153796400,5198
773,p1209,20120823,7512,7502,7522,7726,7510,7566,7556,64,54,806,60916520,5158
774,p1209,20120824,7566,7556,7684,7738,7596,7738,7690,182,134,452,34764560,5000
775,p1209,20120827,7738,7690,7742,7846,7722,7800,7810,110,120,252,19683040,5004
776,p1209,20120828,7800,7810,7802,7802,7644,7672,7710,-138,-100,228,17582760,4878
777,p1209,20120829,7672,7710,7670,7720,7600,7610,7670,-100,-40,792,60759880,4540
778,p1209,20120830,7610,7670,7622,7676,7600,7676,7636,6,-34,522,39860760,4490
779,p1209,20120831,7676,7636,7552,7606,7544,7556,7572,-80,-64,408,30901240,4364
780,p1209,20120903,7556,7572,7670,7720,7670,7688,7636,116,64,132,10082000,4358
781,p1209,20120904,7688,7636,7750,7756,7702,7702,7676,66,40,114,8751960,4358
782,p1209,20120905,7702,7676,7758,7778,7742,7778,7758,102,82,6,465560,4358
783,p1209,20120906,7778,7758,7552,7552,7552,7552,7552,-206,-206,12,906240,4358
784,p1209,20120907,7552,7552,0,0,0,7552,7552,0,0,0,0,4358
785,p1209,20120910,7552,7552,0,0,0,7552,7552,0,0,0,0,4358
786,p1209,20120911,7552,7552,7510,7510,7500,7500,7504,-52,-48,202,15160040,4358
787,p1209,20120912,7500,7504,7496,7540,7450,7540,7498,36,-6,200,14998320,4358
788,p1209,20120913,7540,7498,7550,7550,7550,7550,7550,52,52,20,1510000,4358
789,p1209,20120914,7550,7550,7580,7580,7580,7580,7562,30,12,20,1516000,0
790,p1210,20120104,8006,8006,0,0,0,8006,8006,0,0,0,0,0
791,p1210,20120105,8006,8006,0,0,0,8006,8006,0,0,0,0,0
792,p1210,20120106,8006,8006,0,0,0,8006,8006,0,0,0,0,0
793,p1210,20120109,8006,8006,0,0,0,8006,8006,0,0,0,0,0
794,p1210,20120110,8006,8006,0,0,0,8006,8006,0,0,0,0,0
795,p1210,20120111,8006,8006,8110,8238,8012,8206,8134,200,128,34,2766200,0
796,p1210,20120112,8206,8134,0,0,0,8134,8134,0,0,0,0,0
797,p1210,20120113,8134,8134,0,0,0,8134,8134,0,0,0,0,0
798,p1210,20120116,8134,8134,0,0,0,8134,8134,0,0,0,0,0
799,p1210,20120117,8134,8134,0,0,0,8134,8134,0,0,0,0,0
800,p1210,20120118,8134,8134,0,0,0,8134,8134,0,0,0,0,0
801,p1210,20120119,8134,8134,8130,8130,8046,8046,8080,-88,-54,12,969640,12
802,p1210,20120120,8046,8080,7928,8038,7928,8038,7978,-42,-102,24,1914960,8
803,p1210,20120130,8038,7978,0,0,0,7978,7978,0,0,0,0,8
804,p1210,20120131,7978,7978,0,0,0,7978,7978,0,0,0,0,8
805,p1210,20120201,7978,7978,0,0,0,7978,7978,0,0,0,0,8
806,p1210,20120202,7978,7978,8186,8186,8072,8072,8110,94,132,6,486600,8
807,p1210,20120203,8072,8110,8166,8290,8082,8082,8170,-28,60,22,1797560,10
808,p1210,20120206,8082,8170,8220,8240,8220,8240,8230,70,60,4,329200,8
809,p1210,20120207,8240,8230,0,0,0,8230,8230,0,0,0,0,8
810,p1210,20120208,8230,8230,8164,8244,8164,8244,8166,14,-64,54,4410160,52
811,p1210,20120209,8244,8166,8220,8254,8134,8134,8202,-32,36,6,492160,52
812,p1210,20120210,8134,8202,0,0,0,8202,8202,0,0,0,0,52
813,p1210,20120213,8202,8202,8200,8200,8200,8200,8200,-2,-2,28,2296000,52
814,p1210,20120214,8200,8200,8230,8230,8230,8230,8230,30,30,2,164600,52
815,p1210,20120215,8230,8230,0,0,0,8230,8230,0,0,0,0,52
816,p1210,20120216,8230,8230,8290,8290,8152,8152,8220,-78,-10,12,986520,46
817,p1210,20120217,8152,8220,0,0,0,8220,8220,0,0,0,0,46
818,p1210,20120220,8220,8220,0,0,0,8220,8220,0,0,0,0,46
819,p1210,20120221,8220,8220,0,0,0,8220,8220,0,0,0,0,46
820,p1210,20120222,8220,8220,8396,8396,8280,8304,8332,84,112,48,3999840,46
821,p1210,20120223,8304,8332,8266,8300,8254,8300,8264,-32,-68,20,1653120,42
822,p1210,20120224,8300,8264,8306,8324,8270,8280,8292,16,28,12,995160,42
823,p1210,20120227,8280,8292,8310,8362,8310,8340,8330,48,38,10,833120,42
824,p1210,20120228,8340,8330,8354,8386,8350,8350,8362,20,32,6,501800,42
825,p1210,20120229,8350,8362,0,0,0,8362,8362,0,0,0,0,42
826,p1210,20120301,8362,8362,8322,8344,8304,8304,8320,-58,-42,22,1830520,42
827,p1210,20120302,8304,8320,0,0,0,8320,8320,0,0,0,0,42
828,p1210,20120305,8320,8320,8316,8320,8266,8320,8308,0,-12,12,997000,42
829,p1210,20120306,8320,8308,0,0,0,8308,8308,0,0,0,0,42
830,p1210,20120307,8308,8308,8322,8322,8230,8230,8276,-78,-32,4,331040,40
831,p1210,20120308,8230,8276,0,0,0,8276,8276,0,0,0,0,40
832,p1210,20120309,8276,8276,8360,8530,8360,8528,8476,252,200,42,3560120,40
833,p1210,20120312,8528,8476,8558,8558,8462,8480,8526,4,50,120,10233480,44
834,p1210,20120313,8480,8526,8490,8544,8482,8544,8506,18,-20,22,1871400,40
835,p1210,20120314,8544,8506,8650,8650,8500,8566,8596,60,90,28,2406880,40
836,p1210,20120315,8566,8596,0,0,0,8596,8596,0,0,0,0,40
837,p1210,20120316,8596,8596,8688,8688,8580,8580,8634,-16,38,4,345360,40
838,p1210,20120319,8580,8634,0,0,0,8634,8634,0,0,0,0,40
839,p1210,20120320,8634,8634,8644,8644,8482,8520,8564,-114,-70,22,1884200,44
840,p1210,20120321,8520,8564,8500,8502,8500,8502,8500,-62,-64,6,510080,40
841,p1210,20120322,8502,8500,8598,8598,8512,8530,8546,30,46,6,512800,40
842,p1210,20120323,8530,8546,8442,8580,8442,8580,8558,34,12,34,2910040,42
843,p1210,20120326,8580,8558,8662,8720,8662,8678,8680,120,122,8,694520,44
844,p1210,20120327,8678,8680,8688,8696,8658,8658,8682,-22,2,8,694600,44
845,p1210,20120328,8658,8682,8724,8724,8680,8680,8702,-2,20,4,348080,42
846,p1210,20120329,8680,8702,8642,8642,8642,8642,8642,-60,-60,4,345680,40
847,p1210,20120330,8642,8642,8606,8606,8552,8552,8578,-90,-64,4,343160,40
848,p1210,20120405,8552,8578,8706,8780,8706,8780,8742,202,164,4,349720,40
849,p1210,20120406,8780,8742,8864,8940,8836,8874,8880,132,138,26,2309280,40
850,p1210,20120409,8874,8880,8936,8936,8936,8936,8936,56,56,2,178720,40
851,p1210,20120410,8936,8936,0,0,0,8936,8936,0,0,0,0,40
852,p1210,20120411,8936,8936,8966,8966,8840,8912,8902,-24,-34,66,5875680,22
853,p1210,20120412,8912,8902,8870,8898,8806,8898,8836,-4,-66,28,2474400,12
854,p1210,20120413,8898,8836,0,0,0,8836,8836,0,0,0,0,12
855,p1210,20120416,8836,8836,8860,8886,8856,8856,8876,20,40,22,1952880,8
856,p1210,20120417,8856,8876,0,0,0,8876,8876,0,0,0,0,8
857,p1210,20120418,8876,8876,0,0,0,8876,8876,0,0,0,0,8
858,p1210,20120419,8876,8876,0,0,0,8876,8876,0,0,0,0,8
859,p1210,20120420,8876,8876,0,0,0,8876,8876,0,0,0,0,8
860,p1210,20120423,8876,8876,0,0,0,8876,8876,0,0,0,0,8
861,p1210,20120424,8876,8876,8904,8904,8780,8792,8822,-84,-54,52,4587960,8
862,p1210,20120425,8792,8822,0,0,0,8822,8822,0,0,0,0,8
863,p1210,20120426,8822,8822,8688,8798,8688,8734,8740,-88,-82,18,1573200,8
864,p1210,20120427,8734,8740,8724,8794,8724,8794,8760,54,20,8,700920,4
865,p1210,20120502,8794,8760,8824,8836,8674,8730,8748,-30,-12,20,1749760,10
866,p1210,20120503,8730,8748,8690,8690,8690,8690,8690,-58,-58,2,173800,8
867,p1210,20120504,8690,8690,0,0,0,8690,8690,0,0,0,0,8
868,p1210,20120507,8690,8690,0,0,0,8690,8690,0,0,0,0,8
869,p1210,20120508,8690,8690,8596,8628,8480,8616,8572,-74,-118,16,1371720,6
870,p1210,20120509,8616,8572,0,0,0,8572,8572,0,0,0,0,6
871,p1210,20120510,8572,8572,8566,8612,8546,8612,8588,40,16,10,858960,12
872,p1210,20120511,8612,8588,8580,8580,8520,8520,8564,-68,-24,8,685200,4
873,p1210,20120514,8520,8564,0,0,0,8564,8564,0,0,0,0,4
874,p1210,20120515,8564,8564,0,0,0,8564,8564,0,0,0,0,4
875,p1210,20120516,8564,8564,0,0,0,8564,8564,0,0,0,0,4
876,p1210,20120517,8564,8564,0,0,0,8564,8564,0,0,0,0,4
877,p1210,20120518,8564,8564,8224,8224,8224,8224,8224,-340,-340,2,164480,2
878,p1210,20120521,8224,8224,0,0,0,8224,8224,0,0,0,0,2
879,p1210,20120522,8224,8224,0,0,0,8224,8224,0,0,0,0,2
880,p1210,20120523,8224,8224,7918,8042,7918,8006,7992,-218,-232,10,799280,6
881,p1210,20120524,8006,7992,0,0,0,7992,7992,0,0,0,0,6
882,p1210,20120525,7992,7992,7892,7892,7892,7892,7892,-100,-100,4,315680,2
883,p1210,20120528,7892,7892,0,0,0,7892,7892,0,0,0,0,2
884,p1210,20120529,7892,7892,0,0,0,7892,7892,0,0,0,0,2
885,p1210,20120530,7892,7892,7892,8114,7892,7970,8006,78,114,10,800760,2
886,p1210,20120531,7970,8006,7888,7888,7888,7888,7888,-118,-118,2,157760,4
887,p1210,20120601,7888,7888,7860,7860,7860,7860,7860,-28,-28,2,157200,2
888,p1210,20120604,7860,7860,0,0,0,7860,7860,0,0,0,0,2
889,p1210,20120605,7860,7860,7798,7798,7600,7670,7694,-190,-166,328,25242040,4
890,p1210,20120606,7670,7694,0,0,0,7694,7694,0,0,0,0,4
891,p1210,20120607,7694,7694,0,0,0,7694,7694,0,0,0,0,4
892,p1210,20120608,7694,7694,7726,7746,7636,7746,7698,52,4,10,769800,6
893,p1210,20120611,7746,7698,7866,7964,7866,7964,7898,266,200,6,473920,4
894,p1210,20120612,7964,7898,0,0,0,7898,7898,0,0,0,0,4
895,p1210,20120613,7898,7898,0,0,0,7898,7898,0,0,0,0,4
896,p1210,20120614,7898,7898,0,0,0,7898,7898,0,0,0,0,4
897,p1210,20120615,7898,7898,7584,7584,7584,7584,7584,-314,-314,2,151680,4
898,p1210,20120618,7584,7584,0,0,0,7584,7584,0,0,0,0,4
899,p1210,20120619,7584,7584,0,0,0,7584,7584,0,0,0,0,4
900,p1210,20120620,7584,7584,7886,7886,7886,7886,7886,302,302,2,157720,2
901,p1210,20120621,7886,7886,7978,7978,7770,7888,7842,2,-44,22,1725360,14
902,p1210,20120625,7888,7842,7940,7940,7940,7940,7940,98,98,10,794000,4
903,p1210,20120626,7940,7940,0,0,0,7940,7940,0,0,0,0,4
904,p1210,20120627,7940,7940,0,0,0,7940,7940,0,0,0,0,4
905,p1210,20120628,7940,7940,0,0,0,7940,7940,0,0,0,0,4
906,p1210,20120629,7940,7940,7850,7920,7850,7920,7884,-20,-56,4,315400,2
907,p1210,20120702,7920,7884,8020,8020,7926,7926,7972,42,88,4,318920,2
908,p1210,20120703,7926,7972,0,0,0,7972,7972,0,0,0,0,2
909,p1210,20120704,7972,7972,0,0,0,7972,7972,0,0,0,0,2
910,p1210,20120705,7972,7972,0,0,0,7972,7972,0,0,0,0,2
911,p1210,20120706,7972,7972,0,0,0,7972,7972,0,0,0,0,2
912,p1210,20120709,7972,7972,0,0,0,7972,7972,0,0,0,0,2
913,p1210,20120710,7972,7972,0,0,0,7972,7972,0,0,0,0,2
914,p1210,20120711,7972,7972,0,0,0,7972,7972,0,0,0,0,2
915,p1210,20120712,7972,7972,8082,8082,7910,7938,8000,-34,28,10,800120,4
916,p1210,20120713,7938,8000,0,0,0,8000,8000,0,0,0,0,4
917,p1210,20120716,8000,8000,8078,8078,8078,8078,8078,78,78,2,161560,2
918,p1210,20120717,8078,8078,8074,8074,8074,8074,8074,-4,-4,2,161480,2
919,p1210,20120718,8074,8074,0,0,0,8074,8074,0,0,0,0,2
920,p1210,20120719,8074,8074,0,0,0,8074,8074,0,0,0,0,2
921,p1210,20120720,8074,8074,0,0,0,8074,8074,0,0,0,0,2
922,p1210,20120723,8074,8074,0,0,0,8074,8074,0,0,0,0,2
923,p1210,20120724,8074,8074,0,0,0,8074,8074,0,0,0,0,2
924,p1210,20120725,8074,8074,0,0,0,8074,8074,0,0,0,0,2
925,p1210,20120726,8074,8074,7598,7598,7598,7598,7598,-476,-476,2,151960,0
926,p1210,20120727,7598,7598,0,0,0,7598,7598,0,0,0,0,0
927,p1210,20120730,7598,7598,0,0,0,7598,7598,0,0,0,0,0
928,p1210,20120731,7598,7598,7900,7900,7618,7810,7790,212,192,54,4207320,8
929,p1210,20120801,7810,7790,7696,7800,7696,7800,7754,10,-36,14,1085760,0
930,p1210,20120802,7800,7754,0,0,0,7754,7754,0,0,0,0,0
931,p1210,20120803,7754,7754,0,0,0,7754,7754,0,0,0,0,0
932,p1210,20120806,7754,7754,0,0,0,7754,7754,0,0,0,0,0
933,p1210,20120807,7754,7754,0,0,0,7754,7754,0,0,0,0,0
934,p1210,20120808,7754,7754,0,0,0,7754,7754,0,0,0,0,0
935,p1210,20120809,7754,7754,0,0,0,7754,7754,0,0,0,0,0
936,p1210,20120810,7754,7754,0,0,0,7754,7754,0,0,0,0,0
937,p1210,20120813,7754,7754,0,0,0,7754,7754,0,0,0,0,0
938,p1210,20120814,7754,7754,0,0,0,7754,7754,0,0,0,0,0
939,p1210,20120815,7754,7754,0,0,0,7754,7754,0,0,0,0,0
940,p1210,20120816,7754,7754,0,0,0,7754,7754,0,0,0,0,0
941,p1210,20120817,7754,7754,0,0,0,7754,7754,0,0,0,0,0
942,p1210,20120820,7754,7754,0,0,0,7754,7754,0,0,0,0,0
943,p1210,20120821,7754,7754,0,0,0,7754,7754,0,0,0,0,0
944,p1210,20120822,7754,7754,0,0,0,7754,7754,0,0,0,0,0
945,p1210,20120823,7754,7754,0,0,0,7754,7754,0,0,0,0,0
946,p1210,20120824,7754,7754,0,0,0,7754,7754,0,0,0,0,0
947,p1210,20120827,7754,7754,0,0,0,7754,7754,0,0,0,0,0
948,p1210,20120828,7754,7754,0,0,0,7754,7754,0,0,0,0,0
949,p1210,20120829,7754,7754,0,0,0,7754,7754,0,0,0,0,0
950,p1210,20120830,7754,7754,0,0,0,7754,7754,0,0,0,0,0
951,p1210,20120831,7754,7754,0,0,0,7754,7754,0,0,0,0,0
952,p1210,20120903,7754,7754,0,0,0,7754,7754,0,0,0,0,0
953,p1210,20120904,7754,7754,0,0,0,7754,7754,0,0,0,0,0
954,p1210,20120905,7754,7754,0,0,0,7754,7754,0,0,0,0,0
955,p1210,20120906,7754,7754,0,0,0,7754,7754,0,0,0,0,0
956,p1210,20120907,7754,7754,0,0,0,7754,7754,0,0,0,0,0
957,p1210,20120910,7754,7754,0,0,0,7754,7754,0,0,0,0,0
958,p1210,20120911,7754,7754,0,0,0,7754,7754,0,0,0,0,0
959,p1210,20120912,7754,7754,0,0,0,7754,7754,0,0,0,0,0
960,p1210,20120913,7754,7754,0,0,0,7754,7754,0,0,0,0,0
961,p1210,20120914,7754,7754,0,0,0,7754,7754,0,0,0,0,0
962,p1210,20120917,7754,7754,0,0,0,7754,7754,0,0,0,0,0
963,p1210,20120918,7754,7754,0,0,0,7754,7754,0,0,0,0,0
964,p1210,20120919,7754,7754,0,0,0,7754,7754,0,0,0,0,0
965,p1210,20120920,7754,7754,0,0,0,7754,7754,0,0,0,0,0
966,p1210,20120921,7754,7754,0,0,0,7754,7754,0,0,0,0,0
967,p1210,20120924,7754,7754,0,0,0,7754,7754,0,0,0,0,0
968,p1210,20120925,7754,7754,0,0,0,7754,7754,0,0,0,0,0
969,p1210,20120926,7754,7754,7754,7754,7444,7444,7684,-310,-70,18,1383320,10
970,p1210,20120927,7444,7684,7224,7224,7224,7224,7224,-460,-460,10,722400,0
971,p1210,20120928,7224,7224,0,0,0,7224,7224,0,0,0,0,0
972,p1210,20121008,7224,7224,0,0,0,7224,7224,0,0,0,0,0
973,p1210,20121009,7224,7224,0,0,0,7224,7224,0,0,0,0,0
974,p1210,20121010,7224,7224,0,0,0,7224,7224,0,0,0,0,0
975,p1210,20121011,7224,7224,0,0,0,7224,7224,0,0,0,0,0
976,p1210,20121012,7224,7224,0,0,0,7224,7224,0,0,0,0,0
977,p1210,20121015,7224,7224,0,0,0,7224,7224,0,0,0,0,0
978,p1210,20121016,7224,7224,0,0,0,7224,7224,0,0,0,0,0
979,p1210,20121017,7224,7224,0,0,0,7224,7224,0,0,0,0,0
980,p1210,20121018,7224,7224,0,0,0,7224,7224,0,0,0,0,0
981,p1210,20121019,7224,7224,0,0,0,7224,7224,0,0,0,0,0
982,p1211,20120104,7782,7782,0,0,0,7782,7782,0,0,0,0,0
983,p1211,20120105,7782,7782,0,0,0,7782,7782,0,0,0,0,0
984,p1211,20120106,7782,7782,0,0,0,7782,7782,0,0,0,0,0
985,p1211,20120109,7782,7782,0,0,0,7782,7782,0,0,0,0,0
986,p1211,20120110,7782,7782,0,0,0,7782,7782,0,0,0,0,0
987,p1211,20120111,7782,7782,0,0,0,7782,7782,0,0,0,0,0
988,p1211,20120112,7782,7782,0,0,0,7782,7782,0,0,0,0,0
989,p1211,20120113,7782,7782,0,0,0,7782,7782,0,0,0,0,0
990,p1211,20120116,7782,7782,0,0,0,7782,7782,0,0,0,0,0
991,p1211,20120117,7782,7782,0,0,0,7782,7782,0,0,0,0,0
992,p1211,20120118,7782,7782,0,0,0,7782,7782,0,0,0,0,0
993,p1211,20120119,7782,7782,0,0,0,7782,7782,0,0,0,0,0
994,p1211,20120120,7782,7782,0,0,0,7782,7782,0,0,0,0,0
995,p1211,20120130,7782,7782,0,0,0,7782,7782,0,0,0,0,0
996,p1211,20120131,7782,7782,8146,8146,8146,8146,8146,364,364,4,325840,4
997,p1211,20120201,8146,8146,0,0,0,8146,8146,0,0,0,0,4
998,p1211,20120202,8146,8146,0,0,0,8146,8146,0,0,0,0,4
999,p1211,20120203,8146,8146,0,0,0,8146,8146,0,0,0,0,4
1000,p1211,20120206,8146,8146,8200,8200,7998,8170,8122,24,-24,6,487360,0
1001,p1211,20120207,8170,8122,0,0,0,8122,8122,0,0,0,0,0
1002,p1211,20120208,8122,8122,0,0,0,8122,8122,0,0,0,0,0
1003,p1211,20120209,8122,8122,0,0,0,8122,8122,0,0,0,0,0
1004,p1211,20120210,8122,8122,0,0,0,8122,8122,0,0,0,0,0
1005,p1211,20120213,8122,8122,0,0,0,8122,8122,0,0,0,0,0
1006,p1211,20120214,8122,8122,0,0,0,8122,8122,0,0,0,0,0
1007,p1211,20120215,8122,8122,0,0,0,8122,8122,0,0,0,0,0
1008,p1211,20120216,8122,8122,0,0,0,8122,8122,0,0,0,0,0
1009,p1211,20120217,8122,8122,0,0,0,8122,8122,0,0,0,0,0
1010,p1211,20120220,8122,8122,0,0,0,8122,8122,0,0,0,0,0
1011,p1211,20120221,8122,8122,0,0,0,8122,8122,0,0,0,0,0
1012,p1211,20120222,8122,8122,0,0,0,8122,8122,0,0,0,0,0
1013,p1211,20120223,8122,8122,0,0,0,8122,8122,0,0,0,0,0
1014,p1211,20120224,8122,8122,8528,8528,8400,8400,8464,278,342,8,677120,4
1015,p1211,20120227,8400,8464,0,0,0,8464,8464,0,0,0,0,4
1016,p1211,20120228,8464,8464,0,0,0,8464,8464,0,0,0,0,4
1017,p1211,20120229,8464,8464,0,0,0,8464,8464,0,0,0,0,4
1018,p1211,20120301,8464,8464,8430,8430,8350,8390,8394,-74,-70,16,1343200,4
1019,p1211,20120302,8390,8394,0,0,0,8394,8394,0,0,0,0,4
1020,p1211,20120305,8394,8394,0,0,0,8394,8394,0,0,0,0,4
1021,p1211,20120306,8394,8394,0,0,0,8394,8394,0,0,0,0,4
1022,p1211,20120307,8394,8394,0,0,0,8394,8394,0,0,0,0,4
1023,p1211,20120308,8394,8394,8350,8350,8350,8350,8350,-44,-44,2,167000,6
1024,p1211,20120309,8350,8350,8506,8506,8506,8506,8506,156,156,2,170120,8
1025,p1211,20120312,8506,8506,0,0,0,8506,8506,0,0,0,0,8
1026,p1211,20120313,8506,8506,0,0,0,8506,8506,0,0,0,0,8
1027,p1211,20120314,8506,8506,0,0,0,8506,8506,0,0,0,0,8
1028,p1211,20120315,8506,8506,0,0,0,8506,8506,0,0,0,0,8
1029,p1211,20120316,8506,8506,0,0,0,8506,8506,0,0,0,0,8
1030,p1211,20120319,8506,8506,0,0,0,8506,8506,0,0,0,0,8
1031,p1211,20120320,8506,8506,0,0,0,8506,8506,0,0,0,0,8
1032,p1211,20120321,8506,8506,0,0,0,8506,8506,0,0,0,0,8
1033,p1211,20120322,8506,8506,0,0,0,8506,8506,0,0,0,0,8
1034,p1211,20120323,8506,8506,0,0,0,8506,8506,0,0,0,0,8
1035,p1211,20120326,8506,8506,0,0,0,8506,8506,0,0,0,0,8
1036,p1211,20120327,8506,8506,0,0,0,8506,8506,0,0,0,0,8
1037,p1211,20120328,8506,8506,0,0,0,8506,8506,0,0,0,0,8
1038,p1211,20120329,8506,8506,0,0,0,8506,8506,0,0,0,0,8
1039,p1211,20120330,8506,8506,0,0,0,8506,8506,0,0,0,0,8
1040,p1211,20120405,8506,8506,0,0,0,8506,8506,0,0,0,0,8
1041,p1211,20120406,8506,8506,8930,8930,8930,8930,8930,424,424,2,178600,8
1042,p1211,20120409,8930,8930,0,0,0,8930,8930,0,0,0,0,8
1043,p1211,20120410,8930,8930,0,0,0,8930,8930,0,0,0,0,8
1044,p1211,20120411,8930,8930,0,0,0,8930,8930,0,0,0,0,8
1045,p1211,20120412,8930,8930,0,0,0,8930,8930,0,0,0,0,8
1046,p1211,20120413,8930,8930,0,0,0,8930,8930,0,0,0,0,8
1047,p1211,20120416,8930,8930,0,0,0,8930,8930,0,0,0,0,8
1048,p1211,20120417,8930,8930,0,0,0,8930,8930,0,0,0,0,8
1049,p1211,20120418,8930,8930,8880,8900,8880,8900,8890,-30,-40,4,355600,6
1050,p1211,20120419,8900,8890,8858,8890,8858,8890,8874,0,-16,8,709920,4
1051,p1211,20120420,8890,8874,0,0,0,8874,8874,0,0,0,0,4
1052,p1211,20120423,8874,8874,0,0,0,8874,8874,0,0,0,0,4
1053,p1211,20120424,8874,8874,8800,8800,8798,8798,8798,-76,-76,4,351960,4
1054,p1211,20120425,8798,8798,0,0,0,8798,8798,0,0,0,0,4
1055,p1211,20120426,8798,8798,8788,8788,8770,8770,8778,-28,-20,4,351160,2
1056,p1211,20120427,8770,8778,0,0,0,8778,8778,0,0,0,0,2
1057,p1211,20120502,8778,8778,0,0,0,8778,8778,0,0,0,0,2
1058,p1211,20120503,8778,8778,0,0,0,8778,8778,0,0,0,0,2
1059,p1211,20120504,8778,8778,0,0,0,8778,8778,0,0,0,0,2
1060,p1211,20120507,8778,8778,0,0,0,8778,8778,0,0,0,0,2
1061,p1211,20120508,8778,8778,0,0,0,8778,8778,0,0,0,0,2
1062,p1211,20120509,8778,8778,0,0,0,8778,8778,0,0,0,0,2
1063,p1211,20120510,8778,8778,0,0,0,8778,8778,0,0,0,0,2
1064,p1211,20120511,8778,8778,8622,8622,8622,8622,8622,-156,-156,2,172440,2
1065,p1211,20120514,8622,8622,0,0,0,8622,8622,0,0,0,0,2
1066,p1211,20120515,8622,8622,8296,8296,8296,8296,8296,-326,-326,2,165920,2
1067,p1211,20120516,8296,8296,0,0,0,8296,8296,0,0,0,0,2
1068,p1211,20120517,8296,8296,0,0,0,8296,8296,0,0,0,0,2
1069,p1211,20120518,8296,8296,0,0,0,8296,8296,0,0,0,0,2
1070,p1211,20120521,8296,8296,0,0,0,8296,8296,0,0,0,0,2
1071,p1211,20120522,8296,8296,0,0,0,8296,8296,0,0,0,0,2
1072,p1211,20120523,8296,8296,7980,7980,7980,7980,7980,-316,-316,2,159600,2
1073,p1211,20120524,7980,7980,0,0,0,7980,7980,0,0,0,0,2
1074,p1211,20120525,7980,7980,0,0,0,7980,7980,0,0,0,0,2
1075,p1211,20120528,7980,7980,0,0,0,7980,7980,0,0,0,0,2
1076,p1211,20120529,7980,7980,0,0,0,7980,7980,0,0,0,0,2
1077,p1211,20120530,7980,7980,0,0,0,7980,7980,0,0,0,0,2
1078,p1211,20120531,7980,7980,0,0,0,7980,7980,0,0,0,0,2
1079,p1211,20120601,7980,7980,0,0,0,7980,7980,0,0,0,0,2
1080,p1211,20120604,7980,7980,7662,7662,7662,7662,7662,-318,-318,2,153240,0
1081,p1211,20120605,7662,7662,0,0,0,7662,7662,0,0,0,0,0
1082,p1211,20120606,7662,7662,7590,7784,7590,7736,7696,74,34,26,2001160,12
1083,p1211,20120607,7736,7696,7842,7842,7788,7788,7832,92,136,12,939960,0
1084,p1211,20120608,7788,7832,0,0,0,7832,7832,0,0,0,0,0
1085,p1211,20120611,7832,7832,7880,7880,7860,7860,7870,28,38,4,314800,0
1086,p1211,20120612,7860,7870,0,0,0,7870,7870,0,0,0,0,0
1087,p1211,20120613,7870,7870,0,0,0,7870,7870,0,0,0,0,0
1088,p1211,20120614,7870,7870,0,0,0,7870,7870,0,0,0,0,0
1089,p1211,20120615,7870,7870,0,0,0,7870,7870,0,0,0,0,0
1090,p1211,20120618,7870,7870,0,0,0,7870,7870,0,0,0,0,0
1091,p1211,20120619,7870,7870,7934,7934,7688,7810,7758,-60,-112,32,2482640,16
1092,p1211,20120620,7810,7758,7860,7860,7860,7860,7860,102,102,14,1100400,2
1093,p1211,20120621,7860,7860,0,0,0,7860,7860,0,0,0,0,2
1094,p1211,20120625,7860,7860,0,0,0,7860,7860,0,0,0,0,2
1095,p1211,20120626,7860,7860,0,0,0,7860,7860,0,0,0,0,2
1096,p1211,20120627,7860,7860,8102,8102,7938,7938,8020,78,160,4,320800,2
1097,p1211,20120628,7938,8020,0,0,0,8020,8020,0,0,0,0,2
1098,p1211,20120629,8020,8020,0,0,0,8020,8020,0,0,0,0,2
1099,p1211,20120702,8020,8020,0,0,0,8020,8020,0,0,0,0,2
1100,p1211,20120703,8020,8020,8060,8134,8060,8134,8096,114,76,4,323880,2
1101,p1211,20120704,8134,8096,8248,8248,8092,8170,8170,74,74,6,490200,2
1102,p1211,20120705,8170,8170,8166,8166,8166,8166,8166,-4,-4,2,163320,0
1103,p1211,20120706,8166,8166,0,0,0,8166,8166,0,0,0,0,0
1104,p1211,20120709,8166,8166,0,0,0,8166,8166,0,0,0,0,0
1105,p1211,20120710,8166,8166,0,0,0,8166,8166,0,0,0,0,0
1106,p1211,20120711,8166,8166,0,0,0,8166,8166,0,0,0,0,0
1107,p1211,20120712,8166,8166,0,0,0,8166,8166,0,0,0,0,0
1108,p1211,20120713,8166,8166,0,0,0,8166,8166,0,0,0,0,0
1109,p1211,20120716,8166,8166,0,0,0,8166,8166,0,0,0,0,0
1110,p1211,20120717,8166,8166,0,0,0,8166,8166,0,0,0,0,0
1111,p1211,20120718,8166,8166,0,0,0,8166,8166,0,0,0,0,0
1112,p1211,20120719,8166,8166,0,0,0,8166,8166,0,0,0,0,0
1113,p1211,20120720,8166,8166,0,0,0,8166,8166,0,0,0,0,0
1114,p1211,20120723,8166,8166,0,0,0,8166,8166,0,0,0,0,0
1115,p1211,20120724,8166,8166,0,0,0,8166,8166,0,0,0,0,0
1116,p1211,20120725,8166,8166,0,0,0,8166,8166,0,0,0,0,0
1117,p1211,20120726,8166,8166,0,0,0,8166,8166,0,0,0,0,0
1118,p1211,20120727,8166,8166,0,0,0,8166,8166,0,0,0,0,0
1119,p1211,20120730,8166,8166,0,0,0,8166,8166,0,0,0,0,0
1120,p1211,20120731,8166,8166,0,0,0,8166,8166,0,0,0,0,0
1121,p1211,20120801,8166,8166,0,0,0,8166,8166,0,0,0,0,0
1122,p1211,20120802,8166,8166,0,0,0,8166,8166,0,0,0,0,0
1123,p1211,20120803,8166,8166,0,0,0,8166,8166,0,0,0,0,0
1124,p1211,20120806,8166,8166,0,0,0,8166,8166,0,0,0,0,0
1125,p1211,20120807,8166,8166,0,0,0,8166,8166,0,0,0,0,0
1126,p1211,20120808,8166,8166,0,0,0,8166,8166,0,0,0,0,0
1127,p1211,20120809,8166,8166,0,0,0,8166,8166,0,0,0,0,0
1128,p1211,20120810,8166,8166,0,0,0,8166,8166,0,0,0,0,0
1129,p1211,20120813,8166,8166,0,0,0,8166,8166,0,0,0,0,0
1130,p1211,20120814,8166,8166,0,0,0,8166,8166,0,0,0,0,0
1131,p1211,20120815,8166,8166,0,0,0,8166,8166,0,0,0,0,0
1132,p1211,20120816,8166,8166,7840,7840,7840,7840,7840,-326,-326,2,156800,2
1133,p1211,20120817,7840,7840,0,0,0,7840,7840,0,0,0,0,2
1134,p1211,20120820,7840,7840,0,0,0,7840,7840,0,0,0,0,2
1135,p1211,20120821,7840,7840,0,0,0,7840,7840,0,0,0,0,2
1136,p1211,20120822,7840,7840,0,0,0,7840,7840,0,0,0,0,2
1137,p1211,20120823,7840,7840,0,0,0,7840,7840,0,0,0,0,2
1138,p1211,20120824,7840,7840,0,0,0,7840,7840,0,0,0,0,2
1139,p1211,20120827,7840,7840,0,0,0,7840,7840,0,0,0,0,2
1140,p1211,20120828,7840,7840,8022,8022,8020,8020,8020,180,180,4,320840,0
1141,p1211,20120829,8020,8020,0,0,0,8020,8020,0,0,0,0,0
1142,p1211,20120830,8020,8020,0,0,0,8020,8020,0,0,0,0,0
1143,p1211,20120831,8020,8020,0,0,0,8020,8020,0,0,0,0,0
1144,p1211,20120903,8020,8020,0,0,0,8020,8020,0,0,0,0,0
1145,p1211,20120904,8020,8020,0,0,0,8020,8020,0,0,0,0,0
1146,p1211,20120905,8020,8020,8340,8340,7986,7986,8162,-34,142,8,653040,0
1147,p1211,20120906,7986,8162,0,0,0,8162,8162,0,0,0,0,0
1148,p1211,20120907,8162,8162,0,0,0,8162,8162,0,0,0,0,0
1149,p1211,20120910,8162,8162,0,0,0,8162,8162,0,0,0,0,0
1150,p1211,20120911,8162,8162,7848,7852,7836,7836,7842,-326,-320,10,784240,10
1151,p1211,20120912,7836,7842,7690,7690,7690,7690,7690,-152,-152,4,307600,14
1152,p1211,20120913,7690,7690,0,0,0,7690,7690,0,0,0,0,14
1153,p1211,20120914,7690,7690,7768,7768,7768,7768,7768,78,78,2,155360,14
1154,p1211,20120917,7768,7768,7816,7816,7810,7810,7812,42,44,4,312520,14
1155,p1211,20120918,7810,7812,7500,7506,7500,7506,7502,-306,-310,4,300120,12
1156,p1211,20120919,7506,7502,0,0,0,7502,7502,0,0,0,0,12
1157,p1211,20120920,7502,7502,0,0,0,7502,7502,0,0,0,0,12
1158,p1211,20120921,7502,7502,7450,7562,7212,7212,7452,-290,-50,16,1192360,4
1159,p1211,20120924,7212,7452,7232,7694,7230,7340,7308,-112,-144,22,1608160,6
1160,p1211,20120925,7340,7308,7296,7296,7296,7296,7296,-12,-12,2,145920,4
1161,p1211,20120926,7296,7296,7010,7100,7010,7100,7054,-196,-242,4,282200,2
1162,p1211,20120927,7100,7054,0,0,0,7054,7054,0,0,0,0,2
1163,p1211,20120928,7054,7054,0,0,0,7054,7054,0,0,0,0,2
1164,p1211,20121008,7054,7054,0,0,0,7054,7054,0,0,0,0,2
1165,p1211,20121009,7054,7054,0,0,0,7054,7054,0,0,0,0,2
1166,p1211,20121010,7054,7054,6952,6952,6852,6852,6918,-202,-136,6,415120,6
1167,p1211,20121011,6852,6918,0,0,0,6918,6918,0,0,0,0,6
1168,p1211,20121012,6918,6918,0,0,0,6918,6918,0,0,0,0,6
1169,p1211,20121015,6918,6918,6748,6840,6748,6840,6778,-78,-140,6,406720,2
1170,p1211,20121016,6840,6778,0,0,0,6778,6778,0,0,0,0,2
1171,p1211,20121017,6778,6778,0,0,0,6778,6778,0,0,0,0,2
1172,p1211,20121018,6778,6778,6608,6608,6608,6608,6608,-170,-170,2,132160,2
1173,p1211,20121019,6608,6608,6500,6500,6500,6500,6500,-108,-108,2,130000,2
1174,p1211,20121022,6500,6500,0,0,0,6500,6500,0,0,0,0,2
1175,p1211,20121023,6500,6500,6310,6310,6310,6310,6310,-190,-190,2,126200,2
1176,p1211,20121024,6310,6310,0,0,0,6310,6310,0,0,0,0,2
1177,p1211,20121025,6310,6310,0,0,0,6310,6310,0,0,0,0,2
1178,p1211,20121026,6310,6310,0,0,0,6310,6310,0,0,0,0,2
1179,p1211,20121029,6310,6310,6300,6300,6300,6300,6300,-10,-10,2,126000,0
1180,p1211,20121030,6300,6300,0,0,0,6300,6300,0,0,0,0,0
1181,p1211,20121031,6300,6300,0,0,0,6300,6300,0,0,0,0,0
1182,p1211,20121101,6300,6300,0,0,0,6300,6300,0,0,0,0,0
1183,p1211,20121102,6300,6300,0,0,0,6300,6300,0,0,0,0,0
1184,p1211,20121105,6300,6300,0,0,0,6300,6300,0,0,0,0,0
1185,p1211,20121106,6300,6300,0,0,0,6300,6300,0,0,0,0,0
1186,p1211,20121107,6300,6300,0,0,0,6300,6300,0,0,0,0,0
1187,p1211,20121108,6300,6300,0,0,0,6300,6300,0,0,0,0,0
1188,p1211,20121109,6300,6300,0,0,0,6300,6300,0,0,0,0,0
1189,p1211,20121112,6300,6300,0,0,0,6300,6300,0,0,0,0,0
1190,p1211,20121113,6300,6300,0,0,0,6300,6300,0,0,0,0,0
1191,p1211,20121114,6300,6300,0,0,0,6300,6300,0,0,0,0,0
1192,p1212,20120104,7874,7874,0,0,0,7874,7874,0,0,0,0,0
1193,p1212,20120105,7874,7874,0,0,0,7874,7874,0,0,0,0,0
1194,p1212,20120106,7874,7874,0,0,0,7874,7874,0,0,0,0,0
1195,p1212,20120109,7874,7874,0,0,0,7874,7874,0,0,0,0,0
1196,p1212,20120110,7874,7874,0,0,0,7874,7874,0,0,0,0,0
1197,p1212,20120111,7874,7874,0,0,0,7874,7874,0,0,0,0,0
1198,p1212,20120112,7874,7874,0,0,0,7874,7874,0,0,0,0,0
1199,p1212,20120113,7874,7874,0,0,0,7874,7874,0,0,0,0,0
1200,p1212,20120116,7874,7874,0,0,0,7874,7874,0,0,0,0,0
1201,p1212,20120117,7874,7874,0,0,0,7874,7874,0,0,0,0,0
1202,p1212,20120118,7874,7874,0,0,0,7874,7874,0,0,0,0,0
1203,p1212,20120119,7874,7874,0,0,0,7874,7874,0,0,0,0,0
1204,p1212,20120120,7874,7874,0,0,0,7874,7874,0,0,0,0,0
1205,p1212,20120130,7874,7874,0,0,0,7874,7874,0,0,0,0,0
1206,p1212,20120131,7874,7874,0,0,0,7874,7874,0,0,0,0,0
1207,p1212,20120201,7874,7874,0,0,0,7874,7874,0,0,0,0,0
1208,p1212,20120202,7874,7874,0,0,0,7874,7874,0,0,0,0,0
1209,p1212,20120203,7874,7874,0,0,0,7874,7874,0,0,0,0,0
1210,p1212,20120206,7874,7874,0,0,0,7874,7874,0,0,0,0,0
1211,p1212,20120207,7874,7874,0,0,0,7874,7874,0,0,0,0,0
1212,p1212,20120208,7874,7874,0,0,0,7874,7874,0,0,0,0,0
1213,p1212,20120209,7874,7874,0,0,0,7874,7874,0,0,0,0,0
1214,p1212,20120210,7874,7874,0,0,0,7874,7874,0,0,0,0,0
1215,p1212,20120213,7874,7874,0,0,0,7874,7874,0,0,0,0,0
1216,p1212,20120214,7874,7874,0,0,0,7874,7874,0,0,0,0,0
1217,p1212,20120215,7874,7874,0,0,0,7874,7874,0,0,0,0,0
1218,p1212,20120216,7874,7874,0,0,0,7874,7874,0,0,0,0,0
1219,p1212,20120217,7874,7874,0,0,0,7874,7874,0,0,0,0,0
1220,p1212,20120220,7874,7874,0,0,0,7874,7874,0,0,0,0,0
1221,p1212,20120221,7874,7874,0,0,0,7874,7874,0,0,0,0,0
1222,p1212,20120222,7874,7874,0,0,0,7874,7874,0,0,0,0,0
1223,p1212,20120223,7874,7874,0,0,0,7874,7874,0,0,0,0,0
1224,p1212,20120224,7874,7874,0,0,0,7874,7874,0,0,0,0,0
1225,p1212,20120227,7874,7874,0,0,0,7874,7874,0,0,0,0,0
1226,p1212,20120228,7874,7874,0,0,0,7874,7874,0,0,0,0,0
1227,p1212,20120229,7874,7874,0,0,0,7874,7874,0,0,0,0,0
1228,p1212,20120301,7874,7874,0,0,0,7874,7874,0,0,0,0,0
1229,p1212,20120302,7874,7874,0,0,0,7874,7874,0,0,0,0,0
1230,p1212,20120305,7874,7874,0,0,0,7874,7874,0,0,0,0,0
1231,p1212,20120306,7874,7874,0,0,0,7874,7874,0,0,0,0,0
1232,p1212,20120307,7874,7874,0,0,0,7874,7874,0,0,0,0,0
1233,p1212,20120308,7874,7874,0,0,0,7874,7874,0,0,0,0,0
1234,p1212,20120309,7874,7874,0,0,0,7874,7874,0,0,0,0,0
1235,p1212,20120312,7874,7874,0,0,0,7874,7874,0,0,0,0,0
1236,p1212,20120313,7874,7874,0,0,0,7874,7874,0,0,0,0,0
1237,p1212,20120314,7874,7874,0,0,0,7874,7874,0,0,0,0,0
1238,p1212,20120315,7874,7874,0,0,0,7874,7874,0,0,0,0,0
1239,p1212,20120316,7874,7874,0,0,0,7874,7874,0,0,0,0,0
1240,p1212,20120319,7874,7874,0,0,0,7874,7874,0,0,0,0,0
1241,p1212,20120320,7874,7874,0,0,0,7874,7874,0,0,0,0,0
1242,p1212,20120321,7874,7874,0,0,0,7874,7874,0,0,0,0,0
1243,p1212,20120322,7874,7874,0,0,0,7874,7874,0,0,0,0,0
1244,p1212,20120323,7874,7874,0,0,0,7874,7874,0,0,0,0,0
1245,p1212,20120326,7874,7874,0,0,0,7874,7874,0,0,0,0,0
1246,p1212,20120327,7874,7874,0,0,0,7874,7874,0,0,0,0,0
1247,p1212,20120328,7874,7874,0,0,0,7874,7874,0,0,0,0,0
1248,p1212,20120329,7874,7874,0,0,0,7874,7874,0,0,0,0,0
1249,p1212,20120330,7874,7874,0,0,0,7874,7874,0,0,0,0,0
1250,p1212,20120405,7874,7874,0,0,0,7874,7874,0,0,0,0,0
1251,p1212,20120406,7874,7874,0,0,0,7874,7874,0,0,0,0,0
1252,p1212,20120409,7874,7874,0,0,0,7874,7874,0,0,0,0,0
1253,p1212,20120410,7874,7874,0,0,0,7874,7874,0,0,0,0,0
1254,p1212,20120411,7874,7874,0,0,0,7874,7874,0,0,0,0,0
1255,p1212,20120412,7874,7874,0,0,0,7874,7874,0,0,0,0,0
1256,p1212,20120413,7874,7874,0,0,0,7874,7874,0,0,0,0,0
1257,p1212,20120416,7874,7874,0,0,0,7874,7874,0,0,0,0,0
1258,p1212,20120417,7874,7874,0,0,0,7874,7874,0,0,0,0,0
1259,p1212,20120418,7874,7874,0,0,0,7874,7874,0,0,0,0,0
1260,p1212,20120419,7874,7874,0,0,0,7874,7874,0,0,0,0,0
1261,p1212,20120420,7874,7874,0,0,0,7874,7874,0,0,0,0,0
1262,p1212,20120423,7874,7874,0,0,0,7874,7874,0,0,0,0,0
1263,p1212,20120424,7874,7874,0,0,0,7874,7874,0,0,0,0,0
1264,p1212,20120425,7874,7874,0,0,0,7874,7874,0,0,0,0,0
1265,p1212,20120426,7874,7874,0,0,0,7874,7874,0,0,0,0,0
1266,p1212,20120427,7874,7874,0,0,0,7874,7874,0,0,0,0,0
1267,p1212,20120502,7874,7874,0,0,0,7874,7874,0,0,0,0,0
1268,p1212,20120503,7874,7874,0,0,0,7874,7874,0,0,0,0,0
1269,p1212,20120504,7874,7874,0,0,0,7874,7874,0,0,0,0,0
1270,p1212,20120507,7874,7874,0,0,0,7874,7874,0,0,0,0,0
1271,p1212,20120508,7874,7874,0,0,0,7874,7874,0,0,0,0,0
1272,p1212,20120509,7874,7874,8502,8502,8502,8502,8502,628,628,2,170040,2
1273,p1212,20120510,8502,8502,8650,8650,8650,8650,8650,148,148,2,173000,4
1274,p1212,20120511,8650,8650,8500,8500,8450,8450,8474,-200,-176,4,339000,0
1275,p1212,20120514,8450,8474,0,0,0,8474,8474,0,0,0,0,0
1276,p1212,20120515,8474,8474,0,0,0,8474,8474,0,0,0,0,0
1277,p1212,20120516,8474,8474,0,0,0,8474,8474,0,0,0,0,0
1278,p1212,20120517,8474,8474,0,0,0,8474,8474,0,0,0,0,0
1279,p1212,20120518,8474,8474,0,0,0,8474,8474,0,0,0,0,0
1280,p1212,20120521,8474,8474,0,0,0,8474,8474,0,0,0,0,0
1281,p1212,20120522,8474,8474,8136,8136,8136,8136,8136,-338,-338,2,162720,2
1282,p1212,20120523,8136,8136,0,0,0,8136,8136,0,0,0,0,2
1283,p1212,20120524,8136,8136,0,0,0,8136,8136,0,0,0,0,2
1284,p1212,20120525,8136,8136,0,0,0,8136,8136,0,0,0,0,2
1285,p1212,20120528,8136,8136,0,0,0,8136,8136,0,0,0,0,2
1286,p1212,20120529,8136,8136,0,0,0,8136,8136,0,0,0,0,2
1287,p1212,20120530,8136,8136,0,0,0,8136,8136,0,0,0,0,2
1288,p1212,20120531,8136,8136,0,0,0,8136,8136,0,0,0,0,2
1289,p1212,20120601,8136,8136,0,0,0,8136,8136,0,0,0,0,2
1290,p1212,20120604,8136,8136,0,0,0,8136,8136,0,0,0,0,2
1291,p1212,20120605,8136,8136,0,0,0,8136,8136,0,0,0,0,2
1292,p1212,20120606,8136,8136,0,0,0,8136,8136,0,0,0,0,2
1293,p1212,20120607,8136,8136,0,0,0,8136,8136,0,0,0,0,2
1294,p1212,20120608,8136,8136,7812,7812,7812,7812,7812,-324,-324,2,156240,2
1295,p1212,20120611,7812,7812,7900,7900,7900,7900,7900,88,88,2,158000,0
1296,p1212,20120612,7900,7900,0,0,0,7900,7900,0,0,0,0,0
1297,p1212,20120613,7900,7900,0,0,0,7900,7900,0,0,0,0,0
1298,p1212,20120614,7900,7900,0,0,0,7900,7900,0,0,0,0,0
1299,p1212,20120615,7900,7900,0,0,0,7900,7900,0,0,0,0,0
1300,p1212,20120618,7900,7900,0,0,0,7900,7900,0,0,0,0,0
1301,p1212,20120619,7900,7900,0,0,0,7900,7900,0,0,0,0,0
1302,p1212,20120620,7900,7900,0,0,0,7900,7900,0,0,0,0,0
1303,p1212,20120621,7900,7900,0,0,0,7900,7900,0,0,0,0,0
1304,p1212,20120625,7900,7900,0,0,0,7900,7900,0,0,0,0,0
1305,p1212,20120626,7900,7900,0,0,0,7900,7900,0,0,0,0,0
1306,p1212,20120627,7900,7900,7848,8052,7848,8028,7940,128,40,32,2541160,2
1307,p1212,20120628,8028,7940,7874,8012,7874,7998,7956,58,16,46,3660520,0
1308,p1212,20120629,7998,7956,0,0,0,7956,7956,0,0,0,0,0
1309,p1212,20120702,7956,7956,8010,8216,8010,8040,8088,84,132,6,485320,0
1310,p1212,20120703,8040,8088,0,0,0,8088,8088,0,0,0,0,0
1311,p1212,20120704,8088,8088,0,0,0,8088,8088,0,0,0,0,0
1312,p1212,20120705,8088,8088,0,0,0,8088,8088,0,0,0,0,0
1313,p1212,20120706,8088,8088,0,0,0,8088,8088,0,0,0,0,0
1314,p1212,20120709,8088,8088,8216,8386,8216,8262,8312,174,224,58,4821000,20
1315,p1212,20120710,8262,8312,8220,8270,8216,8260,8238,-52,-74,32,2636480,4
1316,p1212,20120711,8260,8238,0,0,0,8238,8238,0,0,0,0,4
1317,p1212,20120712,8238,8238,8160,8160,7978,8066,8068,-172,-170,8,645560,6
1318,p1212,20120713,8066,8068,7966,7966,7966,7966,7966,-102,-102,2,159320,4
1319,p1212,20120716,7966,7966,8222,8242,7990,8242,8150,276,184,6,489080,4
1320,p1212,20120717,8242,8150,8242,8242,8160,8200,8198,50,48,14,1147800,4
1321,p1212,20120718,8200,8198,0,0,0,8198,8198,0,0,0,0,4
1322,p1212,20120719,8198,8198,0,0,0,8198,8198,0,0,0,0,4
1323,p1212,20120720,8198,8198,0,0,0,8198,8198,0,0,0,0,4
1324,p1212,20120723,8198,8198,0,0,0,8198,8198,0,0,0,0,4
1325,p1212,20120724,8198,8198,0,0,0,8198,8198,0,0,0,0,4
1326,p1212,20120725,8198,8198,7708,7708,7708,7708,7708,-490,-490,4,308320,6
1327,p1212,20120726,7708,7708,7800,7800,7626,7630,7678,-78,-30,12,921400,6
1328,p1212,20120727,7630,7678,0,0,0,7678,7678,0,0,0,0,6
1329,p1212,20120730,7678,7678,0,0,0,7678,7678,0,0,0,0,6
1330,p1212,20120731,7678,7678,0,0,0,7678,7678,0,0,0,0,6
1331,p1212,20120801,7678,7678,7828,7828,7810,7810,7818,132,140,4,312760,4
1332,p1212,20120802,7810,7818,0,0,0,7818,7818,0,0,0,0,4
1333,p1212,20120803,7818,7818,0,0,0,7818,7818,0,0,0,0,4
1334,p1212,20120806,7818,7818,0,0,0,7818,7818,0,0,0,0,4
1335,p1212,20120807,7818,7818,0,0,0,7818,7818,0,0,0,0,4
1336,p1212,20120808,7818,7818,0,0,0,7818,7818,0,0,0,0,4
1337,p1212,20120809,7818,7818,0,0,0,7818,7818,0,0,0,0,4
1338,p1212,20120810,7818,7818,7754,7754,7754,7754,7754,-64,-64,2,155080,6
1339,p1212,20120813,7754,7754,0,0,0,7754,7754,0,0,0,0,6
1340,p1212,20120814,7754,7754,0,0,0,7754,7754,0,0,0,0,6
1341,p1212,20120815,7754,7754,0,0,0,7754,7754,0,0,0,0,6
1342,p1212,20120816,7754,7754,0,0,0,7754,7754,0,0,0,0,6
1343,p1212,20120817,7754,7754,7790,7790,7790,7790,7790,36,36,2,155800,4
1344,p1212,20120820,7790,7790,0,0,0,7790,7790,0,0,0,0,4
1345,p1212,20120821,7790,7790,0,0,0,7790,7790,0,0,0,0,4
1346,p1212,20120822,7790,7790,8026,8038,8010,8038,8024,248,234,6,481480,4
1347,p1212,20120823,8038,8024,8028,8040,8028,8040,8038,16,14,12,964560,12
1348,p1212,20120824,8040,8038,7972,8102,7972,8102,8014,64,-24,12,961840,12
1349,p1212,20120827,8102,8014,0,0,0,8014,8014,0,0,0,0,12
1350,p1212,20120828,8014,8014,0,0,0,8014,8014,0,0,0,0,12
1351,p1212,20120829,8014,8014,8278,8278,7960,8030,8110,16,96,16,1297720,12
1352,p1212,20120830,8030,8110,0,0,0,8110,8110,0,0,0,0,12
1353,p1212,20120831,8110,8110,0,0,0,8110,8110,0,0,0,0,12
1354,p1212,20120903,8110,8110,0,0,0,8110,8110,0,0,0,0,12
1355,p1212,20120904,8110,8110,0,0,0,8110,8110,0,0,0,0,12
1356,p1212,20120905,8110,8110,8140,8140,8140,8140,8140,30,30,4,325600,16
1357,p1212,20120906,8140,8140,0,0,0,8140,8140,0,0,0,0,16
1358,p1212,20120907,8140,8140,7816,7816,7816,7816,7816,-324,-324,6,468960,22
1359,p1212,20120910,7816,7816,7952,7952,7874,7874,7930,58,114,12,951800,16
1360,p1212,20120911,7874,7930,0,0,0,7930,7930,0,0,0,0,16
1361,p1212,20120912,7930,7930,7850,7850,7848,7848,7848,-82,-82,8,627960,22
1362,p1212,20120913,7848,7848,7900,7900,7858,7858,7860,10,12,38,2987200,40
1363,p1212,20120914,7858,7860,7916,7916,7916,7916,7916,56,56,4,316640,44
1364,p1212,20120917,7916,7916,0,0,0,7916,7916,0,0,0,0,44
1365,p1212,20120918,7916,7916,7700,7700,7602,7602,7674,-314,-242,36,2763320,44
1366,p1212,20120919,7602,7674,7552,7552,7552,7552,7552,-122,-122,2,151040,44
1367,p1212,20120920,7552,7552,0,0,0,7552,7552,0,0,0,0,44
1368,p1212,20120921,7552,7552,7450,7450,7450,7450,7450,-102,-102,2,149000,42
1369,p1212,20120924,7450,7450,7360,7398,7290,7360,7362,-90,-88,60,4417800,40
1370,p1212,20120925,7360,7362,7372,7372,7288,7366,7346,4,-16,40,2938720,32
1371,p1212,20120926,7366,7346,7284,7498,7284,7350,7376,4,30,6,442640,32
1372,p1212,20120927,7350,7376,0,0,0,7376,7376,0,0,0,0,32
1373,p1212,20120928,7376,7376,0,0,0,7376,7376,0,0,0,0,32
1374,p1212,20121008,7376,7376,7010,7110,6900,6902,6974,-474,-402,76,5301200,38
1375,p1212,20121009,6902,6974,6960,7026,6950,6998,6980,24,6,76,5304960,60
1376,p1212,20121010,6998,6980,6980,6996,6740,6950,6954,-30,-26,92,6398560,52
1377,p1212,20121011,6950,6954,6992,6992,6884,6954,6942,0,-12,6,416600,52
1378,p1212,20121012,6954,6942,6976,6978,6910,6920,6938,-22,-4,10,693960,56
1379,p1212,20121015,6920,6938,6732,6796,6732,6740,6768,-198,-170,48,3249480,70
1380,p1212,20121016,6740,6768,6742,6774,6712,6742,6748,-26,-20,62,4184200,110
1381,p1212,20121017,6742,6748,6748,6748,6716,6738,6730,-10,-18,22,1480720,114
1382,p1212,20121018,6738,6730,6766,6800,6766,6770,6780,40,50,12,813680,110
1383,p1212,20121019,6770,6780,6796,6796,6796,6796,6796,16,16,6,407760,110
1384,p1212,20121022,6796,6796,6800,6800,6800,6800,6800,4,4,2,136000,110
1385,p1212,20121023,6800,6800,6702,6770,6700,6700,6718,-100,-82,8,537560,110
1386,p1212,20121024,6700,6718,6696,6696,6696,6696,6696,-22,-22,2,133920,110
1387,p1212,20121025,6696,6696,6692,6696,6668,6668,6686,-28,-10,8,534920,110
1388,p1212,20121026,6668,6686,6646,6650,6500,6500,6604,-186,-82,22,1453240,110
1389,p1212,20121029,6500,6604,6448,6638,6448,6500,6526,-104,-78,60,3916080,60
1390,p1212,20121030,6500,6526,6542,6618,6478,6550,6554,24,28,38,2491040,36
1391,p1212,20121031,6550,6554,6500,6540,6500,6540,6520,-14,-34,4,260800,32
1392,p1212,20121101,6540,6520,6606,6730,6308,6670,6604,150,84,52,3435040,10
1393,p1212,20121102,6670,6604,6630,6632,6600,6600,6622,-4,18,8,529760,2
1394,p1212,20121105,6600,6622,6656,6656,6358,6358,6468,-264,-154,8,517440,0
1395,p1212,20121106,6358,6468,0,0,0,6468,6468,0,0,0,0,0
1396,p1212,20121107,6468,6468,0,0,0,6468,6468,0,0,0,0,0
1397,p1212,20121108,6468,6468,0,0,0,6468,6468,0,0,0,0,0
1398,p1212,20121109,6468,6468,0,0,0,6468,6468,0,0,0,0,0
1399,p1212,20121112,6468,6468,6718,6718,6440,6440,6578,-28,110,4,263160,0
1400,p1212,20121113,6440,6578,0,0,0,6578,6578,0,0,0,0,0
1401,p1212,20121114,6578,6578,0,0,0,6578,6578,0,0,0,0,0
1402,p1212,20121115,6578,6578,0,0,0,6578,6578,0,0,0,0,0
1403,p1212,20121116,6578,6578,0,0,0,6578,6578,0,0,0,0,0
1404,p1212,20121119,6578,6578,0,0,0,6578,6578,0,0,0,0,0
1405,p1212,20121120,6578,6578,0,0,0,6578,6578,0,0,0,0,0
1406,p1212,20121121,6578,6578,0,0,0,6578,6578,0,0,0,0,0
1407,p1212,20121122,6578,6578,0,0,0,6578,6578,0,0,0,0,0
1408,p1212,20121123,6578,6578,0,0,0,6578,6578,0,0,0,0,0
1409,p1212,20121126,6578,6578,0,0,0,6578,6578,0,0,0,0,0
1410,p1212,20121127,6578,6578,0,0,0,6578,6578,0,0,0,0,0
1411,p1212,20121128,6578,6578,0,0,0,6578,6578,0,0,0,0,0
1412,p1212,20121129,6578,6578,0,0,0,6578,6578,0,0,0,0,0
1413,p1212,20121130,6578,6578,0,0,0,6578,6578,0,0,0,0,0
1414,p1212,20121203,6578,6578,0,0,0,6578,6578,0,0,0,0,0
1415,p1212,20121204,6578,6578,0,0,0,6578,6578,0,0,0,0,0
1416,p1212,20121205,6578,6578,0,0,0,6578,6578,0,0,0,0,0
1417,p1212,20121206,6578,6578,0,0,0,6578,6578,0,0,0,0,0
1418,p1212,20121207,6578,6578,0,0,0,6578,6578,0,0,0,0,0
1419,p1212,20121210,6578,6578,0,0,0,6578,6578,0,0,0,0,0
1420,p1212,20121211,6578,6578,0,0,0,6578,6578,0,0,0,0,0
1421,p1212,20121212,6578,6578,0,0,0,6578,6578,0,0,0,0,0
1422,p1212,20121213,6578,6578,0,0,0,6578,6578,0,0,0,0,0
1423,p1212,20121214,6578,6578,0,0,0,6578,6578,0,0,0,0,0
1424,p1301,20120119,7934,7960,7968,8000,7968,8000,7988,40,28,24,1917440,118
1425,p1301,20120120,8000,7988,8018,8054,8018,8054,8032,66,44,16,1285280,118
1426,p1301,20120130,8054,8032,8072,8086,8034,8040,8064,8,32,32,2580920,136
1427,p1301,20120131,8040,8064,7988,8004,7984,8004,7996,-60,-68,106,8477600,232
1428,p1301,20120201,8004,7996,8020,8066,8020,8042,8042,46,46,82,6594440,254
1429,p1301,20120202,8042,8042,8068,8116,8068,8112,8094,70,52,86,6961720,278
1430,p1301,20120203,8112,8094,8114,8126,8090,8100,8112,6,18,66,5354480,306
1431,p1301,20120206,8100,8112,8126,8200,8126,8190,8170,78,58,74,6046720,352
1432,p1301,20120207,8190,8170,8200,8204,8130,8156,8174,-14,4,116,9482640,430
1433,p1301,20120208,8156,8174,8178,8250,8162,8248,8214,74,40,110,9037440,466
1434,p1301,20120209,8248,8214,8250,8286,8240,8274,8266,60,52,364,30089680,738
1435,p1301,20120210,8274,8266,8232,8240,8206,8220,8228,-46,-38,200,16456480,780
1436,p1301,20120213,8220,8228,8248,8312,8244,8310,8288,82,60,300,24867640,952
1437,p1301,20120214,8310,8288,8282,8334,8282,8290,8304,2,16,148,12292600,984
1438,p1301,20120215,8290,8304,8314,8338,8298,8300,8316,-4,12,224,18630920,1046
1439,p1301,20120216,8300,8316,8290,8308,8212,8238,8252,-78,-64,84,6933280,1048
1440,p1301,20120217,8238,8252,8256,8328,8256,8328,8314,76,62,416,34591800,1370
1441,p1301,20120220,8328,8314,8316,8438,8316,8368,8388,54,74,752,63084040,1810
1442,p1301,20120221,8368,8388,8360,8410,8344,8404,8378,16,-10,294,24634960,1922
1443,p1301,20120222,8404,8378,8418,8420,8398,8410,8406,32,28,282,23709360,2114
1444,p1301,20120223,8410,8406,8386,8404,8360,8402,8388,-4,-18,104,8723600,2118
1445,p1301,20120224,8402,8388,8360,8424,8360,8412,8398,24,10,210,17639480,2206
1446,p1301,20120227,8412,8398,8436,8470,8436,8450,8454,52,56,164,13867480,2296
1447,p1301,20120228,8450,8454,8454,8494,8454,8494,8476,40,22,100,8476760,2306
1448,p1301,20120229,8494,8476,8464,8476,8448,8476,8464,0,-12,72,6094120,2312
1449,p1301,20120301,8476,8464,8438,8448,8378,8378,8418,-86,-46,232,19532400,2330
1450,p1301,20120302,8378,8418,8464,8464,8408,8424,8424,6,6,62,5223440,2320
1451,p1301,20120305,8424,8424,8408,8448,8402,8446,8424,22,0,94,7920000,2310
1452,p1301,20120306,8446,8424,8412,8412,8386,8410,8412,-14,-12,126,10599680,2242
1453,p1301,20120307,8410,8412,8376,8382,8358,8360,8372,-52,-40,132,11051240,2264
1454,p1301,20120308,8360,8372,8368,8412,8368,8400,8394,28,22,162,13598520,2284
1455,p1301,20120309,8400,8394,8418,8630,8418,8630,8552,236,158,908,77656160,2830
1456,p1301,20120312,8630,8552,8614,8634,8574,8604,8608,52,56,696,59915480,3214
1457,p1301,20120313,8604,8608,8616,8670,8590,8664,8626,56,18,810,69871920,3296
1458,p1301,20120314,8664,8626,8720,8750,8644,8660,8688,34,62,800,69517520,3190
1459,p1301,20120315,8660,8688,8680,8736,8646,8676,8704,-12,16,772,67198360,3638
1460,p1301,20120316,8676,8704,8770,8770,8678,8706,8724,2,20,274,23908960,3680
1461,p1301,20120319,8706,8724,8724,8764,8720,8732,8742,8,18,496,43369760,3892
1462,p1301,20120320,8732,8742,8724,8726,8624,8628,8660,-114,-82,470,40705840,4024
1463,p1301,20120321,8628,8660,8620,8632,8594,8608,8610,-52,-50,546,47011920,4392
1464,p1301,20120322,8608,8610,8626,8662,8590,8590,8620,-20,10,362,31209360,4454
1465,p1301,20120323,8590,8620,8590,8706,8590,8704,8654,84,34,320,27697600,4546
1466,p1301,20120326,8704,8654,8724,8828,8724,8828,8790,174,136,876,77016120,4978
1467,p1301,20120327,8828,8790,8804,8824,8782,8810,8800,20,10,350,30800600,5014
1468,p1301,20120328,8810,8800,8776,8844,8762,8782,8798,-18,-2,494,43462480,5012
1469,p1301,20120329,8782,8798,8780,8800,8700,8736,8752,-62,-46,552,48317840,4958
1470,p1301,20120330,8736,8752,8698,8704,8650,8656,8672,-96,-80,302,26193760,5000
1471,p1301,20120405,8656,8672,8852,8956,8842,8950,8884,278,212,666,59169160,5032
1472,p1301,20120406,8950,8884,8950,9046,8950,9042,9002,158,118,1358,122257040,5396
1473,p1301,20120409,9042,9002,9280,9280,9020,9032,9050,30,48,966,87440840,5802
1474,p1301,20120410,9032,9050,9020,9096,9004,9090,9044,40,-6,1342,121385600,6140
1475,p1301,20120411,9090,9044,9010,9020,8942,8956,8962,-88,-82,4148,371810200,8464
1476,p1301,20120412,8956,8962,8890,8986,8890,8968,8958,6,-4,2234,200156760,8968
1477,p1301,20120413,8968,8958,9000,9054,9000,9012,9028,54,70,1310,118268960,9024
1478,p1301,20120416,9012,9028,8932,8932,8854,8888,8902,-140,-126,2498,222407160,9698
1479,p1301,20120417,8888,8902,8900,8914,8880,8900,8900,-2,-2,2368,210757280,10124
1480,p1301,20120418,8900,8900,8908,8946,8802,8826,8868,-74,-32,15338,1360309960,19516
1481,p1301,20120419,8826,8868,8800,8820,8790,8806,8804,-62,-64,7834,689727760,21512
1482,p1301,20120420,8806,8804,8796,8818,8764,8790,8786,-14,-18,11226,986327120,23052
1483,p1301,20120423,8790,8786,8868,8896,8826,8840,8856,54,70,11208,992589880,26328
1484,p1301,20120424,8840,8856,8780,8816,8728,8732,8776,-124,-80,13796,1210795640,30668
1485,p1301,20120425,8732,8776,8800,8806,8734,8736,8756,-40,-20,10848,950046480,32570
1486,p1301,20120426,8736,8756,8770,8770,8720,8746,8744,-10,-12,17900,1565370040,37240
1487,p1301,20120427,8746,8744,8760,8772,8734,8758,8754,14,10,10862,950910720,35678
1488,p1301,20120502,8758,8754,8758,8764,8702,8706,8720,-48,-34,10664,930083800,38274
1489,p1301,20120503,8706,8720,8700,8700,8610,8614,8652,-106,-68,9746,843418640,41186
1490,p1301,20120504,8614,8652,8590,8632,8580,8632,8614,-20,-38,14128,1217026000,42506
1491,p1301,20120507,8632,8614,8540,8564,8498,8510,8524,-104,-90,21362,1820998920,48314
1492,p1301,20120508,8510,8524,8520,8568,8520,8534,8546,10,22,15546,1328863760,51618
1493,p1301,20120509,8534,8546,8500,8514,8458,8508,8484,-38,-62,15946,1353013480,52162
1494,p1301,20120510,8508,8484,8510,8560,8476,8558,8518,74,34,31412,2676144680,54988
1495,p1301,20120511,8558,8518,8550,8554,8358,8360,8444,-158,-74,30358,2563793480,56730
1496,p1301,20120514,8360,8444,8300,8350,8188,8208,8262,-236,-182,33632,2779304800,55668
1497,p1301,20120515,8208,8262,8150,8176,8092,8144,8134,-118,-128,29594,2407176960,58650
1498,p1301,20120516,8144,8134,8150,8190,8030,8040,8118,-94,-16,36028,2924818680,59404
1499,p1301,20120517,8040,8118,8100,8130,8016,8078,8074,-40,-44,48496,3915577680,68760
1500,p1301,20120518,8078,8074,8050,8050,7904,7914,7962,-160,-112,58906,4690557680,76344
1501,p1301,20120521,7914,7962,8000,8068,7960,8038,8022,76,60,59824,4800162920,78524
1502,p1301,20120522,8038,8022,8046,8064,8020,8044,8044,22,22,39548,3181287360,78152
1503,p1301,20120523,8044,8044,7940,7948,7836,7852,7894,-192,-150,59752,4717492120,84924
1504,p1301,20120524,7852,7894,7850,7876,7784,7874,7844,-20,-50,67366,5284616240,90416
1505,p1301,20120525,7874,7844,7870,7904,7814,7902,7868,58,24,62750,4938290360,92826
1506,p1301,20120528,7902,7868,7928,8006,7922,8002,7968,134,100,69460,5534579760,90566
1507,p1301,20120529,8002,7968,7970,8054,7962,8052,8004,84,36,78576,6290282200,96428
1508,p1301,20120530,8052,8004,8010,8034,7970,7988,8008,-16,4,89024,7129448280,95202
1509,p1301,20120531,7988,8008,7906,7974,7906,7922,7944,-86,-64,98598,7833249600,97526
1510,p1301,20120601,7922,7944,7886,7924,7830,7834,7880,-110,-64,126740,9989075600,111314
1511,p1301,20120604,7834,7880,7810,7812,7584,7640,7678,-240,-202,235740,18103391000,116746
1512,p1301,20120605,7640,7678,7700,7766,7684,7704,7716,26,38,168828,13027256520,136206
1513,p1301,20120606,7704,7716,7718,7802,7690,7742,7764,26,48,223252,17334520160,139454
1514,p1301,20120607,7742,7764,7802,7858,7760,7782,7812,18,48,181480,14178623400,146418
1515,p1301,20120608,7782,7812,7832,7840,7702,7758,7764,-54,-48,237008,18403953880,147782
1516,p1301,20120611,7758,7764,7810,7934,7808,7928,7902,164,138,248548,19641382320,153918
1517,p1301,20120612,7928,7902,7830,7866,7816,7862,7840,-40,-62,175768,13781352760,154314
1518,p1301,20120613,7862,7840,7858,7882,7820,7824,7846,-16,6,173824,13641457920,171758
1519,p1301,20120614,7824,7846,7768,7772,7624,7628,7680,-218,-166,424010,32567379280,203890
1520,p1301,20120615,7628,7680,7630,7694,7602,7658,7652,-22,-28,412216,31547771960,198700
1521,p1301,20120618,7658,7652,7746,7754,7676,7742,7720,90,68,372586,28770367880,209914
1522,p1301,20120619,7742,7720,7770,7848,7744,7814,7812,94,92,327414,25579317760,208372
1523,p1301,20120620,7814,7812,7900,8022,7874,8016,7960,204,148,373030,29697996080,225850
1524,p1301,20120621,8016,7960,7928,7980,7882,7946,7932,-14,-28,361144,28646498880,226848
1525,p1301,20120625,7946,7932,8030,8120,7992,8006,8068,74,136,413134,33335763040,250616
1526,p1301,20120626,8006,8068,8066,8066,7974,7998,8008,-70,-60,343516,27514428200,244102
1527,p1301,20120627,7998,8008,8008,8026,7950,8002,7992,-6,-16,330608,26424596560,256198
1528,p1301,20120628,8002,7992,8030,8042,7944,7952,7974,-40,-18,238152,18993957000,243766
1529,p1301,20120629,7952,7974,7930,8070,7920,8066,7998,92,24,330336,26423215440,256522
1530,p1301,20120702,8066,7998,8200,8224,8096,8096,8128,98,130,242098,19679110360,231750
1531,p1301,20120703,8096,8128,8120,8182,8102,8176,8150,48,22,219858,17921358200,234256
1532,p1301,20120704,8176,8150,8202,8246,8152,8190,8206,40,56,259780,21320902040,236776
1533,p1301,20120705,8190,8206,8180,8262,8166,8222,8212,16,6,318602,26166982000,236992
1534,p1301,20120706,8222,8212,8232,8306,8206,8212,8260,0,48,343816,28405597240,221358
1535,p1301,20120709,8212,8260,8200,8344,8174,8308,8274,48,14,436240,36096962360,239798
1536,p1301,20120710,8308,8274,8280,8298,8196,8202,8258,-72,-16,237668,19626670600,231468
1537,p1301,20120711,8202,8258,8230,8306,8070,8134,8182,-124,-76,466146,38144805720,229760
1538,p1301,20120712,8134,8182,8114,8114,7984,7998,8032,-184,-150,295556,23741082840,222726
1539,p1301,20120713,7998,8032,8010,8046,7966,8040,8010,8,-22,315616,25282460880,220564
1540,p1301,20120716,8040,8010,8100,8280,8100,8252,8236,242,226,321816,26505967440,214886
1541,p1301,20120717,8252,8236,8284,8292,8120,8154,8184,-82,-52,305624,25014193120,218760
1542,p1301,20120718,8154,8184,8178,8186,8004,8038,8082,-146,-102,323388,26136348640,242366
1543,p1301,20120719,8038,8082,8090,8100,8008,8052,8050,-30,-32,419540,33776515720,252830
1544,p1301,20120720,8052,8050,8062,8130,8034,8082,8074,32,24,306522,24750261240,222872
1545,p1301,20120723,8082,8074,8000,8000,7876,7882,7908,-192,-166,260188,20576071880,216616
1546,p1301,20120724,7882,7908,7700,7748,7592,7706,7702,-202,-206,269814,20782893040,214478
1547,p1301,20120725,7706,7702,7604,7742,7604,7652,7690,-50,-12,245320,18869852560,208012
1548,p1301,20120726,7652,7690,7692,7718,7634,7694,7680,4,-10,190932,14664312760,205306
1549,p1301,20120727,7694,7680,7650,7774,7650,7768,7716,88,36,206634,15944504000,205240
1550,p1301,20120730,7768,7716,7840,7924,7784,7852,7864,136,148,285630,22465823520,206044
1551,p1301,20120731,7852,7864,7830,7892,7802,7860,7846,-4,-18,250418,19648196760,204090
1552,p1301,20120801,7860,7846,7880,7920,7840,7854,7886,8,40,230106,18149736680,210718
1553,p1301,20120802,7854,7886,7810,7810,7696,7768,7744,-118,-142,326368,25278255760,221334
1554,p1301,20120803,7768,7744,7700,7780,7698,7750,7742,6,-2,194452,15055662320,212040
1555,p1301,20120806,7750,7742,7700,7820,7696,7788,7782,46,40,232664,18107591280,211056
1556,p1301,20120807,7788,7782,7782,7844,7782,7826,7818,44,36,193630,15138659920,222944
1557,p1301,20120808,7826,7818,7802,7810,7754,7758,7774,-60,-44,200732,15608512920,227614
1558,p1301,20120809,7758,7774,7788,7860,7778,7854,7818,80,44,236606,18500410320,228182
1559,p1301,20120810,7854,7818,7880,7884,7714,7746,7784,-72,-34,320382,24943026560,240272
1560,p1301,20120813,7746,7784,7800,7824,7736,7738,7778,-46,-6,254684,19811781160,244342
1561,p1301,20120814,7738,7778,7720,7748,7588,7690,7662,-88,-116,403238,30898362120,250116
1562,p1301,20120815,7690,7662,7666,7730,7630,7708,7692,46,30,298532,22964428080,227194
1563,p1301,20120816,7708,7692,7728,7750,7680,7736,7722,44,30,287284,22187099840,237600
1564,p1301,20120817,7736,7722,7760,7858,7752,7814,7820,92,98,413684,32357799520,237920
1565,p1301,20120820,7814,7820,7846,7846,7796,7808,7818,-12,-2,220434,17236341040,237650
1566,p1301,20120821,7808,7818,7850,7866,7790,7838,7834,20,16,247902,19420983360,221722
1567,p1301,20120822,7838,7834,7922,8054,7886,8042,7990,208,156,519052,41473496040,255162
1568,p1301,20120823,8042,7990,8086,8150,8022,8084,8092,94,102,312612,25298122680,249824
1569,p1301,20120824,8084,8092,8054,8244,8036,8240,8174,148,82,589326,48174667200,295436
1570,p1301,20120827,8240,8174,8300,8338,8240,8284,8286,110,112,383742,31799651760,270406
1571,p1301,20120828,8284,8286,8210,8260,8164,8174,8212,-112,-74,241806,19860356920,261844
1572,p1301,20120829,8174,8212,8162,8218,8072,8140,8144,-72,-68,320784,26129810880,256632
1573,p1301,20120830,8140,8144,8182,8232,8132,8196,8174,52,30,258272,21113447440,261926
1574,p1301,20120831,8196,8174,8160,8170,8056,8064,8096,-110,-78,257594,20857881040,260250
1575,p1301,20120903,8064,8096,8088,8280,8072,8230,8200,134,104,339806,27869513960,262452
1576,p1301,20120904,8230,8200,8256,8352,8216,8244,8264,44,64,319666,26420760760,263410
1577,p1301,20120905,8244,8264,8206,8302,8140,8200,8238,-64,-26,389608,32097407840,272758
1578,p1301,20120906,8200,8238,8138,8138,8056,8074,8094,-164,-144,262224,21225524720,268508
1579,p1301,20120907,8074,8094,8074,8108,7972,7974,8046,-120,-48,366050,29457931560,296432
1580,p1301,20120910,7974,8046,7992,8032,7954,8010,8002,-36,-44,236864,18954640640,299710
1581,p1301,20120911,8010,8002,8002,8056,7896,7914,7962,-88,-40,361204,28762246160,277068
1582,p1301,20120912,7914,7962,7912,7948,7880,7936,7918,-26,-44,247238,19577314200,272144
1583,p1301,20120913,7936,7918,7960,8034,7940,7946,7990,28,72,246730,19718388360,270844
1584,p1301,20120914,7946,7990,8050,8098,8010,8046,8040,56,50,256058,20590672080,271782
1585,p1301,20120917,8046,8040,8044,8094,7898,7908,8022,-132,-18,329116,26406897560,274020
1586,p1301,20120918,7908,8022,7850,7866,7706,7744,7790,-278,-232,287684,22411930120,273866
1587,p1301,20120919,7744,7790,7800,7852,7774,7802,7812,12,22,187498,14648845600,263936
1588,p1301,20120920,7802,7812,7840,7852,7744,7760,7796,-52,-16,224170,17478563000,260054
1589,p1301,20120921,7760,7796,7720,7730,7606,7614,7656,-182,-140,320744,24562474000,286212
1590,p1301,20120924,7614,7656,7550,7550,7350,7350,7388,-306,-268,390494,28854236840,313402
1591,p1301,20120925,7350,7388,7352,7380,7202,7266,7284,-122,-104,687014,50048370760,308506
1592,p1301,20120926,7266,7284,7252,7318,7222,7230,7264,-54,-20,388272,28209595360,288740
1593,p1301,20120927,7230,7264,7140,7244,7128,7158,7176,-106,-88,342602,24591924280,276690
1594,p1301,20120928,7158,7176,7206,7244,7172,7186,7206,10,30,220106,15861936400,265906
1595,p1301,20121008,7186,7206,7020,7020,6838,6872,6918,-334,-288,480794,33268999360,305242
1596,p1301,20121009,6872,6918,6882,7046,6880,7014,6968,96,50,560080,39030586560,300764
1597,p1301,20121010,7014,6968,6974,7048,6962,7022,7008,54,40,423594,29692295560,290912
1598,p1301,20121011,7022,7008,6972,7038,6930,7000,6992,-8,-16,477136,33361646080,309490
1599,p1301,20121012,7000,6992,7044,7082,6884,6896,6986,-96,-6,473582,33086327080,330574
1600,p1301,20121015,6896,6986,6814,6858,6754,6842,6826,-144,-160,415580,28369193640,334620
1601,p1301,20121016,6842,6826,6876,6932,6862,6926,6902,100,76,227924,15733998880,322222
1602,p1301,20121017,6926,6902,6860,6936,6856,6884,6886,-18,-16,260392,17935049640,314776
1603,p1301,20121018,6884,6886,6920,6978,6906,6950,6950,64,64,166870,11600386400,308174
1604,p1301,20121019,6950,6950,7002,7012,6960,6962,6982,12,32,156920,10957048720,285768
1605,p1301,20121022,6962,6982,6916,6986,6912,6984,6962,2,-20,126648,8818767040,284266
1606,p1301,20121023,6984,6962,7010,7040,6964,6972,7004,10,42,142398,9973935880,270934
1607,p1301,20121024,6972,7004,7002,7020,6986,7016,7002,12,-2,105588,7394837840,257852
1608,p1301,20121025,7016,7002,7020,7028,6910,6920,6970,-82,-32,124850,8702561400,276382
1609,p1301,20121026,6920,6970,6912,6934,6712,6746,6816,-224,-154,305720,20843506160,303834
1610,p1301,20121029,6746,6816,6700,6752,6644,6646,6686,-170,-130,232320,15534322080,310758
1611,p1301,20121030,6646,6686,6646,6664,6506,6536,6566,-150,-120,345340,22677873840,311968
1612,p1301,20121031,6536,6566,6528,6636,6500,6630,6568,64,2,291512,19149408760,269808
1613,p1301,20121101,6630,6568,6604,6648,6590,6640,6620,72,52,139788,9256187040,265108
1614,p1301,20121102,6640,6620,6634,6660,6534,6552,6582,-68,-38,149912,9869747440,258642
1615,p1301,20121105,6552,6582,6480,6494,6340,6344,6408,-238,-174,165796,10625767320,260110
1616,p1301,20121106,6344,6408,6362,6440,6356,6388,6396,-20,-12,128670,8229951480,249438
1617,p1301,20121107,6388,6396,6400,6424,6310,6396,6376,0,-20,191700,12226092640,251462
1618,p1301,20121108,6396,6376,6350,6416,6330,6346,6380,-30,4,115172,7350035880,245000
1619,p1301,20121109,6346,6380,6320,6346,6250,6252,6298,-128,-82,251228,15825162800,260386
1620,p1301,20121112,6252,6298,6154,6180,6048,6078,6088,-220,-210,220704,13438735800,227488
1621,p1301,20121113,6078,6088,6148,6204,6120,6140,6162,52,74,176232,10860485840,214232
1622,p1301,20121114,6140,6162,6146,6204,6120,6204,6168,42,6,148684,9172972560,210246
1623,p1301,20121115,6204,6168,6216,6276,6174,6182,6236,14,68,163612,10204371280,205854
1624,p1301,20121116,6182,6236,6160,6210,6112,6136,6154,-100,-82,137400,8455968360,197122
1625,p1301,20121119,6136,6154,6174,6222,6162,6218,6190,64,36,110362,6833579080,179004
1626,p1301,20121120,6218,6190,6234,6280,6196,6236,6234,46,44,124058,7736235040,167952
1627,p1301,20121121,6236,6234,6280,6284,6232,6264,6248,30,14,86018,5375320080,159368
1628,p1301,20121122,6264,6248,6288,6294,6248,6282,6272,34,24,74452,4669825360,148588
1629,p1301,20121123,6282,6272,6274,6274,6204,6264,6234,-8,-38,86652,5402776400,144830
1630,p1301,20121126,6264,6234,6280,6320,6268,6292,6296,58,62,62928,3962370760,137926
1631,p1301,20121127,6292,6296,6302,6328,6284,6304,6308,8,12,67324,4247343640,121914
1632,p1301,20121128,6304,6308,6332,6352,6264,6276,6312,-32,4,60646,3828247720,121702
1633,p1301,20121129,6276,6312,6292,6298,6226,6246,6262,-66,-50,52712,3301140360,119528
1634,p1301,20121130,6246,6262,6248,6268,6190,6246,6234,-16,-28,90300,5630964640,108642
1635,p1301,20121203,6246,6234,6232,6334,6232,6302,6296,68,62,46050,2899893280,86316
1636,p1301,20121204,6302,6296,6250,6320,6242,6320,6278,24,-18,33570,2107884120,76566
1637,p1301,20121205,6320,6278,6322,6382,6310,6358,6342,80,64,26884,1705047240,68204
1638,p1301,20121206,6358,6342,6380,6408,6362,6366,6386,24,44,15202,970976640,62518
1639,p1301,20121207,6366,6386,6378,6420,6352,6390,6392,4,6,10696,683879520,58966
1640,p1301,20121210,6390,6392,6352,6436,6352,6358,6382,-34,-10,19178,1224090320,47912
1641,p1301,20121211,6358,6382,6360,6390,6270,6274,6340,-108,-42,13298,843282920,44640
1642,p1301,20121212,6274,6340,6210,6258,6190,6190,6226,-150,-114,16996,1058392120,38208
1643,p1301,20121213,6190,6226,6206,6218,6166,6184,6200,-42,-26,8496,526836720,36484
1644,p1301,20121214,6184,6200,6176,6222,6172,6214,6202,14,2,11426,708802440,34312
1645,p1301,20121217,6214,6202,6228,6282,6220,6242,6246,40,44,8484,530029400,30892
1646,p1301,20121218,6242,6246,6240,6272,6224,6242,6250,-4,4,5932,370750040,28310
1647,p1301,20121219,6242,6250,6220,6220,6168,6200,6190,-50,-60,2938,181911800,27272
1648,p1301,20121220,6200,6190,6152,6164,6080,6136,6118,-54,-72,4630,283302320,25528
1649,p1301,20121221,6136,6118,6118,6186,6100,6164,6150,46,32,3302,203119520,22680
1650,p1301,20121224,6164,6150,6200,6242,6172,6192,6210,42,60,4098,254517160,20344
1651,p1301,20121225,6192,6210,6176,6306,6128,6260,6228,50,18,9844,613113400,19790
1652,p1301,20121226,6260,6228,6274,6288,6230,6238,6258,10,30,2228,139453640,19356
1653,p1301,20121227,6238,6258,6246,6252,6204,6218,6230,-40,-28,1936,120645160,19120
1654,p1301,20121228,6218,6230,6218,6264,6176,6242,6218,12,-12,2772,172413440,17694
1655,p1301,20121231,6242,6218,6260,6344,6020,6288,6230,70,12,2056,128097320,17616
1656,p1302,20120216,8280,8280,0,0,0,8280,8280,0,0,0,0,0
1657,p1302,20120217,8280,8280,0,0,0,8280,8280,0,0,0,0,0
1658,p1302,20120220,8280,8280,0,0,0,8280,8280,0,0,0,0,0
1659,p1302,20120221,8280,8280,0,0,0,8280,8280,0,0,0,0,0
1660,p1302,20120222,8280,8280,0,0,0,8280,8280,0,0,0,0,0
1661,p1302,20120223,8280,8280,0,0,0,8280,8280,0,0,0,0,0
1662,p1302,20120224,8280,8280,0,0,0,8280,8280,0,0,0,0,0
1663,p1302,20120227,8280,8280,0,0,0,8280,8280,0,0,0,0,0
1664,p1302,20120228,8280,8280,0,0,0,8280,8280,0,0,0,0,0
1665,p1302,20120229,8280,8280,0,0,0,8280,8280,0,0,0,0,0
1666,p1302,20120301,8280,8280,0,0,0,8280,8280,0,0,0,0,0
1667,p1302,20120302,8280,8280,0,0,0,8280,8280,0,0,0,0,0
1668,p1302,20120305,8280,8280,0,0,0,8280,8280,0,0,0,0,0
1669,p1302,20120306,8280,8280,0,0,0,8280,8280,0,0,0,0,0
1670,p1302,20120307,8280,8280,0,0,0,8280,8280,0,0,0,0,0
1671,p1302,20120308,8280,8280,0,0,0,8280,8280,0,0,0,0,0
1672,p1302,20120309,8280,8280,0,0,0,8280,8280,0,0,0,0,0
1673,p1302,20120312,8280,8280,0,0,0,8280,8280,0,0,0,0,0
1674,p1302,20120313,8280,8280,0,0,0,8280,8280,0,0,0,0,0
1675,p1302,20120314,8280,8280,0,0,0,8280,8280,0,0,0,0,0
1676,p1302,20120315,8280,8280,0,0,0,8280,8280,0,0,0,0,0
1677,p1302,20120316,8280,8280,8732,8732,8730,8730,8730,450,450,4,349240,4
1678,p1302,20120319,8730,8730,0,0,0,8730,8730,0,0,0,0,4
1679,p1302,20120320,8730,8730,8690,8690,8690,8690,8690,-40,-40,4,347600,2
1680,p1302,20120321,8690,8690,0,0,0,8690,8690,0,0,0,0,2
1681,p1302,20120322,8690,8690,0,0,0,8690,8690,0,0,0,0,2
1682,p1302,20120323,8690,8690,0,0,0,8690,8690,0,0,0,0,2
1683,p1302,20120326,8690,8690,0,0,0,8690,8690,0,0,0,0,2
1684,p1302,20120327,8690,8690,8834,8876,8824,8876,8840,186,150,16,1414480,8
1685,p1302,20120328,8876,8840,0,0,0,8840,8840,0,0,0,0,8
1686,p1302,20120329,8840,8840,8780,8780,8768,8768,8776,-72,-64,6,526560,8
1687,p1302,20120330,8768,8776,0,0,0,8776,8776,0,0,0,0,8
1688,p1302,20120405,8776,8776,8910,8950,8910,8950,8922,174,146,8,713760,10
1689,p1302,20120406,8950,8922,9040,9040,9040,9040,9040,118,118,2,180800,12
1690,p1302,20120409,9040,9040,0,0,0,9040,9040,0,0,0,0,12
1691,p1302,20120410,9040,9040,0,0,0,9040,9040,0,0,0,0,12
1692,p1302,20120411,9040,9040,9018,9018,9010,9018,9014,-22,-26,6,540920,8
1693,p1302,20120412,9018,9014,0,0,0,9014,9014,0,0,0,0,8
1694,p1302,20120413,9014,9014,0,0,0,9014,9014,0,0,0,0,8
1695,p1302,20120416,9014,9014,0,0,0,9014,9014,0,0,0,0,8
1696,p1302,20120417,9014,9014,0,0,0,9014,9014,0,0,0,0,8
1697,p1302,20120418,9014,9014,8960,8960,8888,8888,8924,-126,-90,4,356960,6
1698,p1302,20120419,8888,8924,8868,8872,8866,8872,8868,-52,-56,6,532120,2
1699,p1302,20120420,8872,8868,0,0,0,8868,8868,0,0,0,0,2
1700,p1302,20120423,8868,8868,0,0,0,8868,8868,0,0,0,0,2
1701,p1302,20120424,8868,8868,0,0,0,8868,8868,0,0,0,0,2
1702,p1302,20120425,8868,8868,8808,8808,8808,8808,8808,-60,-60,2,176160,2
1703,p1302,20120426,8808,8808,0,0,0,8808,8808,0,0,0,0,2
1704,p1302,20120427,8808,8808,0,0,0,8808,8808,0,0,0,0,2
1705,p1302,20120502,8808,8808,0,0,0,8808,8808,0,0,0,0,2
1706,p1302,20120503,8808,8808,0,0,0,8808,8808,0,0,0,0,2
1707,p1302,20120504,8808,8808,8870,8870,8870,8870,8870,62,62,2,177400,4
1708,p1302,20120507,8870,8870,8518,8518,8518,8518,8518,-352,-352,2,170360,4
1709,p1302,20120508,8518,8518,8560,8560,8560,8560,8560,42,42,2,171200,4
1710,p1302,20120509,8560,8560,8562,8562,8562,8562,8562,2,2,2,171240,2
1711,p1302,20120510,8562,8562,0,0,0,8562,8562,0,0,0,0,2
1712,p1302,20120511,8562,8562,0,0,0,8562,8562,0,0,0,0,2
1713,p1302,20120514,8562,8562,0,0,0,8562,8562,0,0,0,0,2
1714,p1302,20120515,8562,8562,8250,8250,8250,8250,8250,-312,-312,2,165000,2
1715,p1302,20120516,8250,8250,0,0,0,8250,8250,0,0,0,0,2
1716,p1302,20120517,8250,8250,8078,8198,8078,8102,8126,-148,-124,6,487560,2
1717,p1302,20120518,8102,8126,0,0,0,8126,8126,0,0,0,0,2
1718,p1302,20120521,8126,8126,0,0,0,8126,8126,0,0,0,0,2
1719,p1302,20120522,8126,8126,0,0,0,8126,8126,0,0,0,0,2
1720,p1302,20120523,8126,8126,0,0,0,8126,8126,0,0,0,0,2
1721,p1302,20120524,8126,8126,0,0,0,8126,8126,0,0,0,0,2
1722,p1302,20120525,8126,8126,0,0,0,8126,8126,0,0,0,0,2
1723,p1302,20120528,8126,8126,0,0,0,8126,8126,0,0,0,0,2
1724,p1302,20120529,8126,8126,0,0,0,8126,8126,0,0,0,0,2
1725,p1302,20120530,8126,8126,0,0,0,8126,8126,0,0,0,0,2
1726,p1302,20120531,8126,8126,0,0,0,8126,8126,0,0,0,0,2
1727,p1302,20120601,8126,8126,0,0,0,8126,8126,0,0,0,0,2
1728,p1302,20120604,8126,8126,0,0,0,8126,8126,0,0,0,0,2
1729,p1302,20120605,8126,8126,7730,7800,7730,7784,7784,-342,-342,14,1089960,10
1730,p1302,20120606,7784,7784,7800,7822,7800,7810,7810,26,26,16,1249840,4
1731,p1302,20120607,7810,7810,0,0,0,7810,7810,0,0,0,0,4
1732,p1302,20120608,7810,7810,0,0,0,7810,7810,0,0,0,0,4
1733,p1302,20120611,7810,7810,0,0,0,7810,7810,0,0,0,0,4
1734,p1302,20120612,7810,7810,0,0,0,7810,7810,0,0,0,0,4
1735,p1302,20120613,7810,7810,0,0,0,7810,7810,0,0,0,0,4
1736,p1302,20120614,7810,7810,0,0,0,7810,7810,0,0,0,0,4
1737,p1302,20120615,7810,7810,7650,7650,7650,7650,7650,-160,-160,2,153000,4
1738,p1302,20120618,7650,7650,0,0,0,7650,7650,0,0,0,0,4
1739,p1302,20120619,7650,7650,0,0,0,7650,7650,0,0,0,0,4
1740,p1302,20120620,7650,7650,7956,7956,7956,7956,7956,306,306,2,159120,4
1741,p1302,20120621,7956,7956,0,0,0,7956,7956,0,0,0,0,4
1742,p1302,20120625,7956,7956,8102,8102,8102,8102,8102,146,146,2,162040,6
1743,p1302,20120626,8102,8102,8046,8046,8046,8046,8046,-56,-56,2,160920,4
1744,p1302,20120627,8046,8046,0,0,0,8046,8046,0,0,0,0,4
1745,p1302,20120628,8046,8046,7990,8046,7990,7990,8008,-56,-38,12,961040,4
1746,p1302,20120629,7990,8008,0,0,0,8008,8008,0,0,0,0,4
1747,p1302,20120702,8008,8008,8116,8116,8116,8116,8116,108,108,2,162320,6
1748,p1302,20120703,8116,8116,8134,8186,8134,8186,8168,70,52,6,490120,8
1749,p1302,20120704,8186,8168,0,0,0,8168,8168,0,0,0,0,8
1750,p1302,20120705,8168,8168,8340,8394,8172,8394,8282,226,114,12,994000,6
1751,p1302,20120706,8394,8282,8176,8398,8152,8312,8276,30,-6,18,1489760,4
1752,p1302,20120709,8312,8276,8202,8348,8202,8290,8280,14,4,6,496800,4
1753,p1302,20120710,8290,8280,0,0,0,8280,8280,0,0,0,0,4
1754,p1302,20120711,8280,8280,8500,8502,8168,8168,8310,-112,30,32,2659720,4
1755,p1302,20120712,8168,8310,0,0,0,8310,8310,0,0,0,0,4
1756,p1302,20120713,8310,8310,0,0,0,8310,8310,0,0,0,0,4
1757,p1302,20120716,8310,8310,8242,8242,8242,8242,8242,-68,-68,2,164840,4
1758,p1302,20120717,8242,8242,8246,8246,8230,8230,8238,-12,-4,16,1318080,4
1759,p1302,20120718,8230,8238,0,0,0,8238,8238,0,0,0,0,4
1760,p1302,20120719,8238,8238,0,0,0,8238,8238,0,0,0,0,4
1761,p1302,20120720,8238,8238,8184,8184,8088,8088,8136,-150,-102,4,325440,4
1762,p1302,20120723,8088,8136,8108,8108,7828,7992,7976,-144,-160,6,478560,4
1763,p1302,20120724,7992,7976,0,0,0,7976,7976,0,0,0,0,4
1764,p1302,20120725,7976,7976,7758,7758,7700,7700,7722,-276,-254,6,463360,2
1765,p1302,20120726,7700,7722,0,0,0,7722,7722,0,0,0,0,2
1766,p1302,20120727,7722,7722,0,0,0,7722,7722,0,0,0,0,2
1767,p1302,20120730,7722,7722,0,0,0,7722,7722,0,0,0,0,2
1768,p1302,20120731,7722,7722,0,0,0,7722,7722,0,0,0,0,2
1769,p1302,20120801,7722,7722,0,0,0,7722,7722,0,0,0,0,2
1770,p1302,20120802,7722,7722,7754,7754,7754,7754,7754,32,32,4,310160,4
1771,p1302,20120803,7754,7754,0,0,0,7754,7754,0,0,0,0,4
1772,p1302,20120806,7754,7754,7870,7874,7746,7850,7822,96,68,12,938720,4
1773,p1302,20120807,7850,7822,0,0,0,7822,7822,0,0,0,0,4
1774,p1302,20120808,7822,7822,0,0,0,7822,7822,0,0,0,0,4
1775,p1302,20120809,7822,7822,0,0,0,7822,7822,0,0,0,0,4
1776,p1302,20120810,7822,7822,0,0,0,7822,7822,0,0,0,0,4
1777,p1302,20120813,7822,7822,7764,7830,7764,7800,7798,-22,-24,6,467880,4
1778,p1302,20120814,7800,7798,7676,7742,7676,7742,7708,-56,-90,4,308360,6
1779,p1302,20120815,7742,7708,7710,7750,7708,7750,7722,42,14,6,463360,4
1780,p1302,20120816,7750,7722,0,0,0,7722,7722,0,0,0,0,4
1781,p1302,20120817,7722,7722,7892,7892,7816,7850,7852,128,130,6,471160,4
1782,p1302,20120820,7850,7852,0,0,0,7852,7852,0,0,0,0,4
1783,p1302,20120821,7852,7852,0,0,0,7852,7852,0,0,0,0,4
1784,p1302,20120822,7852,7852,7964,8110,7964,8110,8100,258,248,80,6480000,74
1785,p1302,20120823,8110,8100,8148,8254,8148,8200,8200,100,100,6,492040,74
1786,p1302,20120824,8200,8200,8286,8286,8220,8260,8224,60,24,84,6908720,8
1787,p1302,20120827,8260,8224,8288,8382,8282,8282,8328,58,104,12,999440,8
1788,p1302,20120828,8282,8328,8306,8306,8306,8306,8306,-22,-22,2,166120,8
1789,p1302,20120829,8306,8306,0,0,0,8306,8306,0,0,0,0,8
1790,p1302,20120830,8306,8306,8270,8270,8200,8200,8230,-106,-76,50,4115720,8
1791,p1302,20120831,8200,8230,8188,8188,8110,8110,8140,-120,-90,6,488400,6
1792,p1302,20120903,8110,8140,8222,8222,8222,8222,8222,82,82,2,164440,8
1793,p1302,20120904,8222,8222,8404,8404,8270,8318,8342,96,120,28,2336280,10
1794,p1302,20120905,8318,8342,8244,8320,8244,8250,8264,-92,-78,8,661160,6
1795,p1302,20120906,8250,8264,8124,8124,8124,8124,8124,-140,-140,2,162480,8
1796,p1302,20120907,8124,8124,8150,8150,8010,8072,8086,-52,-38,24,1940760,8
1797,p1302,20120910,8072,8086,8040,8240,8032,8240,8158,154,72,10,815840,6
1798,p1302,20120911,8240,8158,7920,8018,7920,8018,7968,-140,-190,4,318760,6
1799,p1302,20120912,8018,7968,0,0,0,7968,7968,0,0,0,0,6
1800,p1302,20120913,7968,7968,0,0,0,7968,7968,0,0,0,0,6
1801,p1302,20120914,7968,7968,0,0,0,7968,7968,0,0,0,0,6
1802,p1302,20120917,7968,7968,8258,8258,8036,8036,8158,68,190,38,3100280,8
1803,p1302,20120918,8036,8158,7978,7988,7976,7988,7980,-170,-178,6,478840,6
1804,p1302,20120919,7988,7980,0,0,0,7980,7980,0,0,0,0,6
1805,p1302,20120920,7980,7980,7950,7980,7950,7980,7972,0,-8,8,637800,12
1806,p1302,20120921,7980,7972,0,0,0,7972,7972,0,0,0,0,12
1807,p1302,20120924,7972,7972,7654,7654,7654,7654,7654,-318,-318,2,153080,14
1808,p1302,20120925,7654,7654,7320,7478,7320,7370,7410,-284,-244,40,2964640,8
1809,p1302,20120926,7370,7410,0,0,0,7410,7410,0,0,0,0,8
1810,p1302,20120927,7410,7410,7340,7358,7272,7300,7316,-110,-94,8,585400,6
1811,p1302,20120928,7300,7316,7314,7404,7314,7404,7358,88,42,4,294360,6
1812,p1302,20121008,7404,7358,0,0,0,7358,7358,0,0,0,0,6
1813,p1302,20121009,7358,7358,7130,7194,7130,7194,7162,-164,-196,4,286480,10
1814,p1302,20121010,7194,7162,7194,7194,7194,7194,7194,32,32,2,143880,12
1815,p1302,20121011,7194,7194,7156,7170,7108,7162,7140,-32,-54,16,1142560,12
1816,p1302,20121012,7162,7140,7164,7338,7164,7190,7212,50,72,10,721200,12
1817,p1302,20121015,7190,7212,7000,7000,7000,7000,7000,-212,-212,4,280000,10
1818,p1302,20121016,7000,7000,0,0,0,7000,7000,0,0,0,0,10
1819,p1302,20121017,7000,7000,0,0,0,7000,7000,0,0,0,0,10
1820,p1302,20121018,7000,7000,7140,7140,7084,7084,7104,84,104,10,710520,14
1821,p1302,20121019,7084,7104,7038,7144,7038,7100,7094,-4,-10,12,851280,14
1822,p1302,20121022,7100,7094,7110,7122,7110,7122,7118,28,24,6,427080,14
1823,p1302,20121023,7122,7118,7130,7130,7114,7120,7118,2,0,16,1139080,20
1824,p1302,20121024,7120,7118,7078,7080,7050,7050,7068,-68,-50,30,2120720,48
1825,p1302,20121025,7050,7068,0,0,0,7068,7068,0,0,0,0,48
1826,p1302,20121026,7068,7068,6906,6994,6846,6846,6936,-222,-132,12,832320,48
1827,p1302,20121029,6846,6936,6740,6850,6740,6816,6812,-120,-124,62,4224320,14
1828,p1302,20121030,6816,6812,0,0,0,6812,6812,0,0,0,0,14
1829,p1302,20121031,6812,6812,0,0,0,6812,6812,0,0,0,0,14
1830,p1302,20121101,6812,6812,0,0,0,6812,6812,0,0,0,0,14
1831,p1302,20121102,6812,6812,6938,6938,6796,6796,6866,-16,54,4,274680,14
1832,p1302,20121105,6796,6866,6796,6914,6592,6592,6642,-274,-224,26,1727080,24
1833,p1302,20121106,6592,6642,6568,6568,6568,6568,6568,-74,-74,4,262720,20
1834,p1302,20121107,6568,6568,0,0,0,6568,6568,0,0,0,0,20
1835,p1302,20121108,6568,6568,0,0,0,6568,6568,0,0,0,0,20
1836,p1302,20121109,6568,6568,0,0,0,6568,6568,0,0,0,0,20
1837,p1302,20121112,6568,6568,6330,6356,6330,6356,6338,-212,-230,6,380320,22
1838,p1302,20121113,6356,6338,6436,6438,6304,6304,6390,-34,52,34,2172760,34
1839,p1302,20121114,6304,6390,6360,6360,6216,6296,6276,-94,-114,80,5021600,66
1840,p1302,20121115,6296,6276,6320,6320,6276,6276,6298,0,22,48,3023400,86
1841,p1302,20121116,6276,6298,6230,6262,6136,6188,6198,-110,-100,34,2107480,96
1842,p1302,20121119,6188,6198,6172,6308,6172,6232,6214,34,16,148,9198600,174
1843,p1302,20121120,6232,6214,6274,6278,6236,6278,6262,64,48,30,1878800,174
1844,p1302,20121121,6278,6262,6330,6330,6230,6250,6262,-12,0,34,2129280,174
1845,p1302,20121122,6250,6262,6258,6348,6258,6348,6284,86,22,18,1131240,178
1846,p1302,20121123,6348,6284,6242,6270,6242,6270,6260,-14,-24,6,375640,176
1847,p1302,20121126,6270,6260,6310,6354,6298,6308,6318,48,58,102,6445560,228
1848,p1302,20121127,6308,6318,6304,6332,6304,6308,6316,-10,-2,86,5432040,278
1849,p1302,20121128,6308,6316,6340,6364,6296,6304,6328,-12,12,30,1898480,290
1850,p1302,20121129,6304,6328,6260,6314,6256,6278,6288,-50,-40,52,3269840,288
1851,p1302,20121130,6278,6288,6288,6334,6288,6334,6310,46,22,4,252440,286
1852,p1302,20121203,6334,6310,6286,6376,6286,6376,6352,66,42,48,3049200,284
1853,p1302,20121204,6376,6352,6300,6348,6288,6348,6322,-4,-30,36,2276320,278
1854,p1302,20121205,6348,6322,6334,6388,6334,6376,6366,54,44,40,2546480,274
1855,p1302,20121206,6376,6366,6420,6440,6386,6400,6410,34,44,42,2692640,276
1856,p1302,20121207,6400,6410,6428,6432,6426,6432,6428,22,18,8,514280,274
1857,p1302,20121210,6432,6428,6438,6438,6438,6438,6438,10,10,2,128760,274
1858,p1302,20121211,6438,6438,6392,6424,6366,6394,6392,-44,-46,44,2813280,286
1859,p1302,20121212,6394,6392,6366,6366,6258,6280,6292,-112,-100,32,2013440,276
1860,p1302,20121213,6280,6292,6276,6302,6276,6300,6282,8,-10,22,1382400,284
1861,p1302,20121214,6300,6282,6306,6332,6284,6332,6308,50,26,60,3785920,278
1862,p1302,20121217,6332,6308,6366,6388,6366,6388,6374,80,66,32,2040040,282
1863,p1302,20121218,6388,6374,6368,6420,6368,6386,6384,12,10,96,6129480,276
1864,p1302,20121219,6386,6384,6374,6388,6362,6388,6374,4,-10,64,4079400,254
1865,p1302,20121220,6388,6374,6334,6378,6288,6378,6346,4,-28,52,3300040,272
1866,p1302,20121221,6378,6346,6386,6476,6386,6476,6430,130,84,70,4501640,238
1867,p1302,20121224,6476,6430,6496,6496,6462,6462,6476,32,46,20,1295560,228
1868,p1302,20121225,6462,6476,6412,6454,6400,6448,6424,-28,-52,68,4369040,258
1869,p1302,20121226,6448,6424,6460,6460,6414,6428,6446,4,22,22,1418200,264
1870,p1302,20121227,6428,6446,6456,6672,6452,6558,6514,112,68,86,5602480,296
1871,p1302,20121228,6558,6514,6478,6540,6448,6540,6454,26,-60,236,15234960,306
1872,p1302,20121231,6540,6454,6540,6540,6390,6390,6420,-64,-34,222,14253000,184
1873,p1303,20120316,8622,8622,0,0,0,8622,8622,0,0,0,0,0
1874,p1303,20120319,8622,8622,0,0,0,8622,8622,0,0,0,0,0
1875,p1303,20120320,8622,8622,0,0,0,8622,8622,0,0,0,0,0
1876,p1303,20120321,8622,8622,0,0,0,8622,8622,0,0,0,0,0
1877,p1303,20120322,8622,8622,0,0,0,8622,8622,0,0,0,0,0
1878,p1303,20120323,8622,8622,0,0,0,8622,8622,0,0,0,0,0
1879,p1303,20120326,8622,8622,0,0,0,8622,8622,0,0,0,0,0
1880,p1303,20120327,8622,8622,0,0,0,8622,8622,0,0,0,0,0
1881,p1303,20120328,8622,8622,0,0,0,8622,8622,0,0,0,0,0
1882,p1303,20120329,8622,8622,0,0,0,8622,8622,0,0,0,0,0
1883,p1303,20120330,8622,8622,0,0,0,8622,8622,0,0,0,0,0
1884,p1303,20120405,8622,8622,0,0,0,8622,8622,0,0,0,0,0
1885,p1303,20120406,8622,8622,0,0,0,8622,8622,0,0,0,0,0
1886,p1303,20120409,8622,8622,0,0,0,8622,8622,0,0,0,0,0
1887,p1303,20120410,8622,8622,0,0,0,8622,8622,0,0,0,0,0
1888,p1303,20120411,8622,8622,0,0,0,8622,8622,0,0,0,0,0
1889,p1303,20120412,8622,8622,0,0,0,8622,8622,0,0,0,0,0
1890,p1303,20120413,8622,8622,0,0,0,8622,8622,0,0,0,0,0
1891,p1303,20120416,8622,8622,0,0,0,8622,8622,0,0,0,0,0
1892,p1303,20120417,8622,8622,0,0,0,8622,8622,0,0,0,0,0
1893,p1303,20120418,8622,8622,0,0,0,8622,8622,0,0,0,0,0
1894,p1303,20120419,8622,8622,0,0,0,8622,8622,0,0,0,0,0
1895,p1303,20120420,8622,8622,0,0,0,8622,8622,0,0,0,0,0
1896,p1303,20120423,8622,8622,0,0,0,8622,8622,0,0,0,0,0
1897,p1303,20120424,8622,8622,0,0,0,8622,8622,0,0,0,0,0
1898,p1303,20120425,8622,8622,0,0,0,8622,8622,0,0,0,0,0
1899,p1303,20120426,8622,8622,0,0,0,8622,8622,0,0,0,0,0
1900,p1303,20120427,8622,8622,0,0,0,8622,8622,0,0,0,0,0
1901,p1303,20120502,8622,8622,0,0,0,8622,8622,0,0,0,0,0
1902,p1303,20120503,8622,8622,0,0,0,8622,8622,0,0,0,0,0
1903,p1303,20120504,8622,8622,0,0,0,8622,8622,0,0,0,0,0
1904,p1303,20120507,8622,8622,0,0,0,8622,8622,0,0,0,0,0
1905,p1303,20120508,8622,8622,0,0,0,8622,8622,0,0,0,0,0
1906,p1303,20120509,8622,8622,0,0,0,8622,8622,0,0,0,0,0
1907,p1303,20120510,8622,8622,0,0,0,8622,8622,0,0,0,0,0
1908,p1303,20120511,8622,8622,0,0,0,8622,8622,0,0,0,0,0
1909,p1303,20120514,8622,8622,0,0,0,8622,8622,0,0,0,0,0
1910,p1303,20120515,8622,8622,0,0,0,8622,8622,0,0,0,0,0
1911,p1303,20120516,8622,8622,0,0,0,8622,8622,0,0,0,0,0
1912,p1303,20120517,8622,8622,0,0,0,8622,8622,0,0,0,0,0
1913,p1303,20120518,8622,8622,0,0,0,8622,8622,0,0,0,0,0
1914,p1303,20120521,8622,8622,0,0,0,8622,8622,0,0,0,0,0
1915,p1303,20120522,8622,8622,0,0,0,8622,8622,0,0,0,0,0
1916,p1303,20120523,8622,8622,0,0,0,8622,8622,0,0,0,0,0
1917,p1303,20120524,8622,8622,0,0,0,8622,8622,0,0,0,0,0
1918,p1303,20120525,8622,8622,0,0,0,8622,8622,0,0,0,0,0
1919,p1303,20120528,8622,8622,0,0,0,8622,8622,0,0,0,0,0
1920,p1303,20120529,8622,8622,8006,8068,8006,8068,8036,-554,-586,4,321480,0
1921,p1303,20120530,8068,8036,0,0,0,8036,8036,0,0,0,0,0
1922,p1303,20120531,8036,8036,0,0,0,8036,8036,0,0,0,0,0
1923,p1303,20120601,8036,8036,0,0,0,8036,8036,0,0,0,0,0
1924,p1303,20120604,8036,8036,0,0,0,8036,8036,0,0,0,0,0
1925,p1303,20120605,8036,8036,0,0,0,8036,8036,0,0,0,0,0
1926,p1303,20120606,8036,8036,0,0,0,8036,8036,0,0,0,0,0
1927,p1303,20120607,8036,8036,0,0,0,8036,8036,0,0,0,0,0
1928,p1303,20120608,8036,8036,0,0,0,8036,8036,0,0,0,0,0
1929,p1303,20120611,8036,8036,7870,7974,7870,7974,7922,-62,-114,16,1267520,8
1930,p1303,20120612,7974,7922,8020,8020,8020,8020,8020,98,98,8,641600,0
1931,p1303,20120613,8020,8020,7870,7870,7870,7870,7870,-150,-150,8,629600,8
1932,p1303,20120614,7870,7870,7670,7852,7670,7738,7754,-132,-116,34,2636960,4
1933,p1303,20120615,7738,7754,7684,7812,7620,7812,7712,58,-42,32,2467840,14
1934,p1303,20120618,7812,7712,7850,7850,7850,7850,7850,138,138,14,1099000,0
1935,p1303,20120619,7850,7850,0,0,0,7850,7850,0,0,0,0,0
1936,p1303,20120620,7850,7850,0,0,0,7850,7850,0,0,0,0,0
1937,p1303,20120621,7850,7850,0,0,0,7850,7850,0,0,0,0,0
1938,p1303,20120625,7850,7850,0,0,0,7850,7850,0,0,0,0,0
1939,p1303,20120626,7850,7850,0,0,0,7850,7850,0,0,0,0,0
1940,p1303,20120627,7850,7850,0,0,0,7850,7850,0,0,0,0,0
1941,p1303,20120628,7850,7850,0,0,0,7850,7850,0,0,0,0,0
1942,p1303,20120629,7850,7850,0,0,0,7850,7850,0,0,0,0,0
1943,p1303,20120702,7850,7850,0,0,0,7850,7850,0,0,0,0,0
1944,p1303,20120703,7850,7850,0,0,0,7850,7850,0,0,0,0,0
1945,p1303,20120704,7850,7850,0,0,0,7850,7850,0,0,0,0,0
1946,p1303,20120705,7850,7850,0,0,0,7850,7850,0,0,0,0,0
1947,p1303,20120706,7850,7850,0,0,0,7850,7850,0,0,0,0,0
1948,p1303,20120709,7850,7850,0,0,0,7850,7850,0,0,0,0,0
1949,p1303,20120710,7850,7850,0,0,0,7850,7850,0,0,0,0,0
1950,p1303,20120711,7850,7850,0,0,0,7850,7850,0,0,0,0,0
1951,p1303,20120712,7850,7850,0,0,0,7850,7850,0,0,0,0,0
1952,p1303,20120713,7850,7850,0,0,0,7850,7850,0,0,0,0,0
1953,p1303,20120716,7850,7850,0,0,0,7850,7850,0,0,0,0,0
1954,p1303,20120717,7850,7850,8164,8164,8164,8164,8164,314,314,2,163280,2
1955,p1303,20120718,8164,8164,8286,8286,8216,8216,8250,52,86,584,48191640,302
1956,p1303,20120719,8216,8250,8158,8184,8090,8110,8148,-140,-102,380,30968920,4
1957,p1303,20120720,8110,8148,8026,8292,8026,8120,8154,-28,6,14,1141600,8
1958,p1303,20120723,8120,8154,7968,8062,7860,7968,7976,-186,-178,24,1914640,2
1959,p1303,20120724,7968,7976,7804,7804,7804,7804,7804,-172,-172,2,156080,2
1960,p1303,20120725,7804,7804,7714,7800,7700,7780,7748,-24,-56,8,619880,2
1961,p1303,20120726,7780,7748,0,0,0,7748,7748,0,0,0,0,2
1962,p1303,20120727,7748,7748,0,0,0,7748,7748,0,0,0,0,2
1963,p1303,20120730,7748,7748,0,0,0,7748,7748,0,0,0,0,2
1964,p1303,20120731,7748,7748,0,0,0,7748,7748,0,0,0,0,2
1965,p1303,20120801,7748,7748,0,0,0,7748,7748,0,0,0,0,2
1966,p1303,20120802,7748,7748,0,0,0,7748,7748,0,0,0,0,2
1967,p1303,20120803,7748,7748,0,0,0,7748,7748,0,0,0,0,2
1968,p1303,20120806,7748,7748,7904,7958,7814,7862,7864,114,116,92,7235600,2
1969,p1303,20120807,7862,7864,0,0,0,7864,7864,0,0,0,0,2
1970,p1303,20120808,7864,7864,0,0,0,7864,7864,0,0,0,0,2
1971,p1303,20120809,7864,7864,0,0,0,7864,7864,0,0,0,0,2
1972,p1303,20120810,7864,7864,0,0,0,7864,7864,0,0,0,0,2
1973,p1303,20120813,7864,7864,0,0,0,7864,7864,0,0,0,0,2
1974,p1303,20120814,7864,7864,0,0,0,7864,7864,0,0,0,0,2
1975,p1303,20120815,7864,7864,0,0,0,7864,7864,0,0,0,0,2
1976,p1303,20120816,7864,7864,0,0,0,7864,7864,0,0,0,0,2
1977,p1303,20120817,7864,7864,0,0,0,7864,7864,0,0,0,0,2
1978,p1303,20120820,7864,7864,0,0,0,7864,7864,0,0,0,0,2
1979,p1303,20120821,7864,7864,0,0,0,7864,7864,0,0,0,0,2
1980,p1303,20120822,7864,7864,0,0,0,7864,7864,0,0,0,0,2
1981,p1303,20120823,7864,7864,0,0,0,7864,7864,0,0,0,0,2
1982,p1303,20120824,7864,7864,0,0,0,7864,7864,0,0,0,0,2
1983,p1303,20120827,7864,7864,8334,8334,8334,8334,8334,470,470,2,166680,2
1984,p1303,20120828,8334,8334,8324,8324,8218,8312,8280,-22,-54,8,662520,2
1985,p1303,20120829,8312,8280,8302,8334,8184,8192,8268,-88,-12,28,2315040,8
1986,p1303,20120830,8192,8268,8192,8278,8192,8278,8234,10,-34,4,329400,8
1987,p1303,20120831,8278,8234,0,0,0,8234,8234,0,0,0,0,8
1988,p1303,20120903,8234,8234,8144,8144,8142,8142,8142,-92,-92,4,325720,8
1989,p1303,20120904,8142,8142,8316,8316,8270,8270,8300,128,158,30,2490480,28
1990,p1303,20120905,8270,8300,8254,8302,8232,8232,8262,-68,-38,34,2809080,26
1991,p1303,20120906,8232,8262,8148,8348,8148,8180,8238,-82,-24,28,2307120,22
1992,p1303,20120907,8180,8238,8144,8190,8106,8130,8152,-108,-86,28,2282600,18
1993,p1303,20120910,8130,8152,8112,8142,8112,8142,8126,-10,-26,4,325080,18
1994,p1303,20120911,8142,8126,8096,8096,8096,8096,8096,-30,-30,4,323840,18
1995,p1303,20120912,8096,8096,0,0,0,8096,8096,0,0,0,0,18
1996,p1303,20120913,8096,8096,8144,8202,8070,8070,8136,-26,40,20,1627280,24
1997,p1303,20120914,8070,8136,8208,8220,8208,8220,8216,84,80,6,492960,18
1998,p1303,20120917,8220,8216,0,0,0,8216,8216,0,0,0,0,18
1999,p1303,20120918,8216,8216,8136,8136,7888,7888,8046,-328,-170,88,7081520,18
2000,p1303,20120919,7888,8046,0,0,0,8046,8046,0,0,0,0,18
2001,p1303,20120920,8046,8046,0,0,0,8046,8046,0,0,0,0,18
2002,p1303,20120921,8046,8046,0,0,0,8046,8046,0,0,0,0,18
2003,p1303,20120924,8046,8046,0,0,0,8046,8046,0,0,0,0,18
2004,p1303,20120925,8046,8046,0,0,0,8046,8046,0,0,0,0,18
2005,p1303,20120926,8046,8046,7404,7472,7404,7472,7420,-574,-626,10,742080,18
2006,p1303,20120927,7472,7420,0,0,0,7420,7420,0,0,0,0,18
2007,p1303,20120928,7420,7420,7320,7380,7320,7380,7338,-40,-82,10,733880,18
2008,p1303,20121008,7380,7338,7224,7224,7158,7158,7192,-180,-146,8,575440,18
2009,p1303,20121009,7158,7192,7090,7090,7064,7064,7080,-128,-112,6,424880,18
2010,p1303,20121010,7064,7080,7156,7172,7156,7172,7164,92,84,4,286560,16
2011,p1303,20121011,7172,7164,7170,7170,7170,7170,7170,6,6,2,143400,16
2012,p1303,20121012,7170,7170,0,0,0,7170,7170,0,0,0,0,16
2013,p1303,20121015,7170,7170,7012,7030,6994,7030,7012,-140,-158,6,420720,16
2014,p1303,20121016,7030,7012,0,0,0,7012,7012,0,0,0,0,16
2015,p1303,20121017,7012,7012,0,0,0,7012,7012,0,0,0,0,16
2016,p1303,20121018,7012,7012,7178,7178,7128,7150,7152,138,140,14,1001360,16
2017,p1303,20121019,7150,7152,7138,7146,7126,7146,7136,-6,-16,28,1998360,22
2018,p1303,20121022,7146,7136,0,0,0,7136,7136,0,0,0,0,22
2019,p1303,20121023,7136,7136,7128,7128,7128,7128,7128,-8,-8,4,285120,26
2020,p1303,20121024,7128,7128,7090,7090,7072,7072,7088,-56,-40,38,2693840,60
2021,p1303,20121025,7072,7088,0,0,0,7088,7088,0,0,0,0,60
2022,p1303,20121026,7088,7088,0,0,0,7088,7088,0,0,0,0,60
2023,p1303,20121029,7088,7088,6932,6994,6926,6950,6946,-138,-142,70,4862800,18
2024,p1303,20121030,6950,6946,6920,6920,6852,6852,6894,-94,-52,18,1241000,10
2025,p1303,20121031,6852,6894,6864,6864,6864,6864,6864,-30,-30,4,274560,10
2026,p1303,20121101,6864,6864,0,0,0,6864,6864,0,0,0,0,10
2027,p1303,20121102,6864,6864,6896,6898,6822,6854,6858,-10,-6,10,685840,10
2028,p1303,20121105,6854,6858,6752,6752,6680,6680,6716,-178,-142,4,268640,8
2029,p1303,20121106,6680,6716,0,0,0,6716,6716,0,0,0,0,8
2030,p1303,20121107,6716,6716,0,0,0,6716,6716,0,0,0,0,8
2031,p1303,20121108,6716,6716,6820,6820,6604,6716,6726,0,10,8,538080,8
2032,p1303,20121109,6716,6726,0,0,0,6726,6726,0,0,0,0,8
2033,p1303,20121112,6726,6726,6458,6488,6458,6488,6464,-238,-262,30,1939200,26
2034,p1303,20121113,6488,6464,6650,6650,6470,6470,6558,6,94,112,7345600,52
2035,p1303,20121114,6470,6558,6420,6432,6370,6392,6404,-166,-154,118,7557520,106
2036,p1303,20121115,6392,6404,6386,6438,6386,6390,6410,-14,6,16,1025800,112
2037,p1303,20121116,6390,6410,0,0,0,6410,6410,0,0,0,0,112
2038,p1303,20121119,6410,6410,6332,6354,6288,6328,6326,-82,-84,162,10249560,240
2039,p1303,20121120,6328,6326,6440,6440,6382,6394,6402,68,76,8,512200,240
2040,p1303,20121121,6394,6402,6344,6364,6336,6364,6350,-38,-52,12,762200,238
2041,p1303,20121122,6364,6350,6324,6396,6324,6390,6374,40,24,12,764880,240
2042,p1303,20121123,6390,6374,6302,6350,6302,6344,6316,-30,-58,14,884440,242
2043,p1303,20121126,6344,6316,6422,6422,6382,6414,6416,98,100,86,5519240,238
2044,p1303,20121127,6414,6416,6392,6462,6392,6398,6402,-18,-14,26,1664800,236
2045,p1303,20121128,6398,6402,6444,6444,6344,6344,6364,-58,-38,24,1527600,246
2046,p1303,20121129,6344,6364,6362,6378,6362,6378,6366,14,2,8,509320,242
2047,p1303,20121130,6378,6366,6358,6358,6266,6330,6318,-36,-48,24,1516440,242
2048,p1303,20121203,6330,6318,6362,6430,6362,6410,6408,92,90,16,1025280,238
2049,p1303,20121204,6410,6408,6378,6396,6378,6396,6386,-12,-22,10,638720,240
2050,p1303,20121205,6396,6386,6400,6438,6400,6438,6424,52,38,14,899600,236
2051,p1303,20121206,6438,6424,6494,6494,6460,6480,6482,56,58,98,6353560,240
2052,p1303,20121207,6480,6482,6496,6496,6484,6484,6486,2,4,32,2075880,236
2053,p1303,20121210,6484,6486,6520,6520,6482,6482,6492,-4,6,30,1947680,236
2054,p1303,20121211,6482,6492,6444,6498,6444,6458,6464,-34,-28,46,2973520,242
2055,p1303,20121212,6458,6464,6338,6438,6338,6350,6374,-114,-90,44,2804800,254
2056,p1303,20121213,6350,6374,6368,6368,6356,6356,6360,-18,-14,6,381600,252
2057,p1303,20121214,6356,6360,6362,6404,6362,6404,6392,44,32,40,2556960,260
2058,p1303,20121217,6404,6392,6448,6488,6420,6462,6462,70,70,82,5299000,262
2059,p1303,20121218,6462,6462,6490,6506,6458,6490,6482,28,20,46,2982160,258
2060,p1303,20121219,6490,6482,6412,6488,6412,6482,6460,0,-22,86,5556000,258
2061,p1303,20121220,6482,6460,6410,6498,6350,6424,6412,-36,-48,156,10003720,286
2062,p1303,20121221,6424,6412,6490,6572,6464,6572,6536,160,124,30,1960920,274
2063,p1303,20121224,6572,6536,6622,6638,6542,6542,6584,6,48,58,3818800,278
2064,p1303,20121225,6542,6584,6520,6616,6520,6586,6594,2,10,18,1187040,270
2065,p1303,20121226,6586,6594,6642,6642,6584,6584,6602,-10,8,36,2377200,278
2066,p1303,20121227,6584,6602,6598,6704,6598,6692,6666,90,64,82,5467600,274
2067,p1303,20121228,6692,6666,6680,6688,6658,6658,6668,-8,2,12,800160,276
2068,p1303,20121231,6658,6668,6690,6698,6616,6616,6660,-52,-8,20,1332000,266
2069,p1304,20120420,8900,8900,0,0,0,8900,8900,0,0,0,0,0
2070,p1304,20120423,8900,8900,0,0,0,8900,8900,0,0,0,0,0
2071,p1304,20120424,8900,8900,0,0,0,8900,8900,0,0,0,0,0
2072,p1304,20120425,8900,8900,0,0,0,8900,8900,0,0,0,0,0
2073,p1304,20120426,8900,8900,0,0,0,8900,8900,0,0,0,0,0
2074,p1304,20120427,8900,8900,0,0,0,8900,8900,0,0,0,0,0
2075,p1304,20120502,8900,8900,0,0,0,8900,8900,0,0,0,0,0
2076,p1304,20120503,8900,8900,0,0,0,8900,8900,0,0,0,0,0
2077,p1304,20120504,8900,8900,0,0,0,8900,8900,0,0,0,0,0
2078,p1304,20120507,8900,8900,0,0,0,8900,8900,0,0,0,0,0
2079,p1304,20120508,8900,8900,0,0,0,8900,8900,0,0,0,0,0
2080,p1304,20120509,8900,8900,0,0,0,8900,8900,0,0,0,0,0
2081,p1304,20120510,8900,8900,0,0,0,8900,8900,0,0,0,0,0
2082,p1304,20120511,8900,8900,0,0,0,8900,8900,0,0,0,0,0
2083,p1304,20120514,8900,8900,0,0,0,8900,8900,0,0,0,0,0
2084,p1304,20120515,8900,8900,0,0,0,8900,8900,0,0,0,0,0
2085,p1304,20120516,8900,8900,8460,8460,8188,8200,8282,-700,-618,6,496960,0
2086,p1304,20120517,8200,8282,0,0,0,8282,8282,0,0,0,0,0
2087,p1304,20120518,8282,8282,0,0,0,8282,8282,0,0,0,0,0
2088,p1304,20120521,8282,8282,0,0,0,8282,8282,0,0,0,0,0
2089,p1304,20120522,8282,8282,0,0,0,8282,8282,0,0,0,0,0
2090,p1304,20120523,8282,8282,8194,8194,7976,8020,8062,-262,-220,6,483800,0
2091,p1304,20120524,8020,8062,0,0,0,8062,8062,0,0,0,0,0
2092,p1304,20120525,8062,8062,0,0,0,8062,8062,0,0,0,0,0
2093,p1304,20120528,8062,8062,0,0,0,8062,8062,0,0,0,0,0
2094,p1304,20120529,8062,8062,0,0,0,8062,8062,0,0,0,0,0
2095,p1304,20120530,8062,8062,0,0,0,8062,8062,0,0,0,0,0
2096,p1304,20120531,8062,8062,0,0,0,8062,8062,0,0,0,0,0
2097,p1304,20120601,8062,8062,0,0,0,8062,8062,0,0,0,0,0
2098,p1304,20120604,8062,8062,0,0,0,8062,8062,0,0,0,0,0
2099,p1304,20120605,8062,8062,0,0,0,8062,8062,0,0,0,0,0
2100,p1304,20120606,8062,8062,0,0,0,8062,8062,0,0,0,0,0
2101,p1304,20120607,8062,8062,0,0,0,8062,8062,0,0,0,0,0
2102,p1304,20120608,8062,8062,0,0,0,8062,8062,0,0,0,0,0
2103,p1304,20120611,8062,8062,0,0,0,8062,8062,0,0,0,0,0
2104,p1304,20120612,8062,8062,0,0,0,8062,8062,0,0,0,0,0
2105,p1304,20120613,8062,8062,0,0,0,8062,8062,0,0,0,0,0
2106,p1304,20120614,8062,8062,0,0,0,8062,8062,0,0,0,0,0
2107,p1304,20120615,8062,8062,0,0,0,8062,8062,0,0,0,0,0
2108,p1304,20120618,8062,8062,0,0,0,8062,8062,0,0,0,0,0
2109,p1304,20120619,8062,8062,7898,7944,7754,7850,7850,-212,-212,54,4239520,0
2110,p1304,20120620,7850,7850,7996,8020,7996,8020,8008,170,158,4,320320,0
2111,p1304,20120621,8020,8008,0,0,0,8008,8008,0,0,0,0,0
2112,p1304,20120625,8008,8008,7960,8140,7960,8140,8050,132,42,28,2254000,14
2113,p1304,20120626,8140,8050,8040,8040,8040,8040,8040,-10,-10,14,1125600,0
2114,p1304,20120627,8040,8040,0,0,0,8040,8040,0,0,0,0,0
2115,p1304,20120628,8040,8040,0,0,0,8040,8040,0,0,0,0,0
2116,p1304,20120629,8040,8040,7940,8060,7940,8060,8004,20,-36,10,800520,2
2117,p1304,20120702,8060,8004,0,0,0,8004,8004,0,0,0,0,2
2118,p1304,20120703,8004,8004,0,0,0,8004,8004,0,0,0,0,2
2119,p1304,20120704,8004,8004,0,0,0,8004,8004,0,0,0,0,2
2120,p1304,20120705,8004,8004,8240,8258,8240,8258,8252,254,248,6,495120,2
2121,p1304,20120706,8258,8252,0,0,0,8252,8252,0,0,0,0,2
2122,p1304,20120709,8252,8252,0,0,0,8252,8252,0,0,0,0,2
2123,p1304,20120710,8252,8252,0,0,0,8252,8252,0,0,0,0,2
2124,p1304,20120711,8252,8252,8270,8270,8266,8266,8268,14,16,4,330720,2
2125,p1304,20120712,8266,8268,0,0,0,8268,8268,0,0,0,0,2
2126,p1304,20120713,8268,8268,0,0,0,8268,8268,0,0,0,0,2
2127,p1304,20120716,8268,8268,0,0,0,8268,8268,0,0,0,0,2
2128,p1304,20120717,8268,8268,0,0,0,8268,8268,0,0,0,0,2
2129,p1304,20120718,8268,8268,0,0,0,8268,8268,0,0,0,0,2
2130,p1304,20120719,8268,8268,0,0,0,8268,8268,0,0,0,0,2
2131,p1304,20120720,8268,8268,0,0,0,8268,8268,0,0,0,0,2
2132,p1304,20120723,8268,8268,0,0,0,8268,8268,0,0,0,0,2
2133,p1304,20120724,8268,8268,7938,7938,7938,7938,7938,-330,-330,2,158760,2
2134,p1304,20120725,7938,7938,0,0,0,7938,7938,0,0,0,0,2
2135,p1304,20120726,7938,7938,0,0,0,7938,7938,0,0,0,0,2
2136,p1304,20120727,7938,7938,0,0,0,7938,7938,0,0,0,0,2
2137,p1304,20120730,7938,7938,0,0,0,7938,7938,0,0,0,0,2
2138,p1304,20120731,7938,7938,7796,7988,7796,7900,7894,-38,-44,6,473680,2
2139,p1304,20120801,7900,7894,0,0,0,7894,7894,0,0,0,0,2
2140,p1304,20120802,7894,7894,0,0,0,7894,7894,0,0,0,0,2
2141,p1304,20120803,7894,7894,0,0,0,7894,7894,0,0,0,0,2
2142,p1304,20120806,7894,7894,0,0,0,7894,7894,0,0,0,0,2
2143,p1304,20120807,7894,7894,0,0,0,7894,7894,0,0,0,0,2
2144,p1304,20120808,7894,7894,0,0,0,7894,7894,0,0,0,0,2
2145,p1304,20120809,7894,7894,0,0,0,7894,7894,0,0,0,0,2
2146,p1304,20120810,7894,7894,0,0,0,7894,7894,0,0,0,0,2
2147,p1304,20120813,7894,7894,0,0,0,7894,7894,0,0,0,0,2
2148,p1304,20120814,7894,7894,7770,7770,7770,7770,7770,-124,-124,2,155400,0
2149,p1304,20120815,7770,7770,0,0,0,7770,7770,0,0,0,0,0
2150,p1304,20120816,7770,7770,0,0,0,7770,7770,0,0,0,0,0
2151,p1304,20120817,7770,7770,0,0,0,7770,7770,0,0,0,0,0
2152,p1304,20120820,7770,7770,0,0,0,7770,7770,0,0,0,0,0
2153,p1304,20120821,7770,7770,0,0,0,7770,7770,0,0,0,0,0
2154,p1304,20120822,7770,7770,0,0,0,7770,7770,0,0,0,0,0
2155,p1304,20120823,7770,7770,0,0,0,7770,7770,0,0,0,0,0
2156,p1304,20120824,7770,7770,0,0,0,7770,7770,0,0,0,0,0
2157,p1304,20120827,7770,7770,0,0,0,7770,7770,0,0,0,0,0
2158,p1304,20120828,7770,7770,0,0,0,7770,7770,0,0,0,0,0
2159,p1304,20120829,7770,7770,0,0,0,7770,7770,0,0,0,0,0
2160,p1304,20120830,7770,7770,0,0,0,7770,7770,0,0,0,0,0
2161,p1304,20120831,7770,7770,8236,8236,8236,8236,8236,466,466,2,164720,2
2162,p1304,20120903,8236,8236,0,0,0,8236,8236,0,0,0,0,2
2163,p1304,20120904,8236,8236,0,0,0,8236,8236,0,0,0,0,2
2164,p1304,20120905,8236,8236,0,0,0,8236,8236,0,0,0,0,2
2165,p1304,20120906,8236,8236,0,0,0,8236,8236,0,0,0,0,2
2166,p1304,20120907,8236,8236,0,0,0,8236,8236,0,0,0,0,2
2167,p1304,20120910,8236,8236,8056,8056,8056,8056,8056,-180,-180,4,322240,6
2168,p1304,20120911,8056,8056,8116,8116,8050,8050,8088,-6,32,6,485360,2
2169,p1304,20120912,8050,8088,0,0,0,8088,8088,0,0,0,0,2
2170,p1304,20120913,8088,8088,0,0,0,8088,8088,0,0,0,0,2
2171,p1304,20120914,8088,8088,0,0,0,8088,8088,0,0,0,0,2
2172,p1304,20120917,8088,8088,0,0,0,8088,8088,0,0,0,0,2
2173,p1304,20120918,8088,8088,7876,7876,7876,7876,7876,-212,-212,2,157520,4
2174,p1304,20120919,7876,7876,7930,8178,7930,7940,8052,64,176,124,9985760,6
2175,p1304,20120920,7940,8052,0,0,0,8052,8052,0,0,0,0,6
2176,p1304,20120921,8052,8052,7870,7870,7870,7870,7870,-182,-182,2,157400,6
2177,p1304,20120924,7870,7870,7556,7556,7556,7556,7556,-314,-314,4,302240,8
2178,p1304,20120925,7556,7556,7524,7524,7422,7424,7456,-132,-100,38,2833960,8
2179,p1304,20120926,7424,7456,0,0,0,7456,7456,0,0,0,0,8
2180,p1304,20120927,7456,7456,7300,7366,7300,7352,7338,-104,-118,6,440360,6
2181,p1304,20120928,7352,7338,7254,7400,7254,7400,7366,62,28,10,736600,4
2182,p1304,20121008,7400,7366,7092,7200,7092,7200,7150,-166,-216,6,429080,2
2183,p1304,20121009,7200,7150,7078,7382,7078,7230,7228,80,78,56,4048320,2
2184,p1304,20121010,7230,7228,0,0,0,7228,7228,0,0,0,0,2
2185,p1304,20121011,7228,7228,0,0,0,7228,7228,0,0,0,0,2
2186,p1304,20121012,7228,7228,0,0,0,7228,7228,0,0,0,0,2
2187,p1304,20121015,7228,7228,0,0,0,7228,7228,0,0,0,0,2
2188,p1304,20121016,7228,7228,0,0,0,7228,7228,0,0,0,0,2
2189,p1304,20121017,7228,7228,0,0,0,7228,7228,0,0,0,0,2
2190,p1304,20121018,7228,7228,7130,7182,7130,7182,7156,-46,-72,4,286240,2
2191,p1304,20121019,7182,7156,0,0,0,7156,7156,0,0,0,0,2
2192,p1304,20121022,7156,7156,7286,7288,7130,7130,7208,-26,52,12,865000,8
2193,p1304,20121023,7130,7208,7230,7230,7204,7204,7220,-4,12,10,722000,2
2194,p1304,20121024,7204,7220,0,0,0,7220,7220,0,0,0,0,2
2195,p1304,20121025,7220,7220,7248,7248,7160,7160,7200,-60,-20,16,1152240,2
2196,p1304,20121026,7160,7200,0,0,0,7200,7200,0,0,0,0,2
2197,p1304,20121029,7200,7200,7094,7094,7010,7058,7042,-142,-158,8,563440,2
2198,p1304,20121030,7058,7042,0,0,0,7042,7042,0,0,0,0,2
2199,p1304,20121031,7042,7042,7042,7042,6928,7000,6990,-42,-52,12,838800,2
2200,p1304,20121101,7000,6990,0,0,0,6990,6990,0,0,0,0,2
2201,p1304,20121102,6990,6990,6992,6992,6800,6800,6898,-190,-92,14,965720,2
2202,p1304,20121105,6800,6898,6764,6848,6760,6760,6796,-138,-102,10,679640,2
2203,p1304,20121106,6760,6796,0,0,0,6796,6796,0,0,0,0,2
2204,p1304,20121107,6796,6796,6796,6796,6710,6740,6722,-56,-74,40,2689120,20
2205,p1304,20121108,6740,6722,6706,6754,6706,6744,6724,22,2,38,2555680,2
2206,p1304,20121109,6744,6724,6576,6576,6576,6576,6576,-148,-148,20,1315200,22
2207,p1304,20121112,6576,6576,6534,6638,6432,6460,6516,-116,-60,88,5734800,2
2208,p1304,20121113,6460,6516,0,0,0,6516,6516,0,0,0,0,2
2209,p1304,20121114,6516,6516,6588,6588,6480,6492,6510,-24,-6,90,5859400,80
2210,p1304,20121115,6492,6510,6568,6568,6502,6514,6540,4,30,108,7064480,164
2211,p1304,20121116,6514,6540,6512,6512,6512,6512,6512,-28,-28,4,260480,164
2212,p1304,20121119,6512,6512,6506,6530,6506,6530,6520,18,8,10,652080,162
2213,p1304,20121120,6530,6520,6504,6548,6504,6548,6526,28,6,4,261040,162
2214,p1304,20121121,6548,6526,6548,6550,6510,6520,6532,-6,6,34,2221520,162
2215,p1304,20121122,6520,6532,6532,6534,6530,6534,6532,2,0,8,522560,162
2216,p1304,20121123,6534,6532,6508,6542,6436,6512,6502,-20,-30,136,8845200,164
2217,p1304,20121126,6512,6502,6626,6626,6576,6580,6598,78,96,10,659800,164
2218,p1304,20121127,6580,6598,6602,6646,6602,6646,6624,48,26,4,264960,162
2219,p1304,20121128,6646,6624,6646,6646,6510,6510,6594,-114,-30,6,395680,162
2220,p1304,20121129,6510,6594,6480,6588,6476,6588,6504,-6,-90,48,3122200,190
2221,p1304,20121130,6588,6504,6558,6558,6494,6546,6502,42,-2,44,2861360,178
2222,p1304,20121203,6546,6502,6592,6648,6592,6636,6632,134,130,18,1194040,176
2223,p1304,20121204,6636,6632,0,0,0,6632,6632,0,0,0,0,176
2224,p1304,20121205,6632,6632,6616,6616,6616,6616,6616,-16,-16,2,132320,174
2225,p1304,20121206,6616,6616,6628,6628,6600,6600,6608,-16,-8,10,660960,164
2226,p1304,20121207,6600,6608,6622,6638,6576,6638,6606,30,-2,18,1189080,164
2227,p1304,20121210,6638,6606,6650,6696,6600,6642,6648,36,42,16,1063920,170
2228,p1304,20121211,6642,6648,6652,6704,6644,6644,6674,-4,26,262,17486400,204
2229,p1304,20121212,6644,6674,6528,6528,6528,6528,6528,-146,-146,2,130560,202
2230,p1304,20121213,6528,6528,6502,6502,6500,6500,6500,-28,-28,8,520040,194
2231,p1304,20121214,6500,6500,6550,6588,6550,6588,6566,88,66,16,1050720,192
2232,p1304,20121217,6588,6566,6592,6678,6592,6640,6654,74,88,36,2395440,198
2233,p1304,20121218,6640,6654,6642,6666,6636,6644,6650,-10,-4,16,1064080,192
2234,p1304,20121219,6644,6650,6580,6592,6560,6572,6574,-78,-76,66,4339520,190
2235,p1304,20121220,6572,6574,6512,6558,6490,6556,6522,-18,-52,34,2217960,188
2236,p1304,20121221,6556,6522,6560,6688,6538,6666,6618,144,96,76,5031160,182
2237,p1304,20121224,6666,6618,6722,6722,6644,6644,6692,26,74,78,5219800,208
2238,p1304,20121225,6644,6692,6668,6700,6646,6688,6676,-4,-16,34,2270400,208
2239,p1304,20121226,6688,6676,6700,6700,6700,6700,6700,24,24,4,268000,204
2240,p1304,20121227,6700,6700,6720,6812,6720,6756,6772,56,72,50,3386080,214
2241,p1304,20121228,6756,6772,6814,6996,6776,6800,6862,28,90,180,12352320,216
2242,p1304,20121231,6800,6862,6856,6856,6762,6764,6804,-98,-58,30,2041400,214
2243,p1305,20120517,8090,8216,8116,8144,8110,8128,8126,-88,-90,38,3087920,106
2244,p1305,20120518,8128,8126,8000,8050,7996,7996,8002,-130,-124,140,11205200,206
2245,p1305,20120521,7996,8002,8080,8146,8080,8120,8102,118,100,108,8751080,254
2246,p1305,20120522,8120,8102,8130,8150,8120,8148,8140,46,38,142,11559440,322
2247,p1305,20120523,8148,8140,8006,8036,7938,7940,7976,-200,-164,198,15795600,366
2248,p1305,20120524,7940,7976,7902,7960,7892,7960,7930,-16,-46,182,14433640,444
2249,p1305,20120525,7960,7930,7956,7988,7928,7988,7972,58,42,118,9408560,480
2250,p1305,20120528,7988,7972,8026,8082,8012,8078,8050,106,78,104,8373960,450
2251,p1305,20120529,8078,8050,8072,8114,8036,8112,8060,62,10,272,21927080,662
2252,p1305,20120530,8112,8060,8088,8088,8022,8050,8052,-10,-8,1044,84067480,1372
2253,p1305,20120531,8050,8052,7966,8024,7942,7968,8000,-84,-52,936,74891000,1616
2254,p1305,20120601,7968,8000,7960,7964,7878,7878,7938,-122,-62,1774,140828360,3262
2255,p1305,20120604,7878,7938,7840,7842,7648,7676,7724,-262,-214,614,47429920,3312
2256,p1305,20120605,7676,7724,7780,7826,7742,7806,7794,82,70,518,40374040,3500
2257,p1305,20120606,7806,7794,7806,7850,7782,7800,7820,6,26,3594,281092200,6064
2258,p1305,20120607,7800,7820,7866,7908,7822,7850,7874,30,54,534,42050520,6142
2259,p1305,20120608,7850,7874,7898,7898,7788,7820,7822,-54,-52,1142,89330440,6800
2260,p1305,20120611,7820,7822,7866,7980,7866,7980,7932,158,110,1342,106466200,7002
2261,p1305,20120612,7980,7932,7902,7904,7854,7882,7874,-50,-58,4416,347795320,10736
2262,p1305,20120613,7882,7874,7852,7902,7852,7856,7874,-18,0,1040,81907400,10774
2263,p1305,20120614,7856,7874,7822,7822,7662,7666,7712,-208,-162,992,76518320,10774
2264,p1305,20120615,7666,7712,7660,7720,7642,7680,7678,-32,-34,834,64040000,10988
2265,p1305,20120618,7680,7678,7782,7788,7716,7782,7764,104,86,948,73603640,11050
2266,p1305,20120619,7782,7764,7826,7874,7790,7834,7842,70,78,3442,269961440,12918
2267,p1305,20120620,7834,7842,7930,8046,7890,8032,7988,190,146,2156,172224400,13102
2268,p1305,20120621,8032,7988,7950,8006,7886,7938,7932,-50,-56,6578,521786640,16534
2269,p1305,20120625,7938,7932,8000,8116,7996,8012,8078,80,146,6056,489290360,18310
2270,p1305,20120626,8012,8078,8080,8080,7982,8012,8020,-66,-58,3672,294561040,18220
2271,p1305,20120627,8012,8020,8020,8044,7958,8020,8006,0,-14,5332,426939600,20298
2272,p1305,20120628,8020,8006,8050,8058,7970,7980,7996,-26,-10,4156,332376120,20732
2273,p1305,20120629,7980,7996,7940,8082,7940,8080,8026,84,30,4444,356702440,21006
2274,p1305,20120702,8080,8026,8218,8232,8122,8132,8154,106,128,5002,407900680,21194
2275,p1305,20120703,8132,8154,8152,8214,8138,8208,8182,54,28,4292,351195080,21264
2276,p1305,20120704,8208,8182,8210,8306,8210,8258,8260,76,78,7518,621089760,22124
2277,p1305,20120705,8258,8260,8280,8334,8236,8304,8286,44,26,5948,492895320,22324
2278,p1305,20120706,8304,8286,8320,8372,8284,8290,8332,4,46,6444,537033880,22478
2279,p1305,20120709,8290,8332,8306,8448,8258,8426,8364,94,32,8020,670842520,23380
2280,p1305,20120710,8426,8364,8398,8406,8320,8326,8372,-38,8,4362,365243960,23152
2281,p1305,20120711,8326,8372,8330,8414,8216,8270,8312,-102,-60,8094,672931320,22666
2282,p1305,20120712,8270,8312,8270,8270,8118,8126,8170,-186,-142,4414,360689240,22836
2283,p1305,20120713,8126,8170,8176,8214,8118,8214,8176,44,6,6938,567253680,20908
2284,p1305,20120716,8214,8176,8330,8450,8272,8444,8410,268,234,6398,538131160,21232
2285,p1305,20120717,8444,8410,8470,8480,8300,8356,8368,-54,-42,6236,521893800,20906
2286,p1305,20120718,8356,8368,8370,8384,8198,8218,8272,-150,-96,8306,687098240,21856
2287,p1305,20120719,8218,8272,8230,8280,8172,8200,8216,-72,-56,16122,1324781760,26118
2288,p1305,20120720,8200,8216,8220,8256,8142,8212,8186,-4,-30,17662,1445896040,29128
2289,p1305,20120723,8212,8186,8100,8136,7980,7986,8036,-200,-150,11656,936855760,30380
2290,p1305,20120724,7986,8036,7860,7860,7716,7798,7800,-238,-236,10050,783953320,31834
2291,p1305,20120725,7798,7800,7666,7846,7666,7772,7794,-28,-6,8762,683004960,32430
2292,p1305,20120726,7772,7794,7820,7868,7794,7834,7828,40,34,13350,1045249480,31340
2293,p1305,20120727,7834,7828,7802,7896,7798,7882,7850,54,22,11544,906319880,34854
2294,p1305,20120730,7882,7850,7946,8086,7930,7980,8014,130,164,23492,1882653560,35430
2295,p1305,20120731,7980,8014,7922,8020,7922,7994,7982,-20,-32,6368,508360040,35314
2296,p1305,20120801,7994,7982,7990,8054,7984,8000,8026,18,44,7432,596635640,36660
2297,p1305,20120802,8000,8026,7900,7954,7844,7910,7892,-116,-134,10270,810611080,38282
2298,p1305,20120803,7910,7892,7860,7914,7844,7884,7878,-8,-14,6472,509956080,39780
2299,p1305,20120806,7884,7878,7880,7938,7838,7920,7898,42,20,9614,759360280,42092
2300,p1305,20120807,7920,7898,7920,7996,7920,7966,7966,68,68,11834,942738480,42532
2301,p1305,20120808,7966,7966,7936,7944,7902,7908,7920,-58,-46,8136,644475640,43374
2302,p1305,20120809,7908,7920,7940,8008,7908,8000,7970,80,50,12034,959272960,44156
2303,p1305,20120810,8000,7970,8058,8058,7882,7900,7952,-70,-18,25906,2060467400,43460
2304,p1305,20120813,7900,7952,7960,7976,7886,7898,7936,-54,-16,11906,944933520,43680
2305,p1305,20120814,7898,7936,7900,7902,7770,7848,7840,-88,-96,21634,1696128440,46832
2306,p1305,20120815,7848,7840,7840,7894,7790,7872,7852,32,12,19782,1553422920,48466
2307,p1305,20120816,7872,7852,7888,7916,7850,7896,7886,44,34,12232,964813040,48952
2308,p1305,20120817,7896,7886,7922,8016,7918,7986,7986,100,100,26082,2082920560,52156
2309,p1305,20120820,7986,7986,7988,8012,7972,7986,7994,0,8,12938,1034473360,53950
2310,p1305,20120821,7986,7994,8020,8058,7982,8036,8026,42,32,15740,1263575960,54690
2311,p1305,20120822,8036,8026,8070,8252,8070,8246,8194,220,168,35892,2941638480,59876
2312,p1305,20120823,8246,8194,8270,8350,8252,8308,8308,114,114,36804,3058263520,63852
2313,p1305,20120824,8308,8308,8230,8446,8230,8444,8374,136,66,40174,3364577560,65640
2314,p1305,20120827,8444,8374,8480,8544,8450,8478,8488,104,114,44156,3748774520,70306
2315,p1305,20120828,8478,8488,8410,8458,8362,8374,8410,-114,-78,41946,3528427280,70426
2316,p1305,20120829,8374,8410,8376,8424,8274,8334,8350,-76,-60,57782,4824988280,80684
2317,p1305,20120830,8334,8350,8402,8420,8332,8396,8368,46,18,46106,3858808240,86078
2318,p1305,20120831,8396,8368,8360,8368,8242,8246,8286,-122,-82,47016,3896496840,88608
2319,p1305,20120903,8246,8286,8248,8450,8248,8408,8384,122,98,63218,5300216840,100164
2320,p1305,20120904,8408,8384,8420,8510,8388,8420,8432,36,48,57330,4834528240,108340
2321,p1305,20120905,8420,8432,8406,8476,8340,8390,8422,-42,-10,71054,5984856840,117022
2322,p1305,20120906,8390,8422,8300,8332,8248,8272,8290,-150,-132,52342,4339536240,117218
2323,p1305,20120907,8272,8290,8290,8320,8160,8162,8256,-128,-34,70412,5813451400,122600
2324,p1305,20120910,8162,8256,8152,8240,8144,8222,8202,-34,-54,46444,3809967280,124228
2325,p1305,20120911,8222,8202,8220,8260,8082,8112,8162,-90,-40,65520,5348000680,126252
2326,p1305,20120912,8112,8162,8110,8156,8090,8148,8124,-14,-38,40898,3322967400,126490
2327,p1305,20120913,8148,8124,8206,8228,8140,8146,8196,22,72,45386,3720030800,128836
2328,p1305,20120914,8146,8196,8230,8304,8224,8268,8258,72,62,63044,5206914200,137898
2329,p1305,20120917,8268,8258,8280,8320,8138,8142,8248,-116,-10,91988,7588013200,146740
2330,p1305,20120918,8142,8248,8060,8096,7930,7968,8018,-280,-230,90988,7297139280,153354
2331,p1305,20120919,7968,8018,8018,8056,7992,8014,8022,-4,4,58282,4675633920,158470
2332,p1305,20120920,8014,8022,8080,8080,7958,7960,8008,-62,-14,83574,6693919320,159334
2333,p1305,20120921,7960,8008,7918,7942,7834,7838,7882,-170,-126,82188,6479694720,160452
2334,p1305,20120924,7838,7882,7746,7770,7568,7568,7612,-314,-270,159654,12152867600,153250
2335,p1305,20120925,7568,7612,7572,7610,7458,7516,7526,-96,-86,168872,12711483960,162940
2336,p1305,20120926,7516,7526,7490,7560,7460,7472,7508,-54,-18,103536,7773641920,158722
2337,p1305,20120927,7472,7508,7340,7460,7340,7366,7394,-142,-114,104286,7711633920,150674
2338,p1305,20120928,7366,7394,7402,7462,7396,7422,7432,28,38,63254,4701391560,148402
2339,p1305,20121008,7422,7432,7198,7264,7128,7158,7198,-274,-234,94004,6766779320,160106
2340,p1305,20121009,7158,7198,7198,7322,7180,7288,7258,90,60,158936,11538623480,196160
2341,p1305,20121010,7288,7258,7252,7326,7228,7306,7284,48,26,150818,10986003160,228544
2342,p1305,20121011,7306,7284,7242,7334,7238,7290,7286,6,2,171274,12481416680,242602
2343,p1305,20121012,7290,7286,7316,7340,7182,7186,7264,-100,-22,199472,14493230040,242614
2344,p1305,20121015,7186,7264,7120,7144,7050,7114,7108,-150,-156,220540,15679980720,258268
2345,p1305,20121016,7114,7108,7150,7202,7142,7188,7174,80,66,138222,9916090720,264402
2346,p1305,20121017,7188,7174,7100,7200,7100,7154,7152,-20,-22,168738,12069499200,265878
2347,p1305,20121018,7154,7152,7190,7254,7170,7210,7226,58,74,177204,12806697640,270180
2348,p1305,20121019,7210,7226,7260,7280,7218,7218,7248,-8,22,186826,13544201120,287898
2349,p1305,20121022,7218,7248,7218,7258,7160,7254,7222,6,-26,211276,15260121880,293638
2350,p1305,20121023,7254,7222,7282,7320,7226,7236,7274,14,52,294152,21400300200,297276
2351,p1305,20121024,7236,7274,7278,7330,7250,7330,7294,56,20,285330,20817077160,326288
2352,p1305,20121025,7330,7294,7330,7350,7240,7242,7296,-52,2,295552,21564177520,332852
2353,p1305,20121026,7242,7296,7230,7280,7100,7134,7196,-162,-100,426548,30698715720,330104
2354,p1305,20121029,7134,7196,7100,7158,7060,7064,7114,-132,-82,319642,22742279600,338130
2355,p1305,20121030,7064,7114,7060,7094,6980,7012,7024,-102,-90,389154,27336469520,363774
2356,p1305,20121031,7012,7024,7012,7060,6950,7046,6996,22,-28,601068,42053746400,366636
2357,p1305,20121101,7046,6996,7024,7106,7024,7074,7072,78,76,331110,23416238320,353474
2358,p1305,20121102,7074,7072,7068,7092,6936,6962,7002,-110,-70,577100,40412909120,367382
2359,p1305,20121105,6962,7002,6880,6920,6764,6784,6842,-218,-160,507862,34752040760,396034
2360,p1305,20121106,6784,6842,6798,6888,6786,6838,6836,-4,-6,412430,28199214040,383406
2361,p1305,20121107,6838,6836,6836,6882,6762,6856,6832,20,-4,535064,36557816520,397388
2362,p1305,20121108,6856,6832,6806,6868,6780,6788,6820,-44,-12,437004,29809500960,409436
2363,p1305,20121109,6788,6820,6766,6794,6702,6708,6752,-112,-68,760706,51369992720,444098
2364,p1305,20121112,6708,6752,6608,6630,6482,6554,6542,-198,-210,735930,48154300240,459872
2365,p1305,20121113,6554,6542,6620,6696,6612,6650,6652,108,110,577820,38447101480,459342
2366,p1305,20121114,6650,6652,6690,6758,6630,6748,6702,96,50,639082,42842236800,468896
2367,p1305,20121115,6748,6702,6758,6838,6736,6750,6784,48,82,694378,47107940440,468262
2368,p1305,20121116,6750,6784,6766,6784,6662,6670,6714,-114,-70,595276,39974512080,459992
2369,p1305,20121119,6670,6714,6714,6782,6710,6772,6750,58,36,441270,29793304600,455326
2370,p1305,20121120,6772,6750,6800,6816,6710,6756,6758,6,8,698888,47232610320,442694
2371,p1305,20121121,6756,6758,6798,6798,6734,6782,6758,24,0,455950,30820060520,430888
2372,p1305,20121122,6782,6758,6798,6798,6744,6770,6762,12,4,398160,26924733520,413374
2373,p1305,20121123,6770,6762,6748,6766,6656,6762,6704,0,-58,822426,55143980000,427090
2374,p1305,20121126,6762,6704,6788,6836,6766,6816,6806,112,102,582850,39671152000,407806
2375,p1305,20121127,6816,6806,6828,6870,6794,6808,6838,2,32,518110,35430087320,389544
2376,p1305,20121128,6808,6838,6840,6860,6730,6740,6788,-98,-50,724406,49186846880,437422
2377,p1305,20121129,6740,6788,6766,6780,6702,6744,6736,-44,-52,649044,43720516360,428098
2378,p1305,20121130,6744,6736,6750,6760,6662,6756,6708,20,-28,802986,53871123840,416564
2379,p1305,20121203,6756,6708,6748,6880,6746,6840,6828,132,120,528054,36059458440,413284
2380,p1305,20121204,6840,6828,6788,6800,6728,6796,6764,-32,-64,645198,43649938920,427004
2381,p1305,20121205,6796,6764,6800,6846,6770,6836,6812,72,48,528584,36009503160,441980
2382,p1305,20121206,6836,6812,6876,6886,6790,6810,6844,-2,32,544898,37294614000,432766
2383,p1305,20121207,6810,6844,6820,6850,6784,6838,6822,-6,-22,430682,29383140480,423910
2384,p1305,20121210,6838,6822,6824,6900,6802,6860,6858,38,36,522018,35801973680,463040
2385,p1305,20121211,6860,6858,6872,6896,6788,6788,6848,-70,-10,823078,56369743480,517198
2386,p1305,20121212,6788,6848,6752,6774,6676,6678,6722,-170,-126,799746,53766328000,549440
2387,p1305,20121213,6678,6722,6688,6736,6664,6698,6702,-24,-20,603440,40451763320,547020
2388,p1305,20121214,6698,6702,6690,6798,6682,6788,6748,86,46,532150,35919012920,524096
2389,p1305,20121217,6788,6748,6810,6882,6796,6830,6836,82,88,548296,37488162320,537818
2390,p1305,20121218,6830,6836,6820,6864,6788,6812,6826,-24,-10,532656,36360145600,544682
2391,p1305,20121219,6812,6826,6766,6788,6728,6772,6756,-54,-70,403098,27237162040,524152
2392,p1305,20121220,6772,6756,6726,6756,6666,6738,6714,-18,-42,607584,40795873880,512770
2393,p1305,20121221,6738,6714,6740,6874,6706,6858,6800,144,86,868566,59077057280,528164
2394,p1305,20121224,6858,6800,6882,6946,6840,6842,6892,42,92,757034,52185786400,529710
2395,p1305,20121225,6842,6892,6854,6908,6810,6866,6860,-26,-32,646886,44378247600,535066
2396,p1305,20121226,6866,6860,6872,6930,6842,6870,6886,10,26,523820,36075481800,539964
2397,p1305,20121227,6870,6886,6860,7018,6848,7016,6942,130,56,941560,65376031600,599108
2398,p1305,20121228,7016,6942,7012,7026,6932,6964,6968,22,26,749854,52264714520,610112
2399,p1305,20121231,6964,6968,6980,7044,6916,6922,6986,-46,18,653958,45686105720,554520
2400,p1306,20120618,7872,7872,0,0,0,7872,7872,0,0,0,0,0
2401,p1306,20120619,7872,7872,0,0,0,7872,7872,0,0,0,0,0
2402,p1306,20120620,7872,7872,8110,8110,7918,8020,8016,148,144,30,2404800,2
2403,p1306,20120621,8020,8016,7976,7976,7976,7976,7976,-40,-40,2,159520,0
2404,p1306,20120625,7976,7976,0,0,0,7976,7976,0,0,0,0,0
2405,p1306,20120626,7976,7976,7914,8054,7914,8010,7990,34,14,30,2397000,2
2406,p1306,20120627,8010,7990,0,0,0,7990,7990,0,0,0,0,2
2407,p1306,20120628,7990,7990,8000,8000,8000,8000,8000,10,10,2,160000,0
2408,p1306,20120629,8000,8000,0,0,0,8000,8000,0,0,0,0,0
2409,p1306,20120702,8000,8000,0,0,0,8000,8000,0,0,0,0,0
2410,p1306,20120703,8000,8000,0,0,0,8000,8000,0,0,0,0,0
2411,p1306,20120704,8000,8000,0,0,0,8000,8000,0,0,0,0,0
2412,p1306,20120705,8000,8000,8306,8306,8306,8306,8306,306,306,4,332240,4
2413,p1306,20120706,8306,8306,0,0,0,8306,8306,0,0,0,0,4
2414,p1306,20120709,8306,8306,0,0,0,8306,8306,0,0,0,0,4
2415,p1306,20120710,8306,8306,0,0,0,8306,8306,0,0,0,0,4
2416,p1306,20120711,8306,8306,8374,8378,8372,8372,8374,66,68,10,837520,8
2417,p1306,20120712,8372,8374,0,0,0,8374,8374,0,0,0,0,8
2418,p1306,20120713,8374,8374,0,0,0,8374,8374,0,0,0,0,8
2419,p1306,20120716,8374,8374,0,0,0,8374,8374,0,0,0,0,8
2420,p1306,20120717,8374,8374,8386,8502,8386,8502,8404,128,30,24,2017360,16
2421,p1306,20120718,8502,8404,8348,8370,8330,8330,8354,-74,-50,8,668360,10
2422,p1306,20120719,8330,8354,8260,8260,8260,8260,8260,-94,-94,2,165200,8
2423,p1306,20120720,8260,8260,8286,8286,8286,8286,8286,26,26,6,497160,2
2424,p1306,20120723,8286,8286,0,0,0,8286,8286,0,0,0,0,2
2425,p1306,20120724,8286,8286,0,0,0,8286,8286,0,0,0,0,2
2426,p1306,20120725,8286,8286,7790,7790,7790,7790,7790,-496,-496,2,155800,4
2427,p1306,20120726,7790,7790,0,0,0,7790,7790,0,0,0,0,4
2428,p1306,20120727,7790,7790,7888,7928,7864,7900,7896,110,106,10,789600,4
2429,p1306,20120730,7900,7896,0,0,0,7896,7896,0,0,0,0,4
2430,p1306,20120731,7896,7896,8030,8030,8030,8030,8030,134,134,2,160600,2
2431,p1306,20120801,8030,8030,8086,8086,8086,8086,8086,56,56,2,161720,0
2432,p1306,20120802,8086,8086,0,0,0,8086,8086,0,0,0,0,0
2433,p1306,20120803,8086,8086,0,0,0,8086,8086,0,0,0,0,0
2434,p1306,20120806,8086,8086,0,0,0,8086,8086,0,0,0,0,0
2435,p1306,20120807,8086,8086,0,0,0,8086,8086,0,0,0,0,0
2436,p1306,20120808,8086,8086,0,0,0,8086,8086,0,0,0,0,0
2437,p1306,20120809,8086,8086,0,0,0,8086,8086,0,0,0,0,0
2438,p1306,20120810,8086,8086,0,0,0,8086,8086,0,0,0,0,0
2439,p1306,20120813,8086,8086,8096,8098,7876,7950,8008,-136,-78,22,1762000,4
2440,p1306,20120814,7950,8008,7834,7914,7834,7850,7864,-158,-144,16,1258480,2
2441,p1306,20120815,7850,7864,0,0,0,7864,7864,0,0,0,0,2
2442,p1306,20120816,7864,7864,0,0,0,7864,7864,0,0,0,0,2
2443,p1306,20120817,7864,7864,0,0,0,7864,7864,0,0,0,0,2
2444,p1306,20120820,7864,7864,0,0,0,7864,7864,0,0,0,0,2
2445,p1306,20120821,7864,7864,0,0,0,7864,7864,0,0,0,0,2
2446,p1306,20120822,7864,7864,0,0,0,7864,7864,0,0,0,0,2
2447,p1306,20120823,7864,7864,8334,8334,8334,8334,8334,470,470,26,2166840,20
2448,p1306,20120824,8334,8334,8332,8440,8322,8440,8358,106,24,32,2675080,18
2449,p1306,20120827,8440,8358,8478,8478,8478,8478,8478,120,120,4,339120,22
2450,p1306,20120828,8478,8478,8476,8476,8454,8454,8462,-24,-16,6,507800,20
2451,p1306,20120829,8454,8462,8410,8410,8370,8370,8388,-92,-74,10,838920,14
2452,p1306,20120830,8370,8388,0,0,0,8388,8388,0,0,0,0,14
2453,p1306,20120831,8388,8388,8330,8330,8330,8330,8330,-58,-58,2,166600,12
2454,p1306,20120903,8330,8330,0,0,0,8330,8330,0,0,0,0,12
2455,p1306,20120904,8330,8330,0,0,0,8330,8330,0,0,0,0,12
2456,p1306,20120905,8330,8330,0,0,0,8330,8330,0,0,0,0,12
2457,p1306,20120906,8330,8330,0,0,0,8330,8330,0,0,0,0,12
2458,p1306,20120907,8330,8330,0,0,0,8330,8330,0,0,0,0,12
2459,p1306,20120910,8330,8330,0,0,0,8330,8330,0,0,0,0,12
2460,p1306,20120911,8330,8330,0,0,0,8330,8330,0,0,0,0,12
2461,p1306,20120912,8330,8330,8104,8148,8104,8148,8132,-182,-198,6,488000,10
2462,p1306,20120913,8148,8132,0,0,0,8132,8132,0,0,0,0,10
2463,p1306,20120914,8132,8132,0,0,0,8132,8132,0,0,0,0,10
2464,p1306,20120917,8132,8132,0,0,0,8132,8132,0,0,0,0,10
2465,p1306,20120918,8132,8132,8054,8054,8054,8054,8054,-78,-78,2,161080,10
2466,p1306,20120919,8054,8054,8070,8070,8070,8070,8070,16,16,2,161400,8
2467,p1306,20120920,8070,8070,0,0,0,8070,8070,0,0,0,0,8
2468,p1306,20120921,8070,8070,0,0,0,8070,8070,0,0,0,0,8
2469,p1306,20120924,8070,8070,0,0,0,8070,8070,0,0,0,0,8
2470,p1306,20120925,8070,8070,0,0,0,8070,8070,0,0,0,0,8
2471,p1306,20120926,8070,8070,0,0,0,8070,8070,0,0,0,0,8
2472,p1306,20120927,8070,8070,7748,7748,7748,7748,7748,-322,-322,40,3099200,42
2473,p1306,20120928,7748,7748,7490,7524,7476,7486,7492,-262,-256,30,2247680,32
2474,p1306,20121008,7486,7492,7274,7274,7274,7274,7274,-218,-218,2,145480,32
2475,p1306,20121009,7274,7274,0,0,0,7274,7274,0,0,0,0,32
2476,p1306,20121010,7274,7274,7344,7380,7344,7352,7360,78,86,10,736160,32
2477,p1306,20121011,7352,7360,7420,7420,7318,7352,7358,-8,-2,12,883040,32
2478,p1306,20121012,7352,7358,0,0,0,7358,7358,0,0,0,0,32
2479,p1306,20121015,7358,7358,0,0,0,7358,7358,0,0,0,0,32
2480,p1306,20121016,7358,7358,0,0,0,7358,7358,0,0,0,0,32
2481,p1306,20121017,7358,7358,7218,7218,7218,7218,7218,-140,-140,2,144360,32
2482,p1306,20121018,7218,7218,0,0,0,7218,7218,0,0,0,0,32
2483,p1306,20121019,7218,7218,0,0,0,7218,7218,0,0,0,0,32
2484,p1306,20121022,7218,7218,7260,7260,7260,7260,7260,42,42,2,145200,32
2485,p1306,20121023,7260,7260,0,0,0,7260,7260,0,0,0,0,32
2486,p1306,20121024,7260,7260,7384,7384,7334,7352,7356,92,96,22,1618560,32
2487,p1306,20121025,7352,7356,0,0,0,7356,7356,0,0,0,0,32
2488,p1306,20121026,7356,7356,0,0,0,7356,7356,0,0,0,0,32
2489,p1306,20121029,7356,7356,7356,7356,7196,7228,7252,-128,-104,22,1595840,32
2490,p1306,20121030,7228,7252,0,0,0,7252,7252,0,0,0,0,32
2491,p1306,20121031,7252,7252,7166,7166,7074,7100,7112,-152,-140,6,426800,32
2492,p1306,20121101,7100,7112,0,0,0,7112,7112,0,0,0,0,32
2493,p1306,20121102,7112,7112,7164,7164,7044,7044,7112,-68,0,42,2987040,34
2494,p1306,20121105,7044,7112,6978,6980,6976,6976,6976,-136,-136,14,976840,34
2495,p1306,20121106,6976,6976,6912,6950,6872,6920,6916,-56,-60,78,5395720,20
2496,p1306,20121107,6920,6916,6898,6996,6852,6930,6896,14,-20,34,2345120,12
2497,p1306,20121108,6930,6896,6840,6980,6840,6980,6852,84,-44,50,3426360,48
2498,p1306,20121109,6980,6852,6850,6878,6750,6800,6812,-52,-40,90,6131200,20
2499,p1306,20121112,6800,6812,6780,6780,6568,6702,6648,-110,-164,76,5053760,14
2500,p1306,20121113,6702,6648,6702,6748,6702,6748,6724,100,76,8,538000,16
2501,p1306,20121114,6748,6724,6772,6790,6740,6770,6766,46,42,68,4601760,48
2502,p1306,20121115,6770,6766,6856,6856,6756,6756,6820,-10,54,20,1364320,52
2503,p1306,20121116,6756,6820,6704,6838,6704,6760,6750,-60,-70,68,4590200,16
2504,p1306,20121119,6760,6750,6814,6814,6814,6814,6814,64,64,12,817680,22
2505,p1306,20121120,6814,6814,6826,6826,6790,6808,6808,-6,-6,6,408480,20
2506,p1306,20121121,6808,6808,6790,6840,6790,6814,6810,6,2,32,2179480,24
2507,p1306,20121122,6814,6810,6790,6854,6790,6802,6814,-8,4,18,1226840,24
2508,p1306,20121123,6802,6814,6780,6790,6710,6790,6758,-24,-56,160,10814360,36
2509,p1306,20121126,6790,6758,6840,6860,6820,6830,6830,72,72,24,1639640,50
2510,p1306,20121127,6830,6830,6854,6918,6854,6870,6888,40,58,36,2480320,40
2511,p1306,20121128,6870,6888,6812,6858,6804,6808,6830,-80,-58,30,2049560,36
2512,p1306,20121129,6808,6830,6784,6818,6784,6818,6806,-12,-24,8,544600,34
2513,p1306,20121130,6818,6806,6752,6812,6752,6782,6778,-24,-28,14,948920,28
2514,p1306,20121203,6782,6778,6834,6882,6834,6862,6858,84,80,36,2469400,30
2515,p1306,20121204,6862,6858,6828,6828,6800,6818,6814,-40,-44,18,1226760,34
2516,p1306,20121205,6818,6814,6848,6852,6848,6852,6850,38,36,8,548000,34
2517,p1306,20121206,6852,6850,0,0,0,6850,6850,0,0,0,0,34
2518,p1306,20121207,6850,6850,6834,6862,6834,6862,6848,12,-2,10,684800,34
2519,p1306,20121210,6862,6848,6890,6890,6890,6890,6890,42,42,14,964600,30
2520,p1306,20121211,6890,6890,6880,6880,6828,6830,6844,-60,-46,14,958160,20
2521,p1306,20121212,6830,6844,6718,6718,6718,6718,6718,-126,-126,26,1746680,40
2522,p1306,20121213,6718,6718,6778,6778,6698,6716,6732,-2,14,94,6329200,44
2523,p1306,20121214,6716,6732,6730,6826,6730,6826,6796,94,64,38,2583160,40
2524,p1306,20121217,6826,6796,6760,6890,6760,6880,6870,84,74,210,14429080,158
2525,p1306,20121218,6880,6870,6884,7018,6870,6872,6928,2,58,56,3880640,158
2526,p1306,20121219,6872,6928,6854,6854,6804,6842,6834,-86,-94,8,546760,158
2527,p1306,20121220,6842,6834,6828,6860,6776,6824,6800,-10,-34,142,9656840,162
2528,p1306,20121221,6824,6800,6858,6974,6848,6974,6890,174,90,94,6478000,150
2529,p1306,20121224,6974,6890,6968,6998,6946,6974,6982,84,92,24,1675680,150
2530,p1306,20121225,6974,6982,6946,7002,6946,7002,6982,20,0,24,1676080,150
2531,p1306,20121226,7002,6982,7020,7048,7000,7000,7020,18,38,24,1685120,160
2532,p1306,20121227,7000,7020,6894,7146,6890,7146,7054,126,34,88,6208200,148
2533,p1306,20121228,7146,7054,7144,7144,7110,7138,7132,84,78,76,5421480,148
2534,p1306,20121231,7138,7132,7166,7228,6984,7086,7094,-46,-38,148,10501160,148
2535,p1307,20120717,8170,8170,8396,8398,8390,8390,8394,220,224,24,2014640,0
2536,p1307,20120718,8390,8394,0,0,0,8394,8394,0,0,0,0,0
2537,p1307,20120719,8394,8394,0,0,0,8394,8394,0,0,0,0,0
2538,p1307,20120720,8394,8394,0,0,0,8394,8394,0,0,0,0,0
2539,p1307,20120723,8394,8394,0,0,0,8394,8394,0,0,0,0,0
2540,p1307,20120724,8394,8394,0,0,0,8394,8394,0,0,0,0,0
2541,p1307,20120725,8394,8394,0,0,0,8394,8394,0,0,0,0,0
2542,p1307,20120726,8394,8394,0,0,0,8394,8394,0,0,0,0,0
2543,p1307,20120727,8394,8394,0,0,0,8394,8394,0,0,0,0,0
2544,p1307,20120730,8394,8394,8060,8060,8060,8060,8060,-334,-334,2,161200,2
2545,p1307,20120731,8060,8060,0,0,0,8060,8060,0,0,0,0,2
2546,p1307,20120801,8060,8060,0,0,0,8060,8060,0,0,0,0,2
2547,p1307,20120802,8060,8060,0,0,0,8060,8060,0,0,0,0,2
2548,p1307,20120803,8060,8060,0,0,0,8060,8060,0,0,0,0,2
2549,p1307,20120806,8060,8060,0,0,0,8060,8060,0,0,0,0,2
2550,p1307,20120807,8060,8060,0,0,0,8060,8060,0,0,0,0,2
2551,p1307,20120808,8060,8060,0,0,0,8060,8060,0,0,0,0,2
2552,p1307,20120809,8060,8060,7852,8216,7852,8010,8026,-50,-34,32,2568480,6
2553,p1307,20120810,8010,8026,8020,8064,7956,8030,8012,4,-14,92,7372600,0
2554,p1307,20120813,8030,8012,0,0,0,8012,8012,0,0,0,0,0
2555,p1307,20120814,8012,8012,0,0,0,8012,8012,0,0,0,0,0
2556,p1307,20120815,8012,8012,0,0,0,8012,8012,0,0,0,0,0
2557,p1307,20120816,8012,8012,0,0,0,8012,8012,0,0,0,0,0
2558,p1307,20120817,8012,8012,0,0,0,8012,8012,0,0,0,0,0
2559,p1307,20120820,8012,8012,0,0,0,8012,8012,0,0,0,0,0
2560,p1307,20120821,8012,8012,0,0,0,8012,8012,0,0,0,0,0
2561,p1307,20120822,8012,8012,0,0,0,8012,8012,0,0,0,0,0
2562,p1307,20120823,8012,8012,8332,8332,8332,8332,8332,320,320,2,166640,2
2563,p1307,20120824,8332,8332,0,0,0,8332,8332,0,0,0,0,2
2564,p1307,20120827,8332,8332,0,0,0,8332,8332,0,0,0,0,2
2565,p1307,20120828,8332,8332,0,0,0,8332,8332,0,0,0,0,2
2566,p1307,20120829,8332,8332,0,0,0,8332,8332,0,0,0,0,2
2567,p1307,20120830,8332,8332,0,0,0,8332,8332,0,0,0,0,2
2568,p1307,20120831,8332,8332,0,0,0,8332,8332,0,0,0,0,2
2569,p1307,20120903,8332,8332,0,0,0,8332,8332,0,0,0,0,2
2570,p1307,20120904,8332,8332,0,0,0,8332,8332,0,0,0,0,2
2571,p1307,20120905,8332,8332,0,0,0,8332,8332,0,0,0,0,2
2572,p1307,20120906,8332,8332,0,0,0,8332,8332,0,0,0,0,2
2573,p1307,20120907,8332,8332,0,0,0,8332,8332,0,0,0,0,2
2574,p1307,20120910,8332,8332,0,0,0,8332,8332,0,0,0,0,2
2575,p1307,20120911,8332,8332,0,0,0,8332,8332,0,0,0,0,2
2576,p1307,20120912,8332,8332,0,0,0,8332,8332,0,0,0,0,2
2577,p1307,20120913,8332,8332,8450,8450,8250,8250,8350,-82,18,4,334000,2
2578,p1307,20120914,8250,8350,0,0,0,8350,8350,0,0,0,0,2
2579,p1307,20120917,8350,8350,0,0,0,8350,8350,0,0,0,0,2
2580,p1307,20120918,8350,8350,0,0,0,8350,8350,0,0,0,0,2
2581,p1307,20120919,8350,8350,8050,8050,8050,8050,8050,-300,-300,2,161000,0
2582,p1307,20120920,8050,8050,0,0,0,8050,8050,0,0,0,0,0
2583,p1307,20120921,8050,8050,0,0,0,8050,8050,0,0,0,0,0
2584,p1307,20120924,8050,8050,0,0,0,8050,8050,0,0,0,0,0
2585,p1307,20120925,8050,8050,0,0,0,8050,8050,0,0,0,0,0
2586,p1307,20120926,8050,8050,0,0,0,8050,8050,0,0,0,0,0
2587,p1307,20120927,8050,8050,0,0,0,8050,8050,0,0,0,0,0
2588,p1307,20120928,8050,8050,0,0,0,8050,8050,0,0,0,0,0
2589,p1307,20121008,8050,8050,0,0,0,8050,8050,0,0,0,0,0
2590,p1307,20121009,8050,8050,7488,7488,7488,7488,7488,-562,-562,6,449280,6
2591,p1307,20121010,7488,7488,7176,7380,7176,7250,7300,-238,-188,14,1022040,6
2592,p1307,20121011,7250,7300,0,0,0,7300,7300,0,0,0,0,6
2593,p1307,20121012,7300,7300,7376,7376,7278,7278,7320,-22,20,8,585640,8
2594,p1307,20121015,7278,7320,7160,7172,7160,7172,7168,-148,-152,6,430080,4
2595,p1307,20121016,7172,7168,0,0,0,7168,7168,0,0,0,0,4
2596,p1307,20121017,7168,7168,0,0,0,7168,7168,0,0,0,0,4
2597,p1307,20121018,7168,7168,0,0,0,7168,7168,0,0,0,0,4
2598,p1307,20121019,7168,7168,7328,7328,7288,7288,7308,120,140,4,292320,6
2599,p1307,20121022,7288,7308,0,0,0,7308,7308,0,0,0,0,6
2600,p1307,20121023,7308,7308,0,0,0,7308,7308,0,0,0,0,6
2601,p1307,20121024,7308,7308,0,0,0,7308,7308,0,0,0,0,6
2602,p1307,20121025,7308,7308,0,0,0,7308,7308,0,0,0,0,6
2603,p1307,20121026,7308,7308,7194,7194,7190,7190,7192,-118,-116,4,287680,4
2604,p1307,20121029,7190,7192,7192,7234,7192,7234,7206,42,14,6,432360,6
2605,p1307,20121030,7234,7206,0,0,0,7206,7206,0,0,0,0,6
2606,p1307,20121031,7206,7206,6952,7082,6952,7060,7030,-146,-176,78,5484640,6
2607,p1307,20121101,7060,7030,7044,7168,7044,7140,7116,110,86,6,427040,6
2608,p1307,20121102,7140,7116,0,0,0,7116,7116,0,0,0,0,6
2609,p1307,20121105,7116,7116,7006,7006,7006,7006,7006,-110,-110,2,140120,6
2610,p1307,20121106,7006,7006,0,0,0,7006,7006,0,0,0,0,6
2611,p1307,20121107,7006,7006,0,0,0,7006,7006,0,0,0,0,6
2612,p1307,20121108,7006,7006,0,0,0,7006,7006,0,0,0,0,6
2613,p1307,20121109,7006,7006,6740,6740,6740,6740,6740,-266,-266,6,404400,12
2614,p1307,20121112,6740,6740,6738,6738,6738,6738,6738,-2,-2,6,404280,6
2615,p1307,20121113,6738,6738,0,0,0,6738,6738,0,0,0,0,6
2616,p1307,20121114,6738,6738,0,0,0,6738,6738,0,0,0,0,6
2617,p1307,20121115,6738,6738,6868,6868,6868,6868,6868,130,130,2,137360,4
2618,p1307,20121116,6868,6868,0,0,0,6868,6868,0,0,0,0,4
2619,p1307,20121119,6868,6868,0,0,0,6868,6868,0,0,0,0,4
2620,p1307,20121120,6868,6868,0,0,0,6868,6868,0,0,0,0,4
2621,p1307,20121121,6868,6868,0,0,0,6868,6868,0,0,0,0,4
2622,p1307,20121122,6868,6868,6886,6886,6844,6862,6864,-6,-4,12,823880,6
2623,p1307,20121123,6862,6864,6840,6840,6840,6840,6840,-24,-24,2,136800,6
2624,p1307,20121126,6840,6840,0,0,0,6840,6840,0,0,0,0,6
2625,p1307,20121127,6840,6840,6918,6984,6918,6984,6950,144,110,4,278040,6
2626,p1307,20121128,6984,6950,0,0,0,6950,6950,0,0,0,0,6
2627,p1307,20121129,6950,6950,0,0,0,6950,6950,0,0,0,0,6
2628,p1307,20121130,6950,6950,0,0,0,6950,6950,0,0,0,0,6
2629,p1307,20121203,6950,6950,6960,6960,6960,6960,6960,10,10,4,278400,10
2630,p1307,20121204,6960,6960,6860,6870,6830,6830,6852,-130,-108,6,411200,10
2631,p1307,20121205,6830,6852,6890,6890,6868,6868,6878,16,26,4,275160,10
2632,p1307,20121206,6868,6878,6960,6960,6960,6960,6960,82,82,2,139200,12
2633,p1307,20121207,6960,6960,7008,7008,6820,6910,6912,-50,-48,12,829520,12
2634,p1307,20121210,6910,6912,0,0,0,6912,6912,0,0,0,0,12
2635,p1307,20121211,6912,6912,0,0,0,6912,6912,0,0,0,0,12
2636,p1307,20121212,6912,6912,0,0,0,6912,6912,0,0,0,0,12
2637,p1307,20121213,6912,6912,6788,6788,6788,6788,6788,-124,-124,4,271520,12
2638,p1307,20121214,6788,6788,6836,6836,6836,6836,6836,48,48,2,136720,10
2639,p1307,20121217,6836,6836,0,0,0,6836,6836,0,0,0,0,10
2640,p1307,20121218,6836,6836,0,0,0,6836,6836,0,0,0,0,10
2641,p1307,20121219,6836,6836,0,0,0,6836,6836,0,0,0,0,10
2642,p1307,20121220,6836,6836,6814,6818,6812,6818,6814,-18,-22,6,408880,10
2643,p1307,20121221,6818,6814,0,0,0,6814,6814,0,0,0,0,10
2644,p1307,20121224,6814,6814,7028,7066,7026,7034,7036,220,222,12,844320,8
2645,p1307,20121225,7034,7036,0,0,0,7036,7036,0,0,0,0,8
2646,p1307,20121226,7036,7036,6978,6978,6976,6976,6976,-60,-60,6,418600,2
2647,p1307,20121227,6976,6976,0,0,0,6976,6976,0,0,0,0,2
2648,p1307,20121228,6976,6976,7062,7128,7062,7070,7070,94,94,98,6930520,16
2649,p1307,20121231,7070,7070,7200,7200,7102,7104,7134,34,64,6,428120,18
2650,p1308,20120816,7936,7936,0,0,0,7936,7936,0,0,0,0,0
2651,p1308,20120817,7936,7936,0,0,0,7936,7936,0,0,0,0,0
2652,p1308,20120820,7936,7936,0,0,0,7936,7936,0,0,0,0,0
2653,p1308,20120821,7936,7936,0,0,0,7936,7936,0,0,0,0,0
2654,p1308,20120822,7936,7936,0,0,0,7936,7936,0,0,0,0,0
2655,p1308,20120823,7936,7936,0,0,0,7936,7936,0,0,0,0,0
2656,p1308,20120824,7936,7936,0,0,0,7936,7936,0,0,0,0,0
2657,p1308,20120827,7936,7936,0,0,0,7936,7936,0,0,0,0,0
2658,p1308,20120828,7936,7936,0,0,0,7936,7936,0,0,0,0,0
2659,p1308,20120829,7936,7936,0,0,0,7936,7936,0,0,0,0,0
2660,p1308,20120830,7936,7936,0,0,0,7936,7936,0,0,0,0,0
2661,p1308,20120831,7936,7936,0,0,0,7936,7936,0,0,0,0,0
2662,p1308,20120903,7936,7936,0,0,0,7936,7936,0,0,0,0,0
2663,p1308,20120904,7936,7936,0,0,0,7936,7936,0,0,0,0,0
2664,p1308,20120905,7936,7936,0,0,0,7936,7936,0,0,0,0,0
2665,p1308,20120906,7936,7936,0,0,0,7936,7936,0,0,0,0,0
2666,p1308,20120907,7936,7936,0,0,0,7936,7936,0,0,0,0,0
2667,p1308,20120910,7936,7936,0,0,0,7936,7936,0,0,0,0,0
2668,p1308,20120911,7936,7936,8118,8494,8112,8246,8256,310,320,14,1156000,2
2669,p1308,20120912,8246,8256,8200,8200,8200,8200,8200,-56,-56,2,164000,0
2670,p1308,20120913,8200,8200,0,0,0,8200,8200,0,0,0,0,0
2671,p1308,20120914,8200,8200,0,0,0,8200,8200,0,0,0,0,0
2672,p1308,20120917,8200,8200,0,0,0,8200,8200,0,0,0,0,0
2673,p1308,20120918,8200,8200,0,0,0,8200,8200,0,0,0,0,0
2674,p1308,20120919,8200,8200,8342,8342,8040,8100,8160,-100,-40,6,489640,0
2675,p1308,20120920,8100,8160,0,0,0,8160,8160,0,0,0,0,0
2676,p1308,20120921,8160,8160,0,0,0,8160,8160,0,0,0,0,0
2677,p1308,20120924,8160,8160,0,0,0,8160,8160,0,0,0,0,0
2678,p1308,20120925,8160,8160,0,0,0,8160,8160,0,0,0,0,0
2679,p1308,20120926,8160,8160,0,0,0,8160,8160,0,0,0,0,0
2680,p1308,20120927,8160,8160,0,0,0,8160,8160,0,0,0,0,0
2681,p1308,20120928,8160,8160,7508,7508,7508,7508,7508,-652,-652,2,150160,2
2682,p1308,20121008,7508,7508,0,0,0,7508,7508,0,0,0,0,2
2683,p1308,20121009,7508,7508,0,0,0,7508,7508,0,0,0,0,2
2684,p1308,20121010,7508,7508,7208,7434,7208,7342,7318,-166,-190,18,1317400,2
2685,p1308,20121011,7342,7318,7328,7380,7280,7380,7328,62,10,6,439760,2
2686,p1308,20121012,7380,7328,0,0,0,7328,7328,0,0,0,0,2
2687,p1308,20121015,7328,7328,7058,7210,7058,7180,7156,-148,-172,58,4150720,0
2688,p1308,20121016,7180,7156,0,0,0,7156,7156,0,0,0,0,0
2689,p1308,20121017,7156,7156,0,0,0,7156,7156,0,0,0,0,0
2690,p1308,20121018,7156,7156,0,0,0,7156,7156,0,0,0,0,0
2691,p1308,20121019,7156,7156,0,0,0,7156,7156,0,0,0,0,0
2692,p1308,20121022,7156,7156,0,0,0,7156,7156,0,0,0,0,0
2693,p1308,20121023,7156,7156,0,0,0,7156,7156,0,0,0,0,0
2694,p1308,20121024,7156,7156,0,0,0,7156,7156,0,0,0,0,0
2695,p1308,20121025,7156,7156,0,0,0,7156,7156,0,0,0,0,0
2696,p1308,20121026,7156,7156,0,0,0,7156,7156,0,0,0,0,0
2697,p1308,20121029,7156,7156,7150,7370,7150,7206,7242,50,86,6,434520,0
2698,p1308,20121030,7206,7242,0,0,0,7242,7242,0,0,0,0,0
2699,p1308,20121031,7242,7242,0,0,0,7242,7242,0,0,0,0,0
2700,p1308,20121101,7242,7242,0,0,0,7242,7242,0,0,0,0,0
2701,p1308,20121102,7242,7242,0,0,0,7242,7242,0,0,0,0,0
2702,p1308,20121105,7242,7242,0,0,0,7242,7242,0,0,0,0,0
2703,p1308,20121106,7242,7242,0,0,0,7242,7242,0,0,0,0,0
2704,p1308,20121107,7242,7242,0,0,0,7242,7242,0,0,0,0,0
2705,p1308,20121108,7242,7242,0,0,0,7242,7242,0,0,0,0,0
2706,p1308,20121109,7242,7242,0,0,0,7242,7242,0,0,0,0,0
2707,p1308,20121112,7242,7242,0,0,0,7242,7242,0,0,0,0,0
2708,p1308,20121113,7242,7242,0,0,0,7242,7242,0,0,0,0,0
2709,p1308,20121114,7242,7242,0,0,0,7242,7242,0,0,0,0,0
2710,p1308,20121115,7242,7242,0,0,0,7242,7242,0,0,0,0,0
2711,p1308,20121116,7242,7242,0,0,0,7242,7242,0,0,0,0,0
2712,p1308,20121119,7242,7242,0,0,0,7242,7242,0,0,0,0,0
2713,p1308,20121120,7242,7242,0,0,0,7242,7242,0,0,0,0,0
2714,p1308,20121121,7242,7242,0,0,0,7242,7242,0,0,0,0,0
2715,p1308,20121122,7242,7242,0,0,0,7242,7242,0,0,0,0,0
2716,p1308,20121123,7242,7242,0,0,0,7242,7242,0,0,0,0,0
2717,p1308,20121126,7242,7242,7088,7088,6912,6912,7000,-330,-242,4,280000,0
2718,p1308,20121127,6912,7000,0,0,0,7000,7000,0,0,0,0,0
2719,p1308,20121128,7000,7000,0,0,0,7000,7000,0,0,0,0,0
2720,p1308,20121129,7000,7000,0,0,0,7000,7000,0,0,0,0,0
2721,p1308,20121130,7000,7000,0,0,0,7000,7000,0,0,0,0,0
2722,p1308,20121203,7000,7000,0,0,0,7000,7000,0,0,0,0,0
2723,p1308,20121204,7000,7000,0,0,0,7000,7000,0,0,0,0,0
2724,p1308,20121205,7000,7000,0,0,0,7000,7000,0,0,0,0,0
2725,p1308,20121206,7000,7000,7086,7134,6940,6940,7006,-60,6,12,840800,0
2726,p1308,20121207,6940,7006,0,0,0,7006,7006,0,0,0,0,0
2727,p1308,20121210,7006,7006,0,0,0,7006,7006,0,0,0,0,0
2728,p1308,20121211,7006,7006,0,0,0,7006,7006,0,0,0,0,0
2729,p1308,20121212,7006,7006,0,0,0,7006,7006,0,0,0,0,0
2730,p1308,20121213,7006,7006,0,0,0,7006,7006,0,0,0,0,0
2731,p1308,20121214,7006,7006,0,0,0,7006,7006,0,0,0,0,0
2732,p1308,20121217,7006,7006,0,0,0,7006,7006,0,0,0,0,0
2733,p1308,20121218,7006,7006,7038,7122,6996,6996,7052,-10,46,6,423120,2
2734,p1308,20121219,6996,7052,0,0,0,7052,7052,0,0,0,0,2
2735,p1308,20121220,7052,7052,0,0,0,7052,7052,0,0,0,0,2
2736,p1308,20121221,7052,7052,7120,7120,7120,7120,7120,68,68,2,142400,4
2737,p1308,20121224,7120,7120,0,0,0,7120,7120,0,0,0,0,4
2738,p1308,20121225,7120,7120,7076,7122,7068,7122,7088,2,-32,6,425320,4
2739,p1308,20121226,7122,7088,7094,7182,7094,7102,7120,14,32,8,569640,8
2740,p1308,20121227,7102,7120,7022,7404,7022,7200,7228,80,108,90,6506720,4
2741,p1308,20121228,7200,7228,7182,7218,6984,7194,7090,-34,-138,68,4821880,40
2742,p1308,20121231,7194,7090,7194,7194,7194,7194,7194,104,104,2,143880,40
2743,p1309,20120918,8310,8340,8224,8260,8120,8170,8188,-170,-152,102,8353320,90
2744,p1309,20120919,8170,8188,8200,8238,8200,8230,8210,42,22,24,1970520,102
2745,p1309,20120920,8230,8210,8238,8238,8158,8178,8206,-32,-4,136,11161360,178
2746,p1309,20120921,8178,8206,8178,8178,8040,8048,8098,-158,-108,148,11985920,196
2747,p1309,20120924,8048,8098,7906,7906,7776,7776,7814,-322,-284,156,12189920,228
2748,p1309,20120925,7776,7814,7760,7778,7666,7718,7718,-96,-96,104,8028760,266
2749,p1309,20120926,7718,7718,7720,7734,7660,7688,7698,-30,-20,86,6621440,266
2750,p1309,20120927,7688,7698,7596,7630,7570,7590,7608,-108,-90,140,10653640,312
2751,p1309,20120928,7590,7608,7634,7646,7554,7578,7592,-30,-16,460,34929600,568
2752,p1309,20121008,7578,7592,7284,7402,7266,7292,7330,-300,-262,250,18325640,736
2753,p1309,20121009,7292,7330,7298,7418,7294,7386,7350,56,20,530,38959400,1036
2754,p1309,20121010,7386,7350,7360,7428,7344,7410,7390,60,40,140,10348200,996
2755,p1309,20121011,7410,7390,7372,7416,7346,7380,7374,-10,-16,272,20062040,1170
2756,p1309,20121012,7380,7374,7412,7418,7262,7264,7326,-110,-48,1472,107855440,2144
2757,p1309,20121015,7264,7326,7258,7258,7140,7188,7186,-138,-140,1092,78492440,2588
2758,p1309,20121016,7188,7186,7226,7278,7222,7276,7246,90,60,4160,301493040,5020
2759,p1309,20121017,7276,7246,7276,7276,7190,7216,7212,-30,-34,3114,224598680,6682
2760,p1309,20121018,7216,7212,7270,7320,7250,7290,7290,78,78,2016,146989600,7184
2761,p1309,20121019,7290,7290,7386,7386,7290,7292,7320,2,30,940,68819520,7616
2762,p1309,20121022,7292,7320,7302,7332,7260,7308,7296,-12,-24,7186,524387080,8344
2763,p1309,20121023,7308,7296,7322,7380,7312,7316,7348,20,52,2414,177407320,8560
2764,p1309,20121024,7316,7348,7316,7406,7316,7400,7372,52,24,1196,88169760,8896
2765,p1309,20121025,7400,7372,7414,7424,7360,7360,7374,-12,2,5870,432930320,11226
2766,p1309,20121026,7360,7374,7356,7386,7256,7294,7336,-80,-38,1892,138800760,11310
2767,p1309,20121029,7294,7336,7250,7278,7200,7210,7254,-126,-82,1488,107945880,11566
2768,p1309,20121030,7210,7254,7214,7238,7120,7172,7172,-82,-82,3566,255774000,12836
2769,p1309,20121031,7172,7172,7168,7230,7136,7210,7176,38,4,3398,243869640,13682
2770,p1309,20121101,7210,7176,7190,7284,7190,7270,7254,94,78,1882,136531320,13856
2771,p1309,20121102,7270,7254,7260,7280,7140,7154,7202,-100,-52,2924,210627880,14286
2772,p1309,20121105,7154,7202,7050,7118,6970,6976,7046,-226,-156,3338,235224000,14746
2773,p1309,20121106,6976,7046,6996,7054,6980,7032,7022,-14,-24,8190,575141760,16698
2774,p1309,20121107,7032,7022,7034,7050,6962,7042,7020,20,-2,3636,255272200,16686
2775,p1309,20121108,7042,7020,7012,7040,6968,6976,7012,-44,-8,4088,286708480,17188
2776,p1309,20121109,6976,7012,6966,6976,6882,6890,6932,-122,-80,5274,365660800,17920
2777,p1309,20121112,6890,6932,6780,6802,6656,6724,6706,-208,-226,11050,741190800,17636
2778,p1309,20121113,6724,6706,6770,6856,6770,6808,6812,102,106,8412,573167440,19012
2779,p1309,20121114,6808,6812,6790,6908,6790,6900,6852,88,40,9470,648979680,21120
2780,p1309,20121115,6900,6852,6910,6986,6894,6906,6938,54,86,12590,873655680,23418
2781,p1309,20121116,6906,6938,6910,6948,6852,6872,6896,-66,-42,11042,761577320,25348
2782,p1309,20121119,6872,6896,6916,6972,6904,6964,6948,68,52,11546,802381240,26848
2783,p1309,20121120,6964,6948,6990,7008,6926,6966,6958,18,10,11878,826639600,28282
2784,p1309,20121121,6966,6958,6966,7010,6966,7002,6988,44,30,12944,904664760,28972
2785,p1309,20121122,7002,6988,7010,7020,6958,6982,6974,-6,-14,15074,1051439520,30444
2786,p1309,20121123,6982,6974,6962,6980,6882,6974,6926,0,-48,19554,1354345280,31640
2787,p1309,20121126,6974,6926,6980,7036,6980,7000,7004,74,78,34682,2429410600,46730
2788,p1309,20121127,7000,7004,7028,7048,6986,6988,7022,-16,18,20086,1410468160,48580
2789,p1309,20121128,6988,7022,7044,7046,6930,6944,6988,-78,-34,30230,2112666920,50262
2790,p1309,20121129,6944,6988,6970,6984,6900,6950,6940,-38,-48,30638,2126365200,50158
2791,p1309,20121130,6950,6940,6942,6968,6888,6960,6922,20,-18,30930,2141253480,51330
2792,p1309,20121203,6960,6922,6960,7060,6958,7020,7022,98,100,32112,2254976240,57546
2793,p1309,20121204,7020,7022,6990,6990,6930,6976,6958,-46,-64,44722,3111895400,63596
2794,p1309,20121205,6976,6958,6966,7006,6964,6996,6986,38,28,45974,3211951240,69038
2795,p1309,20121206,6996,6986,7020,7040,6960,6970,7002,-16,16,42184,2954457080,75856
2796,p1309,20121207,6970,7002,6984,7016,6952,6988,6984,-14,-18,44694,3121580600,77218
2797,p1309,20121210,6988,6984,6968,7012,6952,7000,6986,16,2,59118,4130865760,91884
2798,p1309,20121211,7000,6986,6990,7036,6966,6966,7000,-20,14,68900,4824250680,102460
2799,p1309,20121212,6966,7000,6940,6942,6856,6858,6900,-142,-100,66444,4585848320,107206
2800,p1309,20121213,6858,6900,6850,6900,6836,6870,6870,-30,-30,51120,3511976160,108514
2801,p1309,20121214,6870,6870,6838,6956,6838,6956,6912,86,42,44274,3061094320,107944
2802,p1309,20121217,6956,6912,7000,7044,6974,7008,7004,96,92,56470,3955172640,110184
2803,p1309,20121218,7008,7004,6992,7048,6984,7004,7014,0,10,64078,4495232840,112392
2804,p1309,20121219,7004,7014,6960,6978,6926,6974,6952,-40,-62,46700,3246792200,117924
2805,p1309,20121220,6974,6952,6920,6968,6872,6950,6920,-2,-32,78012,5399602080,127186
2806,p1309,20121221,6950,6920,6920,7140,6920,7130,7060,210,140,229900,16231110640,163286
2807,p1309,20121224,7130,7060,7130,7218,7100,7102,7156,42,96,221980,15886308440,162432
2808,p1309,20121225,7102,7156,7120,7176,7062,7132,7122,-24,-34,208714,14868293400,170116
2809,p1309,20121226,7132,7122,7142,7226,7100,7138,7158,16,36,320972,22979441320,181746
2810,p1309,20121227,7138,7158,7100,7296,7100,7286,7224,128,66,494024,35696042600,213324
2811,p1309,20121228,7286,7224,7272,7298,7224,7256,7252,32,28,224542,16288065480,208300
2812,p1309,20121231,7256,7252,7266,7316,7208,7214,7262,-38,10,206776,15016557640,203296
2813,p1310,20121023,7290,7290,0,0,0,7290,7290,0,0,0,0,0
2814,p1310,20121024,7290,7290,0,0,0,7290,7290,0,0,0,0,0
2815,p1310,20121025,7290,7290,7204,7512,7204,7390,7368,100,78,6,442120,0
2816,p1310,20121026,7390,7368,7324,7360,7318,7334,7332,-34,-36,18,1319800,0
2817,p1310,20121029,7334,7332,0,0,0,7332,7332,0,0,0,0,0
2818,p1310,20121030,7332,7332,7218,7218,7120,7120,7156,-212,-176,6,429360,0
2819,p1310,20121031,7120,7156,0,0,0,7156,7156,0,0,0,0,0
2820,p1310,20121101,7156,7156,0,0,0,7156,7156,0,0,0,0,0
2821,p1310,20121102,7156,7156,0,0,0,7156,7156,0,0,0,0,0
2822,p1310,20121105,7156,7156,0,0,0,7156,7156,0,0,0,0,0
2823,p1310,20121106,7156,7156,0,0,0,7156,7156,0,0,0,0,0
2824,p1310,20121107,7156,7156,0,0,0,7156,7156,0,0,0,0,0
2825,p1310,20121108,7156,7156,0,0,0,7156,7156,0,0,0,0,0
2826,p1310,20121109,7156,7156,0,0,0,7156,7156,0,0,0,0,0
2827,p1310,20121112,7156,7156,0,0,0,7156,7156,0,0,0,0,0
2828,p1310,20121113,7156,7156,0,0,0,7156,7156,0,0,0,0,0
2829,p1310,20121114,7156,7156,0,0,0,7156,7156,0,0,0,0,0
2830,p1310,20121115,7156,7156,0,0,0,7156,7156,0,0,0,0,0
2831,p1310,20121116,7156,7156,6910,6910,6910,6910,6910,-246,-246,2,138200,2
2832,p1310,20121119,6910,6910,6994,6994,6994,6994,6994,84,84,2,139880,4
2833,p1310,20121120,6994,6994,0,0,0,6994,6994,0,0,0,0,4
2834,p1310,20121121,6994,6994,7012,7012,7012,7012,7012,18,18,2,140240,6
2835,p1310,20121122,7012,7012,0,0,0,7012,7012,0,0,0,0,6
2836,p1310,20121123,7012,7012,0,0,0,7012,7012,0,0,0,0,6
2837,p1310,20121126,7012,7012,6886,7020,6884,6996,6962,-16,-50,24,1670880,10
2838,p1310,20121127,6996,6962,7024,7024,7020,7020,7022,58,60,4,280880,8
2839,p1310,20121128,7020,7022,0,0,0,7022,7022,0,0,0,0,8
2840,p1310,20121129,7022,7022,0,0,0,7022,7022,0,0,0,0,8
2841,p1310,20121130,7022,7022,0,0,0,7022,7022,0,0,0,0,8
2842,p1310,20121203,7022,7022,7024,7050,7012,7014,7024,-8,2,10,702480,8
2843,p1310,20121204,7014,7024,0,0,0,7024,7024,0,0,0,0,8
2844,p1310,20121205,7024,7024,0,0,0,7024,7024,0,0,0,0,8
2845,p1310,20121206,7024,7024,0,0,0,7024,7024,0,0,0,0,8
2846,p1310,20121207,7024,7024,6968,6992,6968,6992,6980,-32,-44,8,558400,8
2847,p1310,20121210,6992,6980,6948,6948,6948,6948,6948,-32,-32,4,277920,8
2848,p1310,20121211,6948,6948,7016,7016,7004,7004,7010,56,62,4,280400,8
2849,p1310,20121212,7004,7010,6970,6970,6826,6900,6906,-110,-104,8,552480,8
2850,p1310,20121213,6900,6906,0,0,0,6906,6906,0,0,0,0,8
2851,p1310,20121214,6906,6906,0,0,0,6906,6906,0,0,0,0,8
2852,p1310,20121217,6906,6906,7000,7000,6990,6990,6994,84,88,6,419640,8
2853,p1310,20121218,6990,6994,0,0,0,6994,6994,0,0,0,0,8
2854,p1310,20121219,6994,6994,0,0,0,6994,6994,0,0,0,0,8
2855,p1310,20121220,6994,6994,0,0,0,6994,6994,0,0,0,0,8
2856,p1310,20121221,6994,6994,7100,7124,7100,7124,7108,130,114,6,426480,10
2857,p1310,20121224,7124,7108,7172,7172,7128,7134,7140,26,32,14,999720,14
2858,p1310,20121225,7134,7140,7086,7110,7086,7110,7100,-30,-40,18,1278320,14
2859,p1310,20121226,7110,7100,0,0,0,7100,7100,0,0,0,0,14
2860,p1310,20121227,7100,7100,7262,7290,7262,7290,7276,190,176,4,291040,14
2861,p1310,20121228,7290,7276,7380,7380,7356,7356,7368,80,92,4,294720,14
2862,p1310,20121231,7356,7368,7350,7350,7350,7350,7350,-18,-18,2,147000,12
2863,p1311,20121116,6810,6810,0,0,0,6810,6810,0,0,0,0,0
2864,p1311,20121119,6810,6810,0,0,0,6810,6810,0,0,0,0,0
2865,p1311,20121120,6810,6810,7190,7190,7190,7190,7190,380,380,2,143800,2
2866,p1311,20121121,7190,7190,6994,6994,6994,6994,6994,-196,-196,2,139880,2
2867,p1311,20121122,6994,6994,0,0,0,6994,6994,0,0,0,0,2
2868,p1311,20121123,6994,6994,0,0,0,6994,6994,0,0,0,0,2
2869,p1311,20121126,6994,6994,7026,7026,7026,7026,7026,32,32,2,140520,0
2870,p1311,20121127,7026,7026,0,0,0,7026,7026,0,0,0,0,0
2871,p1311,20121128,7026,7026,0,0,0,7026,7026,0,0,0,0,0
2872,p1311,20121129,7026,7026,0,0,0,7026,7026,0,0,0,0,0
2873,p1311,20121130,7026,7026,0,0,0,7026,7026,0,0,0,0,0
2874,p1311,20121203,7026,7026,0,0,0,7026,7026,0,0,0,0,0
2875,p1311,20121204,7026,7026,0,0,0,7026,7026,0,0,0,0,0
2876,p1311,20121205,7026,7026,0,0,0,7026,7026,0,0,0,0,0
2877,p1311,20121206,7026,7026,0,0,0,7026,7026,0,0,0,0,0
2878,p1311,20121207,7026,7026,0,0,0,7026,7026,0,0,0,0,0
2879,p1311,20121210,7026,7026,0,0,0,7026,7026,0,0,0,0,0
2880,p1311,20121211,7026,7026,0,0,0,7026,7026,0,0,0,0,0
2881,p1311,20121212,7026,7026,0,0,0,7026,7026,0,0,0,0,0
2882,p1311,20121213,7026,7026,0,0,0,7026,7026,0,0,0,0,0
2883,p1311,20121214,7026,7026,0,0,0,7026,7026,0,0,0,0,0
2884,p1311,20121217,7026,7026,0,0,0,7026,7026,0,0,0,0,0
2885,p1311,20121218,7026,7026,0,0,0,7026,7026,0,0,0,0,0
2886,p1311,20121219,7026,7026,0,0,0,7026,7026,0,0,0,0,0
2887,p1311,20121220,7026,7026,0,0,0,7026,7026,0,0,0,0,0
2888,p1311,20121221,7026,7026,7088,7088,7086,7086,7086,60,60,4,283480,2
2889,p1311,20121224,7086,7086,0,0,0,7086,7086,0,0,0,0,2
2890,p1311,20121225,7086,7086,7182,7204,7180,7204,7184,118,98,14,1005840,14
2891,p1311,20121226,7204,7184,0,0,0,7184,7184,0,0,0,0,14
2892,p1311,20121227,7184,7184,0,0,0,7184,7184,0,0,0,0,14
2893,p1311,20121228,7184,7184,0,0,0,7184,7184,0,0,0,0,14
2894,p1311,20121231,7184,7184,0,0,0,7184,7184,0,0,0,0,14
2895,p1312,20121218,6868,6868,0,0,0,6868,6868,0,0,0,0,0
2896,p1312,20121219,6868,6868,0,0,0,6868,6868,0,0,0,0,0
2897,p1312,20121220,6868,6868,0,0,0,6868,6868,0,0,0,0,0
2898,p1312,20121221,6868,6868,7084,7136,7084,7126,7114,258,246,6,426920,2
2899,p1312,20121224,7126,7114,0,0,0,7114,7114,0,0,0,0,2
2900,p1312,20121225,7114,7114,7136,7136,7136,7136,7136,22,22,4,285440,6
2901,p1312,20121226,7136,7136,7206,7218,7206,7218,7212,82,76,4,288480,6
2902,p1312,20121227,7218,7212,0,0,0,7212,7212,0,0,0,0,6
2903,p1312,20121228,7212,7212,0,0,0,7212,7212,0,0,0,0,6
2904,p1312,20121231,7212,7212,0,0,0,7212,7212,0,0,0,0,6