   ,合约,日期,前收盘价,前结算价,开盘价,最高价,最低价,收盘价,结算价,涨跌1,涨跌2,成交量,成交金额,持仓量
1,p1301,20130104,6288,6230,6348,6348,5988,6278,6258,48,28,296,18525000,17454
2,p1301,20130107,6278,6258,6032,6360,6032,6250,6288,-8,30,3230,203110640,15432
3,p1301,20130108,6250,6288,6328,6328,6120,6240,6238,-48,-50,3008,187696760,12430
4,p1301,20130109,6240,6238,0,0,0,6238,6238,0,0,0,0,12430
5,p1301,20130110,6238,6238,6200,6200,6080,6082,6182,-156,-56,3112,192399200,9528
6,p1301,20130111,6082,6182,6050,6090,6050,6050,6068,-132,-114,310,18810920,9528
7,p1301,20130114,6050,6068,6000,6000,6000,6000,6000,-68,-68,410,24600000,9528
8,p1301,20130115,6000,6000,6100,6100,6000,6000,6068,0,68,574,34840000,9128
9,p1301,20130116,6000,6068,0,0,0,6068,6068,0,0,0,0,9128
10,p1301,20130117,6068,6068,6100,6140,6100,6140,6210,72,142,538,33007160,0
11,p1302,20130104,6390,6420,6340,6450,6340,6450,6424,30,4,34,2184320,156
12,p1302,20130107,6450,6424,6450,6502,6306,6422,6410,-2,-14,92,5897920,154
13,p1302,20130108,6422,6410,0,0,0,6410,6410,0,0,0,0,154
14,p1302,20130109,6410,6410,0,0,0,6410,6410,0,0,0,0,154
15,p1302,20130110,6410,6410,6154,6446,6154,6250,6290,-160,-120,58,3648920,162
16,p1302,20130111,6250,6290,6176,6208,6154,6208,6194,-82,-96,30,1858400,148
17,p1302,20130114,6208,6194,6228,6318,6228,6318,6254,124,60,8,500400,148
18,p1302,20130115,6318,6254,6102,6248,6102,6248,6128,-6,-126,16,980640,138
19,p1302,20130116,6248,6128,6156,6156,6156,6156,6156,28,28,2,123120,138
20,p1302,20130117,6156,6156,6224,6250,6224,6250,6244,94,88,74,4621560,84
21,p1302,20130118,6250,6244,6224,6306,6128,6306,6248,62,4,32,1999960,60
22,p1302,20130121,6306,6248,6362,6362,6202,6252,6262,4,14,12,751600,50
23,p1302,20130122,6252,6262,0,0,0,6262,6262,0,0,0,0,50
24,p1302,20130123,6262,6262,6258,6378,6258,6378,6298,116,36,12,755880,44
25,p1302,20130124,6378,6298,6504,6506,6068,6110,6322,-188,24,240,15173080,54
26,p1302,20130125,6110,6322,6106,6124,6088,6088,6108,-234,-214,18,1099640,54
27,p1302,20130128,6088,6108,6052,6052,6052,6052,6052,-56,-56,2,121040,54
28,p1302,20130129,6052,6052,0,0,0,6052,6052,0,0,0,0,54
29,p1302,20130130,6052,6052,6020,6148,6020,6090,6100,38,48,38,2318520,54
30,p1302,20130131,6090,6100,6336,6338,5902,6336,6098,236,-2,46,2805440,56
31,p1302,20130201,6336,6098,0,0,0,6098,6098,0,0,0,0,56
32,p1302,20130204,6098,6098,0,0,0,6098,6098,0,0,0,0,56
33,p1302,20130205,6098,6098,0,0,0,6098,6098,0,0,0,0,56
34,p1302,20130206,6098,6098,0,0,0,6098,6098,0,0,0,0,56
35,p1302,20130207,6098,6098,0,0,0,6098,6098,0,0,0,0,56
36,p1302,20130208,6098,6098,0,0,0,6098,6098,0,0,0,0,56
37,p1302,20130218,6098,6098,0,0,0,6098,6098,0,0,0,0,56
38,p1302,20130219,6098,6098,6462,6462,6462,6462,6462,364,364,2,129240,54
39,p1302,20130220,6462,6462,6150,6150,6150,6150,6150,-312,-312,4,246000,54
40,p1302,20130221,6150,6150,0,0,0,6150,6254,0,104,0,0,0
41,p1303,20130104,6616,6660,6620,6658,6586,6658,6620,-2,-40,22,1456560,262
42,p1303,20130107,6658,6620,6882,6884,6540,6610,6672,-10,52,70,4670880,264
43,p1303,20130108,6610,6672,6580,6580,6580,6580,6580,-92,-92,2,131600,264
44,p1303,20130109,6580,6580,6492,6494,6444,6458,6466,-122,-114,18,1164200,268
45,p1303,20130110,6458,6466,6508,6508,6406,6444,6458,-22,-8,72,4649920,270
46,p1303,20130111,6444,6458,6344,6396,6324,6396,6352,-62,-106,8,508280,270
47,p1303,20130114,6396,6352,6530,6530,6380,6422,6422,70,70,44,2826520,288
48,p1303,20130115,6422,6422,6452,6452,6400,6422,6434,0,12,16,1029640,286
49,p1303,20130116,6422,6434,6474,6474,6444,6444,6452,10,18,14,903400,284
50,p1303,20130117,6444,6452,6438,6438,6332,6332,6386,-120,-66,22,1404960,286
51,p1303,20130118,6332,6386,6380,6406,6380,6406,6388,20,2,32,2044480,294
52,p1303,20130121,6406,6388,6382,6446,6382,6396,6402,8,14,24,1536560,290
53,p1303,20130122,6396,6402,6468,6468,6434,6434,6442,32,40,20,1288400,300
54,p1303,20130123,6434,6442,6570,6570,6446,6468,6490,26,48,14,908680,298
55,p1303,20130124,6468,6490,6474,6474,6384,6384,6412,-106,-78,36,2308720,288
56,p1303,20130125,6384,6412,6314,6424,6314,6342,6394,-70,-18,360,23023360,320
57,p1303,20130128,6342,6394,6328,6328,6306,6306,6314,-88,-80,6,378880,322
58,p1303,20130129,6306,6314,6302,6316,6262,6290,6296,-24,-18,26,1637040,318
59,p1303,20130130,6290,6296,6326,6326,6304,6304,6312,8,16,6,378720,318
60,p1303,20130131,6304,6312,6360,6390,6320,6390,6358,78,46,24,1526240,320
61,p1303,20130201,6390,6358,6432,6432,6360,6388,6390,30,32,92,5879560,320
62,p1303,20130204,6388,6390,6418,6418,6370,6370,6398,-20,8,8,511920,320
63,p1303,20130205,6370,6398,6352,6352,6352,6352,6352,-46,-46,4,254080,320
64,p1303,20130206,6352,6352,6348,6372,6348,6372,6356,20,4,20,1271520,326
65,p1303,20130207,6372,6356,6270,6386,6270,6370,6346,14,-10,38,2412120,326
66,p1303,20130208,6370,6346,6336,6360,6330,6330,6340,-16,-6,42,2663240,328
67,p1303,20130218,6330,6340,6280,6316,6280,6296,6304,-44,-36,20,1261120,322
68,p1303,20130219,6296,6304,6298,6362,6298,6362,6344,58,40,30,1903640,336
69,p1303,20130220,6362,6344,6380,6380,6358,6380,6374,36,30,122,7776560,228
70,p1303,20130221,6380,6374,6280,6380,6156,6282,6312,-92,-62,56,3534920,202
71,p1303,20130222,6282,6312,6316,6332,6316,6332,6320,20,8,6,379280,196
72,p1303,20130225,6332,6320,6068,6220,6068,6220,6210,-100,-110,92,5714040,202
73,p1303,20130226,6220,6210,6150,6150,6120,6120,6138,-90,-72,20,1227920,184
74,p1303,20130227,6120,6138,6052,6100,6052,6100,6060,-38,-78,18,1090840,170
75,p1303,20130228,6100,6060,6108,6302,5906,6302,6064,242,4,122,7399360,100
76,p1303,20130301,6302,6064,0,0,0,6064,6064,0,0,0,0,100
77,p1303,20130304,6064,6064,0,0,0,6064,6064,0,0,0,0,100
78,p1303,20130305,6064,6064,0,0,0,6064,6064,0,0,0,0,100
79,p1303,20130306,6064,6064,6064,6064,6064,6064,6064,0,0,62,3759680,98
80,p1303,20130307,6064,6064,0,0,0,6064,6064,0,0,0,0,98
81,p1303,20130308,6064,6064,5710,5950,5710,5950,5830,-114,-234,16,932800,90
82,p1303,20130311,5950,5830,0,0,0,5830,5830,0,0,0,0,90
83,p1303,20130312,5830,5830,0,0,0,5830,5830,0,0,0,0,90
84,p1303,20130313,5830,5830,0,0,0,5830,5830,0,0,0,0,90
85,p1303,20130314,5830,5830,0,0,0,5830,6016,0,186,0,0,0
86,p1304,20130104,6764,6804,6798,6894,6464,6894,6760,90,-44,124,8383480,218
87,p1304,20130107,6894,6760,6810,6854,6806,6808,6818,48,58,18,1227440,222
88,p1304,20130108,6808,6818,6774,6774,6630,6696,6708,-122,-110,42,2817560,202
89,p1304,20130109,6696,6708,6670,6670,6632,6670,6658,-38,-50,24,1598040,208
90,p1304,20130110,6670,6658,6652,6680,6546,6546,6596,-112,-62,78,5145400,212
91,p1304,20130111,6546,6596,6496,6548,6446,6446,6500,-150,-96,12,780040,210
92,p1304,20130114,6446,6500,6500,6532,6492,6524,6512,24,12,22,1432840,206
93,p1304,20130115,6524,6512,6484,6574,6484,6522,6542,10,30,18,1177800,212
94,p1304,20130116,6522,6542,6580,6580,6564,6564,6572,22,30,4,262880,210
95,p1304,20130117,6564,6572,6584,6584,6522,6522,6550,-50,-22,8,524000,206
96,p1304,20130118,6522,6550,6460,6550,6460,6550,6502,0,-48,10,650240,204
97,p1304,20130121,6550,6502,6558,6558,6478,6536,6524,34,22,16,1044000,214
98,p1304,20130122,6536,6524,6578,6600,6546,6600,6580,76,56,24,1579640,208
99,p1304,20130123,6600,6580,6586,6616,6542,6596,6590,16,10,70,4614120,210
100,p1304,20130124,6596,6590,6568,6568,6500,6516,6550,-74,-40,40,2620040,210
101,p1304,20130125,6516,6550,6514,6530,6400,6520,6496,-30,-54,96,6237960,170
102,p1304,20130128,6520,6496,6450,6530,6450,6530,6498,34,2,16,1039880,166
103,p1304,20130129,6530,6498,6538,6538,6500,6532,6512,34,14,40,2605400,144
104,p1304,20130130,6532,6512,6534,6564,6534,6564,6544,52,32,6,392680,138
105,p1304,20130131,6564,6544,6582,6660,6582,6636,6640,92,96,44,2921760,144
106,p1304,20130201,6636,6640,6630,6668,6622,6668,6636,28,-4,8,531000,144
107,p1304,20130204,6668,6636,6694,6694,6694,6694,6694,58,58,2,133880,144
108,p1304,20130205,6694,6694,6586,6630,6586,6630,6618,-64,-76,72,4765120,122
109,p1304,20130206,6630,6618,0,0,0,6618,6618,0,0,0,0,122
110,p1304,20130207,6618,6618,6556,6640,6550,6640,6588,22,-30,22,1449720,114
111,p1304,20130208,6640,6588,6678,6692,6626,6626,6662,38,74,60,3997840,112
112,p1304,20130218,6626,6662,6588,6590,6588,6590,6588,-72,-74,4,263560,110
113,p1304,20130219,6590,6588,6638,6638,6630,6630,6632,42,44,16,1061200,110
114,p1304,20130220,6630,6632,6640,6660,6628,6628,6634,-4,2,26,1724960,114
115,p1304,20130221,6628,6634,6576,6610,6534,6596,6590,-38,-44,102,6722280,102
116,p1304,20130222,6596,6590,6528,6636,6528,6620,6598,30,8,42,2771440,116
117,p1304,20130225,6620,6598,6338,6408,6338,6372,6362,-226,-236,50,3181960,116
118,p1304,20130226,6372,6362,6364,6370,6364,6368,6368,6,6,30,1910840,132
119,p1304,20130227,6368,6368,6318,6324,6302,6302,6318,-66,-50,46,2906400,114
120,p1304,20130228,6302,6318,6320,6324,6248,6280,6296,-38,-22,100,6296560,112
121,p1304,20130301,6280,6296,6190,6216,6190,6212,6208,-84,-88,12,745120,114
122,p1304,20130304,6212,6208,6232,6240,6208,6240,6228,32,20,12,747360,106
123,p1304,20130305,6240,6228,6232,6232,6232,6232,6232,4,4,6,373920,104
124,p1304,20130306,6232,6232,6134,6134,6134,6134,6134,-98,-98,6,368040,104
125,p1304,20130307,6134,6134,0,0,0,6134,6134,0,0,0,0,104
126,p1304,20130308,6134,6134,0,0,0,6134,6134,0,0,0,0,104
127,p1304,20130311,6134,6134,0,0,0,6134,6134,0,0,0,0,104
128,p1304,20130312,6134,6134,0,0,0,6134,6134,0,0,0,0,104
129,p1304,20130313,6134,6134,5936,5938,5912,5938,5924,-196,-210,8,473960,100
130,p1304,20130314,5938,5924,5702,5720,5702,5710,5714,-214,-210,32,1828920,94
131,p1304,20130315,5710,5714,5730,5800,5730,5800,5776,86,62,6,346560,94
132,p1304,20130318,5800,5776,5734,5734,5734,5734,5734,-42,-42,2,114680,94
133,p1304,20130319,5734,5734,0,0,0,5734,5734,0,0,0,0,94
134,p1304,20130320,5734,5734,0,0,0,5734,5734,0,0,0,0,94
135,p1304,20130321,5734,5734,5890,5946,5880,5880,5902,146,168,62,3659640,58
136,p1304,20130322,5880,5902,0,0,0,5902,5902,0,0,0,0,58
137,p1304,20130325,5902,5902,0,0,0,5902,5902,0,0,0,0,58
138,p1304,20130326,5902,5902,0,0,0,5902,5902,0,0,0,0,58
139,p1304,20130327,5902,5902,0,0,0,5902,5902,0,0,0,0,58
140,p1304,20130328,5902,5902,0,0,0,5902,5902,0,0,0,0,58
141,p1304,20130329,5902,5902,5750,5750,5730,5730,5746,-172,-156,12,689600,56
142,p1304,20130401,5730,5746,0,0,0,5746,5746,0,0,0,0,56
143,p1304,20130402,5746,5746,5746,5746,5746,5746,5746,0,0,10,574600,46
144,p1304,20130403,5746,5746,0,0,0,5746,5746,0,0,0,0,46
145,p1304,20130408,5746,5746,5746,5746,5746,5746,5746,0,0,46,2643160,30
146,p1304,20130409,5746,5746,0,0,0,5746,5746,0,0,0,0,30
147,p1304,20130410,5746,5746,5514,5750,5514,5750,5626,4,-120,40,2250800,10
148,p1304,20130411,5750,5626,5750,5750,5750,5750,5750,124,124,10,575000,0
149,p1304,20130412,5750,5750,0,0,0,5750,5750,0,0,0,0,0
150,p1304,20130415,5750,5750,0,0,0,5750,5750,0,0,0,0,0
151,p1304,20130416,5750,5750,0,0,0,5700,5700,-50,-50,0,0,0
152,p1305,20130104,6922,6986,6940,7038,6898,7028,7000,42,14,626342,43845287240,561414
153,p1305,20130107,7028,7000,6966,7016,6940,6964,6978,-36,-22,604152,42164975240,596144
154,p1305,20130108,6964,6978,6978,6988,6828,6844,6886,-134,-92,718090,49456965720,596782
155,p1305,20130109,6844,6886,6860,6860,6800,6804,6828,-82,-58,525870,35908032280,615842
156,p1305,20130110,6804,6828,6838,6874,6722,6726,6810,-102,-18,642526,43757026000,630364
157,p1305,20130111,6726,6810,6732,6748,6634,6640,6704,-170,-106,698016,46800663280,639434
158,p1305,20130114,6640,6704,6700,6730,6662,6698,6702,-6,-2,500238,33531380000,627448
159,p1305,20130115,6698,6702,6752,6788,6718,6726,6750,24,48,464414,31351175880,583928
160,p1305,20130116,6726,6750,6750,6800,6740,6776,6776,26,26,399654,27080833240,549960
161,p1305,20130117,6776,6776,6800,6818,6700,6712,6750,-64,-26,454242,30668298480,564772
162,p1305,20130118,6712,6750,6720,6750,6652,6746,6700,-4,-50,537290,36007796400,555258
163,p1305,20130121,6746,6700,6736,6778,6726,6752,6748,52,48,301050,20318834960,555730
164,p1305,20130122,6752,6748,6746,6820,6746,6818,6788,70,40,293718,19940207280,536838
165,p1305,20130123,6818,6788,6838,6850,6798,6826,6824,38,36,182746,12472237120,520212
166,p1305,20130124,6826,6824,6796,6808,6686,6720,6748,-104,-76,239094,16135725040,501884
167,p1305,20130125,6720,6748,6748,6762,6716,6724,6736,-24,-12,154504,10408682760,487666
168,p1305,20130128,6724,6736,6730,6742,6678,6724,6708,-12,-28,144128,9669412000,481644
169,p1305,20130129,6724,6708,6732,6732,6682,6702,6704,-6,-4,140060,9391052640,478726
170,p1305,20130130,6702,6704,6704,6756,6696,6756,6734,52,30,130478,8788660160,468388
171,p1305,20130131,6756,6734,6798,6844,6766,6836,6808,102,74,165620,11276357160,451050
172,p1305,20130201,6836,6808,6820,6868,6816,6864,6846,56,38,155778,10666766160,444536
173,p1305,20130204,6864,6846,6880,6906,6852,6854,6880,8,34,98886,6804203440,429764
174,p1305,20130205,6854,6880,6850,6856,6810,6830,6832,-50,-48,107060,7314835400,415584
175,p1305,20130206,6830,6832,6814,6854,6800,6810,6830,-22,-2,64962,4438198160,411788
176,p1305,20130207,6810,6830,6802,6812,6750,6772,6774,-58,-56,66194,4485251320,401096
177,p1305,20130208,6772,6774,6770,6806,6732,6736,6776,-38,2,57320,3884875520,387246
178,p1305,20130218,6736,6776,6700,6724,6662,6694,6700,-82,-76,59924,4014957520,387168
179,p1305,20130219,6694,6700,6704,6752,6704,6738,6734,38,34,45614,3072069920,388420
180,p1305,20130220,6738,6734,6762,6788,6760,6766,6774,32,40,75656,5125606240,373784
181,p1305,20130221,6766,6774,6748,6748,6644,6698,6688,-76,-86,97996,6554338560,355736
182,p1305,20130222,6698,6688,6680,6756,6678,6734,6718,46,30,67942,4565480480,347022
183,p1305,20130225,6734,6718,6640,6640,6452,6496,6512,-222,-206,139412,9080588080,314622
184,p1305,20130226,6496,6512,6470,6520,6392,6394,6462,-118,-50,106926,6910243720,278756
185,p1305,20130227,6394,6462,6410,6422,6366,6416,6398,-46,-64,73122,4679743040,255360
186,p1305,20130228,6416,6398,6428,6440,6350,6354,6386,-44,-12,116116,7415866080,240914
187,p1305,20130301,6354,6386,6350,6362,6312,6334,6336,-52,-50,71808,4550625680,235396
188,p1305,20130304,6334,6336,6332,6378,6322,6356,6356,20,20,51180,3253427280,227206
189,p1305,20130305,6356,6356,6382,6400,6282,6302,6336,-54,-20,52554,3330404360,230136
190,p1305,20130306,6302,6336,6300,6356,6270,6310,6318,-26,-18,62436,3945852040,220290
191,p1305,20130307,6310,6318,6300,6336,6266,6272,6298,-46,-20,40750,2567056720,215290
192,p1305,20130308,6272,6298,6322,6336,6300,6306,6312,8,14,40028,2527073520,215948
193,p1305,20130311,6306,6312,6300,6316,6260,6264,6286,-48,-26,32642,2051916040,210730
194,p1305,20130312,6264,6286,6268,6278,6180,6182,6218,-104,-68,56834,3534354560,204668
195,p1305,20130313,6182,6218,6170,6182,5996,6002,6060,-216,-158,82404,4994994960,194898
196,p1305,20130314,6002,6060,5902,6010,5902,5910,5948,-150,-112,97130,5778632480,183442
197,p1305,20130315,5910,5948,5922,6034,5910,6010,5978,62,30,70244,4200102000,174684
198,p1305,20130318,6010,5978,5958,6000,5900,5956,5962,-22,-16,52044,3103900000,165086
199,p1305,20130319,5956,5962,5980,6018,5966,5988,5990,26,28,31410,1881563280,166820
200,p1305,20130320,5988,5990,5960,6012,5940,6002,5988,12,-2,25522,1528654400,164524
201,p1305,20130321,6002,5988,6030,6100,6030,6056,6072,68,84,41980,2549378400,159860
202,p1305,20130322,6056,6072,6068,6086,6022,6030,6052,-42,-20,33794,2045291840,156750
203,p1305,20130325,6030,6052,6052,6106,6046,6060,6076,8,24,26178,1590803640,151478
204,p1305,20130326,6060,6076,6032,6066,6004,6018,6028,-58,-48,18388,1108700320,148628
205,p1305,20130327,6018,6028,6048,6060,6016,6060,6040,32,12,27570,1665743920,146776
206,p1305,20130328,6060,6040,6046,6060,5956,5976,5990,-64,-50,25590,1533130680,143470
207,p1305,20130329,5976,5990,5900,5934,5812,5902,5894,-88,-96,22930,1351945000,136680
208,p1305,20130401,5902,5894,5874,5902,5752,5768,5806,-126,-88,29098,1689669680,125916
209,p1305,20130402,5768,5806,5782,5890,5770,5884,5820,78,14,32994,1920360960,128162
210,p1305,20130403,5884,5820,5860,5934,5830,5880,5884,60,64,35106,2066310280,124230
211,p1305,20130408,5880,5884,5850,5940,5848,5922,5910,38,26,21266,1257172000,120244
212,p1305,20130409,5922,5910,5966,5984,5946,5972,5970,62,60,33544,2002835960,101684
213,p1305,20130410,5972,5970,5994,6026,5942,6014,5992,44,22,32350,1938766440,90376
214,p1305,20130411,6014,5992,5998,6002,5910,5922,5966,-70,-26,27920,1666138560,84960
215,p1305,20130412,5922,5966,5900,5940,5890,5926,5918,-40,-48,24092,1425793600,78246
216,p1305,20130415,5926,5918,5902,5902,5752,5798,5810,-120,-108,27012,1569506160,65710
217,p1305,20130416,5798,5810,5702,5754,5578,5730,5694,-80,-116,28268,1609608480,51530
218,p1305,20130417,5730,5694,5758,5770,5660,5674,5716,-20,22,7888,450903520,49026
219,p1305,20130418,5674,5716,5656,5656,5576,5620,5622,-96,-94,10360,582604880,44488
220,p1305,20130419,5620,5622,5644,5678,5618,5660,5650,38,28,8094,457318280,40114
221,p1305,20130422,5660,5650,5650,5650,5538,5550,5588,-100,-62,11612,648977560,32890
222,p1305,20130423,5550,5588,5560,5602,5532,5562,5562,-26,-26,10326,574458360,25864
223,p1305,20130424,5562,5562,5520,5598,5480,5488,5524,-74,-38,6750,372995560,21532
224,p1305,20130425,5488,5524,5500,5576,5500,5538,5550,14,26,7174,398204920,17492
225,p1305,20130426,5538,5550,5592,5594,5470,5480,5516,-70,-34,8496,468778840,13868
226,p1305,20130502,5480,5516,5302,5400,5302,5384,5358,-132,-158,1848,99035720,13654
227,p1305,20130503,5384,5358,5400,5482,5400,5450,5444,92,86,2732,148736080,11792
228,p1305,20130506,5450,5444,5508,5520,5470,5520,5498,76,54,354,19467640,11774
229,p1305,20130507,5520,5498,5530,5530,5520,5528,5520,30,22,116,6405440,11770
230,p1305,20130508,5528,5520,5572,5572,5526,5560,5562,40,42,206,11460520,11754
231,p1305,20130509,5560,5562,0,0,0,5530,5530,-32,-32,0,0,11754
232,p1305,20130510,5530,5530,5540,5656,5540,5656,5606,126,76,408,22873600,11754
233,p1305,20130513,5656,5606,5720,5720,5600,5600,5656,-6,50,266,15049000,11748
234,p1305,20130514,5600,5656,5680,5680,5600,5650,5640,-6,-16,310,17486000,11736
235,p1305,20130515,5650,5640,5580,5650,5580,5650,5482,10,-158,1044,58938000,0
236,p1306,20130104,7086,7094,7350,7350,7064,7128,7152,34,58,122,8726000,50
237,p1306,20130107,7128,7152,7208,7380,7118,7118,7204,-34,52,88,6340880,72
238,p1306,20130108,7118,7204,7164,7164,7008,7058,7044,-146,-160,50,3522280,58
239,p1306,20130109,7058,7044,6980,7006,6942,6984,6982,-60,-62,10,698360,56
240,p1306,20130110,6984,6982,6968,6978,6860,6928,6938,-54,-44,144,9993360,56
241,p1306,20130111,6928,6938,6856,6862,6806,6806,6842,-132,-96,18,1231840,58
242,p1306,20130114,6806,6842,6866,6908,6866,6882,6882,40,40,16,1101240,58
243,p1306,20130115,6882,6882,6930,6948,6902,6904,6924,22,42,16,1107880,60
244,p1306,20130116,6904,6924,6946,6952,6946,6952,6948,28,24,4,277960,60
245,p1306,20130117,6952,6948,6976,6976,6852,6880,6920,-68,-28,74,5121240,56
246,p1306,20130118,6880,6920,6826,6896,6826,6896,6858,-24,-62,12,822960,56
247,p1306,20130121,6896,6858,6962,6962,6894,6898,6912,40,54,14,967720,60
248,p1306,20130122,6898,6912,6980,6990,6960,6990,6970,78,58,10,697080,60
249,p1306,20130123,6990,6970,7000,7080,6900,6970,6992,0,22,98,6853040,66
250,p1306,20130124,6970,6992,6930,6930,6854,6858,6886,-134,-106,20,1377480,62
251,p1306,20130125,6858,6886,6944,7006,6886,6892,6932,6,46,94,6516440,82
252,p1306,20130128,6892,6932,6896,6896,6860,6872,6870,-60,-62,12,824520,86
253,p1306,20130129,6872,6870,6880,6880,6798,6850,6838,-20,-32,32,2188600,68
254,p1306,20130130,6850,6838,6856,6906,6856,6894,6880,56,42,10,688120,60
255,p1306,20130131,6894,6880,6950,7030,6948,7010,7004,130,124,152,10647520,66
256,p1306,20130201,7010,7004,7048,7048,6992,6992,7014,-12,10,14,982200,60
257,p1306,20130204,6992,7014,0,0,0,7014,7014,0,0,0,0,60
258,p1306,20130205,7014,7014,7032,7032,7000,7004,7012,-10,-2,10,701320,62
259,p1306,20130206,7004,7012,7006,7010,7006,7010,7006,-2,-6,8,560560,62
260,p1306,20130207,7010,7006,6952,6954,6930,6954,6946,-52,-60,24,1667200,54
261,p1306,20130208,6954,6946,0,0,0,6946,6946,0,0,0,0,54
262,p1306,20130218,6946,6946,6890,6898,6890,6898,6894,-48,-52,4,275760,56
263,p1306,20130219,6898,6894,6916,7098,6908,6920,7012,26,118,360,25245440,166
264,p1306,20130220,6920,7012,6958,6962,6924,6924,6956,-88,-56,72,5008480,162
265,p1306,20130221,6924,6956,6840,6868,6800,6848,6850,-108,-106,432,29597160,564
266,p1306,20130222,6848,6850,6840,6928,6820,6876,6862,26,12,44,3019760,582
267,p1306,20130225,6876,6862,6698,6760,6594,6598,6638,-264,-224,324,21512240,592
268,p1306,20130226,6598,6638,6610,6628,6600,6600,6612,-38,-26,12,793640,592
269,p1306,20130227,6600,6612,6502,6538,6500,6538,6510,-74,-102,22,1432600,580
270,p1306,20130228,6538,6510,6576,6632,6432,6432,6492,-78,-18,496,32204680,796
271,p1306,20130301,6432,6492,6426,6426,6362,6398,6390,-94,-102,126,8052640,736
272,p1306,20130304,6398,6390,6450,6464,6428,6464,6448,74,58,152,9803080,632
273,p1306,20130305,6464,6448,6424,6450,6384,6426,6416,-22,-32,1420,91132480,608
274,p1306,20130306,6426,6416,6450,6450,6372,6410,6384,-6,-32,126,8045040,614
275,p1306,20130307,6410,6384,6466,6466,6380,6380,6382,-4,-2,154,9831280,650
276,p1306,20130308,6380,6382,6400,6400,6400,6400,6400,18,18,6,384000,656
277,p1306,20130311,6400,6400,6370,6378,6348,6378,6366,-22,-34,302,19229400,620
278,p1306,20130312,6378,6366,6368,6378,6330,6352,6358,-14,-8,66,4196680,618
279,p1306,20130313,6352,6358,6352,6352,6108,6108,6172,-250,-186,122,7531320,594
280,p1306,20130314,6108,6172,6082,6082,6068,6068,6072,-104,-100,22,1336000,606
281,p1306,20130315,6068,6072,6108,6158,6108,6158,6128,86,56,10,612840,598
282,p1306,20130318,6158,6128,6158,6158,6024,6066,6060,-62,-68,160,9698160,652
283,p1306,20130319,6066,6060,6100,6126,6100,6120,6112,60,52,14,855920,644
284,p1306,20130320,6120,6112,6022,6160,6022,6138,6118,26,6,30,1835600,644
285,p1306,20130321,6138,6118,6204,6218,6152,6184,6180,66,62,672,41540520,600
286,p1306,20130322,6184,6180,6176,6176,6174,6174,6174,-6,-6,26,1605560,578
287,p1306,20130325,6174,6174,6204,6232,6184,6184,6198,10,24,52,3223480,564
288,p1306,20130326,6184,6198,6136,6136,6130,6136,6134,-62,-64,26,1594880,558
289,p1306,20130327,6136,6134,6170,6170,6170,6170,6170,36,36,2,123400,556
290,p1306,20130328,6170,6170,6170,6170,6090,6090,6140,-80,-30,16,982600,556
291,p1306,20130329,6090,6140,5934,6032,5934,6008,6006,-132,-134,12,720760,560
292,p1306,20130401,6008,6006,6012,6012,5918,5924,5974,-82,-32,14,836440,566
293,p1306,20130402,5924,5974,5892,5980,5892,5980,5946,6,-28,48,2854320,572
294,p1306,20130403,5980,5946,5950,5998,5950,5972,5986,26,40,576,34482960,248
295,p1306,20130408,5972,5986,6000,6000,5964,5978,5978,-8,-8,120,7175600,308
296,p1306,20130409,5978,5978,6014,6028,5982,5982,6012,4,34,134,8057240,402
297,p1306,20130410,5982,6012,6030,6050,5988,6050,6034,38,22,26,1569320,416
298,p1306,20130411,6050,6034,6038,6072,5962,5986,6006,-48,-28,30,1802000,420
299,p1306,20130412,5986,6006,5952,5978,5952,5976,5962,-30,-44,40,2385240,412
300,p1306,20130415,5976,5962,5786,5830,5786,5828,5812,-134,-150,100,5812200,382
301,p1306,20130416,5828,5812,5700,5798,5700,5754,5744,-58,-68,204,11720320,414
302,p1306,20130417,5754,5744,5762,5762,5684,5738,5746,-6,2,452,25976720,600
303,p1306,20130418,5738,5746,5700,5716,5672,5684,5692,-62,-54,536,30512200,842
304,p1306,20130419,5684,5692,5708,5738,5708,5738,5722,46,30,36,2060120,848
305,p1306,20130422,5738,5722,5692,5752,5652,5664,5676,-58,-46,82,4655160,812
306,p1306,20130423,5664,5676,5636,5736,5632,5640,5650,-36,-26,2056,116176720,2790
307,p1306,20130424,5640,5650,5626,5626,5602,5602,5620,-48,-30,792,44510640,2760
308,p1306,20130425,5602,5620,5666,5666,5666,5666,5666,46,46,2,113320,2758
309,p1306,20130426,5666,5666,5666,5666,5602,5602,5644,-64,-22,6,338680,2758
310,p1306,20130502,5602,5644,5406,5406,5406,5406,5406,-238,-238,2,108120,756
311,p1306,20130503,5406,5406,5464,5598,5464,5598,5530,192,124,4,221240,754
312,p1306,20130506,5598,5530,5406,5678,5406,5552,5566,22,36,66,3674640,730
313,p1306,20130507,5552,5566,5598,5600,5598,5600,5598,34,32,16,895840,718
314,p1306,20130508,5600,5598,5608,5610,5594,5594,5604,-4,6,6,336240,714
315,p1306,20130509,5594,5604,5588,5588,5588,5588,5588,-16,-16,2,111760,714
316,p1306,20130510,5588,5588,5614,5772,5614,5730,5696,142,108,10,569680,710
317,p1306,20130513,5730,5696,5642,5642,5642,5642,5642,-54,-54,2,112840,710
318,p1306,20130514,5642,5642,5798,5798,5798,5798,5798,156,156,2,115960,710
319,p1306,20130515,5798,5798,5652,5698,5650,5698,5662,-100,-136,176,9965240,580
320,p1306,20130516,5698,5662,5780,5820,5720,5720,5794,58,132,40,2318360,578
321,p1306,20130517,5720,5794,5974,5974,5806,5840,5886,46,92,30,1766080,590
322,p1306,20130520,5840,5886,0,0,0,5886,5886,0,0,0,0,590
323,p1306,20130521,5886,5886,0,0,0,5886,5886,0,0,0,0,590
324,p1306,20130522,5886,5886,0,0,0,5886,5886,0,0,0,0,590
325,p1306,20130523,5886,5886,5760,5760,5672,5750,5738,-136,-148,26,1492320,584
326,p1306,20130524,5750,5738,5854,5854,5662,5840,5788,102,50,30,1736680,584
327,p1306,20130527,5840,5788,5738,5898,5692,5898,5788,110,0,8,463160,584
328,p1306,20130528,5898,5788,6000,6000,5822,5822,5880,34,92,10,588000,586
329,p1306,20130529,5822,5880,5700,5700,5700,5700,5700,-180,-180,2,114000,584
330,p1306,20130530,5700,5700,0,0,0,5700,5700,0,0,0,0,584
331,p1306,20130531,5700,5700,5702,5926,5702,5800,5810,100,110,80,4649040,566
332,p1306,20130603,5800,5810,5878,5950,5878,5950,5946,140,136,566,33658280,0
333,p1306,20130604,5950,5946,0,0,0,5946,5946,0,0,0,0,0
334,p1306,20130605,5946,5946,0,0,0,5946,5946,0,0,0,0,0
335,p1306,20130606,5946,5946,0,0,0,5946,5946,0,0,0,0,0
336,p1306,20130607,5946,5946,0,0,0,5946,5946,0,0,0,0,0
337,p1306,20130613,5946,5946,0,0,0,5946,5946,0,0,0,0,0
338,p1306,20130614,5946,5946,0,0,0,5946,5946,0,0,0,0,0
339,p1306,20130617,5946,5946,0,0,0,5946,5946,0,0,0,0,0
340,p1306,20130618,5946,5946,0,0,0,5946,5946,0,0,0,0,0
341,p1306,20130619,5946,5946,0,0,0,5946,5946,0,0,0,0,0
342,p1307,20130104,7104,7134,7166,7252,7122,7154,7158,20,24,14,1002200,16
343,p1307,20130107,7154,7158,7134,7134,7134,7134,7134,-24,-24,4,285360,12
344,p1307,20130108,7134,7134,7160,7162,7002,7050,7070,-84,-64,20,1414240,10
345,p1307,20130109,7050,7070,0,0,0,7070,7070,0,0,0,0,10
346,p1307,20130110,7070,7070,0,0,0,7070,7070,0,0,0,0,10
347,p1307,20130111,7070,7070,0,0,0,7070,7070,0,0,0,0,10
348,p1307,20130114,7070,7070,0,0,0,7070,7070,0,0,0,0,10
349,p1307,20130115,7070,7070,0,0,0,7070,7070,0,0,0,0,10
350,p1307,20130116,7070,7070,0,0,0,7070,7070,0,0,0,0,10
351,p1307,20130117,7070,7070,0,0,0,7070,7070,0,0,0,0,10
352,p1307,20130118,7070,7070,0,0,0,7070,7070,0,0,0,0,10
353,p1307,20130121,7070,7070,0,0,0,7070,7070,0,0,0,0,10
354,p1307,20130122,7070,7070,7070,7070,7070,7070,7070,0,0,2,141400,12
355,p1307,20130123,7070,7070,7034,7036,7034,7036,7034,-34,-36,4,281400,14
356,p1307,20130124,7036,7034,6896,6896,6896,6896,6896,-138,-138,2,137920,12
357,p1307,20130125,6896,6896,6908,6908,6908,6908,6908,12,12,2,138160,10
358,p1307,20130128,6908,6908,0,0,0,6908,6908,0,0,0,0,10
359,p1307,20130129,6908,6908,0,0,0,6908,6908,0,0,0,0,10
360,p1307,20130130,6908,6908,0,0,0,6908,6908,0,0,0,0,10
361,p1307,20130131,6908,6908,7034,7050,7034,7050,7042,142,134,4,281680,10
362,p1307,20130201,7050,7042,0,0,0,7042,7042,0,0,0,0,10
363,p1307,20130204,7042,7042,0,0,0,7042,7042,0,0,0,0,10
364,p1307,20130205,7042,7042,0,0,0,7042,7042,0,0,0,0,10
365,p1307,20130206,7042,7042,0,0,0,7042,7042,0,0,0,0,10
366,p1307,20130207,7042,7042,0,0,0,7042,7042,0,0,0,0,10
367,p1307,20130208,7042,7042,0,0,0,7042,7042,0,0,0,0,10
368,p1307,20130218,7042,7042,6942,6978,6942,6978,6952,-64,-90,12,834240,12
369,p1307,20130219,6978,6952,6998,6998,6998,6998,6998,46,46,2,139960,10
370,p1307,20130220,6998,6998,7010,7124,6990,7014,7024,16,26,84,5901080,14
371,p1307,20130221,7014,7024,6992,6992,6986,6986,6988,-38,-36,4,279560,12
372,p1307,20130222,6986,6988,6952,6952,6950,6950,6950,-38,-38,6,417040,10
373,p1307,20130225,6950,6950,6752,6752,6740,6740,6744,-210,-206,6,404640,12
374,p1307,20130226,6740,6744,6694,6700,6690,6690,6694,-54,-50,6,401680,12
375,p1307,20130227,6690,6694,6656,6656,6656,6656,6656,-38,-38,2,133120,10
376,p1307,20130228,6656,6656,0,0,0,6656,6656,0,0,0,0,10
377,p1307,20130301,6656,6656,0,0,0,6656,6656,0,0,0,0,10
378,p1307,20130304,6656,6656,0,0,0,6656,6656,0,0,0,0,10
379,p1307,20130305,6656,6656,6552,6552,6496,6496,6538,-160,-118,22,1438400,26
380,p1307,20130306,6496,6538,6512,6512,6512,6512,6512,-26,-26,2,130240,28
381,p1307,20130307,6512,6512,0,0,0,6512,6512,0,0,0,0,28
382,p1307,20130308,6512,6512,0,0,0,6512,6512,0,0,0,0,28
383,p1307,20130311,6512,6512,0,0,0,6512,6512,0,0,0,0,28
384,p1307,20130312,6512,6512,0,0,0,6512,6512,0,0,0,0,28
385,p1307,20130313,6512,6512,0,0,0,6512,6512,0,0,0,0,28
386,p1307,20130314,6512,6512,6350,6350,6252,6252,6284,-260,-228,6,377080,34
387,p1307,20130315,6252,6284,6258,6260,6190,6190,6240,-94,-44,8,499320,34
388,p1307,20130318,6190,6240,6182,6182,6096,6096,6138,-144,-102,4,245560,32
389,p1307,20130319,6096,6138,6216,6216,6216,6216,6216,78,78,2,124320,34
390,p1307,20130320,6216,6216,0,0,0,6216,6216,0,0,0,0,34
391,p1307,20130321,6216,6216,6290,6290,6290,6290,6290,74,74,2,125800,32
392,p1307,20130322,6290,6290,6314,6326,6290,6290,6312,0,22,20,1262640,36
393,p1307,20130325,6290,6312,6312,6312,6280,6280,6302,-32,-10,14,882320,28
394,p1307,20130326,6280,6302,6290,6290,6222,6222,6256,-80,-46,8,500480,28
395,p1307,20130327,6222,6256,0,0,0,6256,6256,0,0,0,0,28
396,p1307,20130328,6256,6256,0,0,0,6256,6256,0,0,0,0,28
397,p1307,20130329,6256,6256,0,0,0,6256,6256,0,0,0,0,28
398,p1307,20130401,6256,6256,6136,6138,6006,6006,6070,-250,-186,8,485720,28
399,p1307,20130402,6006,6070,6138,6138,6138,6138,6138,68,68,8,491040,32
400,p1307,20130403,6138,6138,6108,6166,6108,6128,6122,-10,-16,42,2571440,50
401,p1307,20130408,6128,6122,6080,6100,6080,6092,6094,-30,-28,16,975040,64
402,p1307,20130409,6092,6094,6118,6118,6080,6084,6090,-10,-4,16,974560,58
403,p1307,20130410,6084,6090,6132,6136,6104,6128,6120,38,30,24,1469080,68
404,p1307,20130411,6128,6120,6088,6100,6034,6034,6088,-86,-32,36,2192360,56
405,p1307,20130412,6034,6088,0,0,0,6088,6088,0,0,0,0,56
406,p1307,20130415,6088,6088,6020,6020,5854,5868,5902,-220,-186,8,472200,52
407,p1307,20130416,5868,5902,5894,5894,5894,5894,5894,-8,-8,2,117880,52
408,p1307,20130417,5894,5894,0,0,0,5896,5896,2,2,0,0,52
409,p1307,20130418,5896,5896,0,0,0,5842,5842,-54,-54,0,0,52
410,p1307,20130419,5842,5842,0,0,0,5872,5872,30,30,0,0,52
411,p1307,20130422,5872,5872,0,0,0,5826,5826,-46,-46,0,0,52
412,p1307,20130423,5826,5826,0,0,0,5800,5800,-26,-26,0,0,52
413,p1307,20130424,5800,5800,0,0,0,5770,5770,-30,-30,0,0,52
414,p1307,20130425,5770,5770,5950,5950,5950,5950,5950,180,180,4,238000,54
415,p1307,20130426,5950,5950,5830,5830,5696,5780,5780,-170,-170,114,6589760,52
416,p1307,20130502,5780,5780,0,0,0,5538,5538,-242,-242,0,0,52
417,p1307,20130503,5538,5538,5630,5636,5630,5636,5632,98,94,4,225320,52
418,p1307,20130506,5636,5632,5594,5654,5594,5654,5624,22,-8,4,224960,52
419,p1307,20130507,5654,5624,5606,5606,5606,5606,5606,-18,-18,4,224240,52
420,p1307,20130508,5606,5606,5626,5700,5626,5682,5668,76,62,20,1133600,46
421,p1307,20130509,5682,5668,5694,5694,5686,5686,5690,18,22,4,227600,44
422,p1307,20130510,5686,5690,5848,5850,5842,5850,5848,160,158,10,584800,44
423,p1307,20130513,5850,5848,5868,5982,5868,5970,5904,122,56,70,4133400,38
424,p1307,20130514,5970,5904,5910,5910,5910,5910,5910,6,6,2,118200,36
425,p1307,20130515,5910,5910,0,0,0,5772,5772,-138,-138,0,0,36
426,p1307,20130516,5772,5772,0,0,0,5772,5772,0,0,0,0,36
427,p1307,20130517,5772,5772,0,0,0,5862,5862,90,90,0,0,36
428,p1307,20130520,5862,5862,5816,5816,5816,5816,5816,-46,-46,2,116320,34
429,p1307,20130521,5816,5816,0,0,0,5816,5816,0,0,0,0,34
430,p1307,20130522,5816,5816,0,0,0,5838,5838,22,22,0,0,34
431,p1307,20130523,5838,5838,5812,5812,5812,5812,5812,-26,-26,4,232480,30
432,p1307,20130524,5812,5812,0,0,0,5812,5812,0,0,0,0,30
433,p1307,20130527,5812,5812,5870,5978,5870,5978,5906,166,94,6,354360,30
434,p1307,20130528,5978,5906,5918,6048,5918,6048,5982,142,76,4,239320,28
435,p1307,20130529,6048,5982,0,0,0,5982,5982,0,0,0,0,28
436,p1307,20130530,5982,5982,0,0,0,5982,5982,0,0,0,0,28
437,p1307,20130531,5982,5982,0,0,0,5982,5982,0,0,0,0,28
438,p1307,20130603,5982,5982,0,0,0,5982,5982,0,0,0,0,28
439,p1307,20130604,5982,5982,0,0,0,5982,5982,0,0,0,0,28
440,p1307,20130605,5982,5982,0,0,0,5982,5982,0,0,0,0,28
441,p1307,20130606,5982,5982,5930,5930,5930,5930,5930,-52,-52,2,118600,28
442,p1307,20130607,5930,5930,6008,6008,6008,6008,6008,78,78,2,120160,26
443,p1307,20130613,6008,6008,0,0,0,6008,6008,0,0,0,0,26
444,p1307,20130614,6008,6008,6216,6216,6006,6006,6110,-2,102,4,244440,26
445,p1307,20130617,6006,6110,0,0,0,6110,6110,0,0,0,0,26
446,p1307,20130618,6110,6110,0,0,0,6110,6110,0,0,0,0,26
447,p1307,20130619,6110,6110,0,0,0,6110,6110,0,0,0,0,26
448,p1307,20130620,6110,6110,0,0,0,6110,6110,0,0,0,0,26
449,p1307,20130621,6110,6110,5924,5924,5924,5924,5924,-186,-186,2,118480,24
450,p1307,20130624,5924,5924,0,0,0,5924,5924,0,0,0,0,24
451,p1307,20130625,5924,5924,5756,5768,5736,5736,5756,-188,-168,8,460480,26
452,p1307,20130626,5736,5756,0,0,0,5756,5756,0,0,0,0,26
453,p1307,20130627,5756,5756,5670,5780,5662,5700,5710,-56,-46,30,1713240,10
454,p1307,20130628,5700,5710,5482,5680,5482,5680,5574,-30,-136,10,557440,2
455,p1307,20130701,5680,5574,0,0,0,5574,5574,0,0,0,0,2
456,p1307,20130702,5574,5574,5690,5690,5690,5690,5690,116,116,2,113800,0
457,p1307,20130703,5690,5690,0,0,0,5690,5690,0,0,0,0,0
458,p1307,20130704,5690,5690,0,0,0,5690,5690,0,0,0,0,0
459,p1307,20130705,5690,5690,0,0,0,5690,5690,0,0,0,0,0
460,p1307,20130708,5690,5690,0,0,0,5690,5690,0,0,0,0,0
461,p1307,20130709,5690,5690,0,0,0,5690,5690,0,0,0,0,0
462,p1307,20130710,5690,5690,0,0,0,5690,5690,0,0,0,0,0
463,p1307,20130711,5690,5690,0,0,0,5690,5690,0,0,0,0,0
464,p1307,20130712,5690,5690,0,0,0,5690,5690,0,0,0,0,0
465,p1308,20130104,7194,7194,7096,7296,7054,7240,7162,46,-32,52,3724920,44
466,p1308,20130107,7240,7162,7296,7296,7186,7200,7226,38,64,48,3469200,40
467,p1308,20130108,7200,7226,7112,7138,7112,7120,7112,-106,-114,46,3272360,8
468,p1308,20130109,7120,7112,7120,7126,7072,7072,7102,-40,-10,26,1846880,6
469,p1308,20130110,7072,7102,7100,7100,7024,7030,7060,-72,-42,20,1412280,10
470,p1308,20130111,7030,7060,7056,7056,6920,6968,7000,-92,-60,32,2240360,12
471,p1308,20130114,6968,7000,0,0,0,7000,7000,0,0,0,0,12
472,p1308,20130115,7000,7000,0,0,0,7000,7000,0,0,0,0,12
473,p1308,20130116,7000,7000,0,0,0,7000,7000,0,0,0,0,12
474,p1308,20130117,7000,7000,7082,7082,7000,7002,7022,2,22,14,983320,14
475,p1308,20130118,7002,7022,7008,7008,7000,7000,7004,-22,-18,8,560320,14
476,p1308,20130121,7000,7004,7060,7060,7060,7060,7060,56,56,2,141200,14
477,p1308,20130122,7060,7060,7038,7120,7038,7082,7086,22,26,34,2409440,18
478,p1308,20130123,7082,7086,7132,7132,7076,7110,7110,24,24,20,1422160,16
479,p1308,20130124,7110,7110,0,0,0,7110,7110,0,0,0,0,16
480,p1308,20130125,7110,7110,0,0,0,7110,7110,0,0,0,0,16
481,p1308,20130128,7110,7110,6976,6978,6976,6978,6976,-132,-134,4,279080,16
482,p1308,20130129,6978,6976,6998,7096,6984,7016,7008,40,32,58,4065640,24
483,p1308,20130130,7016,7008,7052,7052,7052,7052,7052,44,44,2,141040,24
484,p1308,20130131,7052,7052,7150,7152,7076,7116,7128,64,76,106,7555960,30
485,p1308,20130201,7116,7128,7110,7160,7102,7160,7138,32,10,26,1856080,18
486,p1308,20130204,7160,7138,7236,7236,7142,7182,7188,44,50,12,862560,16
487,p1308,20130205,7182,7188,7164,7178,7086,7086,7142,-102,-46,18,1285680,18
488,p1308,20130206,7086,7142,7128,7146,7094,7094,7116,-48,-26,8,569320,16
489,p1308,20130207,7094,7116,0,0,0,7116,7116,0,0,0,0,16
490,p1308,20130208,7116,7116,0,0,0,7116,7116,0,0,0,0,16
491,p1308,20130218,7116,7116,7056,7056,6990,7050,7016,-66,-100,30,2104800,26
492,p1308,20130219,7050,7016,7100,7130,7062,7130,7082,114,66,24,1699720,20
493,p1308,20130220,7130,7082,7152,7152,7112,7118,7124,36,42,8,570000,18
494,p1308,20130221,7118,7124,7026,7026,6988,7012,7008,-112,-116,20,1401800,18
495,p1308,20130222,7012,7008,7038,7062,7010,7062,7024,54,16,136,9555120,14
496,p1308,20130225,7062,7024,6780,6808,6766,6802,6792,-222,-232,22,1494240,14
497,p1308,20130226,6802,6792,6780,6780,6696,6696,6738,-96,-54,4,269520,14
498,p1308,20130227,6696,6738,6558,6688,6538,6680,6658,-58,-80,28,1864560,14
499,p1308,20130228,6680,6658,0,0,0,6658,6658,0,0,0,0,14
500,p1308,20130301,6658,6658,6600,6600,6540,6540,6570,-118,-88,4,262800,14
501,p1308,20130304,6540,6570,6600,6600,6518,6574,6564,4,-6,6,393840,14
502,p1308,20130305,6574,6564,6650,6650,6598,6598,6624,34,60,4,264960,18
503,p1308,20130306,6598,6624,6636,6636,6590,6592,6614,-32,-10,74,4895040,16
504,p1308,20130307,6592,6614,6582,6582,6556,6562,6570,-52,-44,58,3810640,16
505,p1308,20130308,6562,6570,6628,6628,6612,6612,6620,42,50,24,1589120,12
506,p1308,20130311,6612,6620,0,0,0,6620,6620,0,0,0,0,12
507,p1308,20130312,6620,6620,6550,6550,6502,6540,6524,-80,-96,18,1174440,12
508,p1308,20130313,6540,6524,6310,6390,6304,6304,6358,-220,-166,54,3433680,28
509,p1308,20130314,6304,6358,6260,6260,6220,6220,6242,-138,-116,6,374560,26
510,p1308,20130315,6220,6242,6360,6360,6360,6360,6360,118,118,2,127200,28
511,p1308,20130318,6360,6360,6318,6382,6230,6230,6306,-130,-54,60,3784000,42
512,p1308,20130319,6230,6306,6338,6338,6176,6330,6298,24,-8,24,1511520,34
513,p1308,20130320,6330,6298,6314,6330,6306,6306,6314,8,16,102,6441400,28
514,p1308,20130321,6306,6314,6380,6400,6376,6400,6382,86,68,18,1148960,26
515,p1308,20130322,6400,6382,6378,6378,6378,6378,6378,-4,-4,2,127560,26
516,p1308,20130325,6378,6378,0,0,0,6378,6378,0,0,0,0,26
517,p1308,20130326,6378,6378,0,0,0,6378,6378,0,0,0,0,26
518,p1308,20130327,6378,6378,0,0,0,6378,6378,0,0,0,0,26
519,p1308,20130328,6378,6378,6296,6298,6244,6244,6274,-134,-104,14,878520,26
520,p1308,20130329,6244,6274,6156,6180,6156,6180,6170,-94,-104,12,740560,26
521,p1308,20130401,6180,6170,6116,6116,6116,6116,6116,-54,-54,10,611600,26
522,p1308,20130402,6116,6116,6116,6116,6042,6110,6092,-6,-24,16,975000,28
523,p1308,20130403,6110,6092,0,0,0,6092,6092,0,0,0,0,28
524,p1308,20130408,6092,6092,6092,6202,6092,6202,6146,110,54,4,245880,28
525,p1308,20130409,6202,6146,6244,6268,6244,6268,6256,122,110,4,250240,28
526,p1308,20130410,6268,6256,6278,6294,6254,6294,6274,38,18,12,752960,28
527,p1308,20130411,6294,6274,0,0,0,6274,6274,0,0,0,0,28
528,p1308,20130412,6274,6274,6202,6202,6168,6198,6190,-76,-84,8,495320,28
529,p1308,20130415,6198,6190,6112,6112,6112,6112,6112,-78,-78,2,122240,28
530,p1308,20130416,6112,6112,0,0,0,6112,6112,0,0,0,0,28
531,p1308,20130417,6112,6112,0,0,0,6114,6114,2,2,0,0,28
532,p1308,20130418,6114,6114,5894,6020,5894,6020,5944,-94,-170,6,356640,28
533,p1308,20130419,6020,5944,6058,6064,6004,6004,6034,60,90,70,4225120,50
534,p1308,20130422,6004,6034,0,0,0,5986,5986,-48,-48,0,0,50
535,p1308,20130423,5986,5986,0,0,0,5960,5960,-26,-26,0,0,50
536,p1308,20130424,5960,5960,5810,6016,5792,5808,5874,-152,-86,42,2467080,54
537,p1308,20130425,5808,5874,5882,5882,5856,5856,5868,-18,-6,12,704160,48
538,p1308,20130426,5856,5868,5846,5846,5830,5846,5840,-22,-28,18,1051320,34
539,p1308,20130502,5846,5840,5846,5848,5756,5768,5832,-72,-8,24,1399880,48
540,p1308,20130503,5768,5832,5776,5850,5776,5818,5822,-14,-10,54,3144440,48
541,p1308,20130506,5818,5822,5860,5868,5728,5806,5786,-16,-36,40,2314720,42
542,p1308,20130507,5806,5786,5834,5898,5818,5818,5854,32,68,10,585400,40
543,p1308,20130508,5818,5854,5852,5880,5832,5852,5852,-2,-2,18,1053680,44
544,p1308,20130509,5852,5852,5872,5888,5828,5888,5866,36,14,10,586680,44
545,p1308,20130510,5888,5866,5884,6030,5872,6018,5924,152,58,34,2014160,42
546,p1308,20130513,6018,5924,6044,6050,6040,6040,6046,116,122,10,604600,44
547,p1308,20130514,6040,6046,6030,6100,5956,6018,6008,-28,-38,38,2283760,42
548,p1308,20130515,6018,6008,5852,5860,5768,5860,5778,-148,-230,56,3236640,94
549,p1308,20130516,5860,5778,5856,5998,5856,5962,5946,184,168,106,6303840,46
550,p1308,20130517,5962,5946,5932,5996,5932,5996,5946,50,0,14,832480,54
551,p1308,20130520,5996,5946,5996,5996,5934,5934,5964,-12,18,12,715800,54
552,p1308,20130521,5934,5964,5942,5942,5908,5908,5924,-56,-40,4,237000,54
553,p1308,20130522,5908,5924,5982,6052,5980,6028,5998,104,74,16,959800,52
554,p1308,20130523,6028,5998,0,0,0,5966,5966,-32,-32,0,0,52
555,p1308,20130524,5966,5966,6036,6090,5998,6038,6052,72,86,48,2905320,50
556,p1308,20130527,6038,6052,0,0,0,6026,6026,-26,-26,0,0,50
557,p1308,20130528,6026,6026,6038,6042,6012,6042,6026,16,0,60,3616640,52
558,p1308,20130529,6042,6026,5982,6134,5982,6130,6100,104,74,10,610120,54
559,p1308,20130530,6130,6100,6010,6010,5986,5986,6000,-114,-100,28,1680040,50
560,p1308,20130531,5986,6000,6016,6016,6016,6016,6016,16,16,2,120320,50
561,p1308,20130603,6016,6016,6062,6062,6062,6062,6062,46,46,2,121240,50
562,p1308,20130604,6062,6062,6012,6012,6012,6012,6012,-50,-50,6,360720,50
563,p1308,20130605,6012,6012,0,0,0,6012,6012,0,0,0,0,50
564,p1308,20130606,6012,6012,5968,6014,5968,6012,5998,0,-14,12,719760,42
565,p1308,20130607,6012,5998,6132,6132,6130,6130,6130,132,132,4,245240,38
566,p1308,20130613,6130,6130,6130,6202,6130,6134,6152,4,22,8,492160,34
567,p1308,20130614,6134,6152,6054,6088,6040,6088,6062,-64,-90,14,848920,30
568,p1308,20130617,6088,6062,6100,6100,6082,6082,6092,20,30,6,365600,26
569,p1308,20130618,6082,6092,0,0,0,6092,6092,0,0,0,0,26
570,p1308,20130619,6092,6092,6026,6026,6026,6026,6026,-66,-66,2,120520,24
571,p1308,20130620,6026,6026,6026,6026,6018,6018,6022,-8,-4,4,240880,24
572,p1308,20130621,6018,6022,0,0,0,5900,5900,-122,-122,0,0,24
573,p1308,20130624,5900,5900,0,0,0,5900,5900,0,0,0,0,24
574,p1308,20130625,5900,5900,5808,5808,5808,5808,5808,-92,-92,2,116160,22
575,p1308,20130626,5808,5808,5730,5730,5730,5730,5730,-78,-78,2,114600,22
576,p1308,20130627,5730,5730,0,0,0,5730,5730,0,0,0,0,22
577,p1308,20130628,5730,5730,0,0,0,5730,5730,0,0,0,0,22
578,p1308,20130701,5730,5730,5700,5700,5700,5700,5700,-30,-30,2,114000,20
579,p1308,20130702,5700,5700,5700,5712,5700,5710,5708,10,8,8,456680,20
580,p1308,20130703,5710,5708,5736,5736,5736,5736,5736,28,28,2,114720,18
581,p1308,20130704,5736,5736,0,0,0,5736,5736,0,0,0,0,18
582,p1308,20130705,5736,5736,5742,5742,5742,5742,5742,6,6,2,114840,16
583,p1308,20130708,5742,5742,5730,5730,5730,5730,5730,-12,-12,2,114600,14
584,p1308,20130709,5730,5730,0,0,0,5730,5730,0,0,0,0,14
585,p1308,20130710,5730,5730,0,0,0,5730,5730,0,0,0,0,14
586,p1308,20130711,5730,5730,0,0,0,5730,5730,0,0,0,0,14
587,p1308,20130712,5730,5730,0,0,0,5730,5730,0,0,0,0,14
588,p1308,20130715,5730,5730,5560,5560,5560,5560,5560,-170,-170,2,111200,12
589,p1308,20130716,5560,5560,0,0,0,5560,5560,0,0,0,0,12
590,p1308,20130717,5560,5560,0,0,0,5560,5560,0,0,0,0,12
591,p1308,20130718,5560,5560,5520,5520,5520,5520,5520,-40,-40,4,220800,12
592,p1308,20130719,5520,5520,0,0,0,5520,5520,0,0,0,0,12
593,p1308,20130722,5520,5520,0,0,0,5520,5520,0,0,0,0,12
594,p1308,20130723,5520,5520,0,0,0,5520,5520,0,0,0,0,12
595,p1308,20130724,5520,5520,0,0,0,5520,5520,0,0,0,0,12
596,p1308,20130725,5520,5520,0,0,0,5520,5520,0,0,0,0,12
597,p1308,20130726,5520,5520,5300,5300,5300,5300,5300,-220,-220,2,106000,10
598,p1308,20130729,5300,5300,0,0,0,5300,5300,0,0,0,0,10
599,p1308,20130730,5300,5300,5300,5300,5300,5300,5300,0,0,2,106000,8
600,p1308,20130731,5300,5300,5496,5496,5300,5370,5380,70,80,10,538160,2
601,p1308,20130801,5370,5380,0,0,0,5380,5380,0,0,0,0,2
602,p1308,20130802,5380,5380,0,0,0,5380,5380,0,0,0,0,2
603,p1308,20130805,5380,5380,0,0,0,5380,5380,0,0,0,0,2
604,p1308,20130806,5380,5380,0,0,0,5380,5380,0,0,0,0,2
605,p1308,20130807,5380,5380,5650,5650,5650,5650,5650,270,270,2,113000,0
606,p1308,20130808,5650,5650,0,0,0,5650,5650,0,0,0,0,0
607,p1308,20130809,5650,5650,0,0,0,5650,5650,0,0,0,0,0
608,p1308,20130812,5650,5650,0,0,0,5650,5650,0,0,0,0,0
609,p1308,20130813,5650,5650,0,0,0,5650,5650,0,0,0,0,0
610,p1308,20130814,5650,5650,0,0,0,5650,5650,0,0,0,0,0
611,p1309,20130104,7214,7262,7236,7344,7192,7328,7292,66,30,249150,18170480680,228334
612,p1309,20130107,7328,7292,7256,7320,7224,7252,7272,-40,-20,287490,20908000000,255306
613,p1309,20130108,7252,7272,7250,7264,7116,7126,7174,-146,-98,332578,23861495880,216504
614,p1309,20130109,7126,7174,7124,7154,7094,7102,7126,-72,-48,281024,20027036320,240880
615,p1309,20130110,7102,7126,7126,7182,7020,7022,7114,-104,-12,557948,39703229360,275702
616,p1309,20130111,7022,7114,7040,7050,6920,6930,6986,-184,-128,396654,27716543560,258900
617,p1309,20130114,6930,6986,6978,7014,6934,6980,6978,-6,-8,289460,20201290360,266538
618,p1309,20130115,6980,6978,7060,7086,6986,6992,7036,14,58,305914,21526069800,288256
619,p1309,20130116,6992,7036,7030,7068,7010,7060,7044,24,8,196850,13868270400,282686
620,p1309,20130117,7060,7044,7078,7106,6972,6982,7034,-62,-10,300556,21141593960,302126
621,p1309,20130118,6982,7034,6980,7042,6936,7040,6994,6,-40,318416,22270876400,301806
622,p1309,20130121,7040,6994,7040,7080,7020,7058,7052,64,58,238560,16824654800,310256
623,p1309,20130122,7058,7052,7054,7140,7054,7138,7102,86,50,356916,25350150440,331412
624,p1309,20130123,7138,7102,7146,7166,7098,7134,7130,32,28,290638,20723971280,334754
625,p1309,20130124,7134,7130,7118,7118,6992,7018,7048,-112,-82,431516,30415819920,309614
626,p1309,20130125,7018,7048,7054,7076,7024,7024,7042,-24,-6,295796,20832558200,322866
627,p1309,20130128,7024,7042,7038,7046,6964,7028,7006,-14,-36,398844,27946258120,334136
628,p1309,20130129,7028,7006,7020,7038,6982,7014,7008,8,2,347106,24328910080,343466
629,p1309,20130130,7014,7008,7008,7080,7000,7072,7054,64,46,361290,25487776720,360076
630,p1309,20130131,7072,7054,7138,7180,7088,7176,7138,122,84,435902,31120407360,374834
631,p1309,20130201,7176,7138,7176,7210,7130,7204,7174,66,36,635786,45620947280,424930
632,p1309,20130204,7204,7174,7216,7252,7180,7190,7218,16,44,479612,34627726600,451686
633,p1309,20130205,7190,7218,7170,7196,7142,7156,7168,-62,-50,454762,32602952680,450168
634,p1309,20130206,7156,7168,7156,7186,7122,7136,7154,-32,-14,293486,21000461440,450512
635,p1309,20130207,7136,7154,7144,7146,7078,7116,7112,-38,-42,334800,23817478080,434732
636,p1309,20130208,7116,7112,7102,7156,7082,7088,7124,-24,12,307504,21911195080,454020
637,p1309,20130218,7088,7124,7018,7082,7000,7056,7052,-68,-72,350084,24689320240,476966
638,p1309,20130219,7056,7052,7068,7130,7064,7118,7108,66,56,384710,27347785400,514760
639,p1309,20130220,7118,7108,7148,7170,7110,7124,7138,16,30,318866,22765666680,519912
640,p1309,20130221,7124,7138,7084,7086,6964,7024,7020,-114,-118,568116,39883109040,494836
641,p1309,20130222,7024,7020,7010,7104,6992,7066,7048,46,28,580722,40939521480,533476
642,p1309,20130225,7066,7048,6950,6960,6768,6780,6812,-268,-236,799048,54443919560,519496
643,p1309,20130226,6780,6812,6780,6828,6698,6702,6768,-110,-44,734330,49706569280,501916
644,p1309,20130227,6702,6768,6728,6744,6676,6732,6716,-36,-52,458156,30777430560,500744
645,p1309,20130228,6732,6716,6730,6756,6622,6624,6674,-92,-42,948238,63299526240,591986
646,p1309,20130301,6624,6674,6602,6646,6582,6608,6608,-66,-66,655196,43306274360,548520
647,p1309,20130304,6608,6608,6620,6666,6596,6644,6638,36,30,515800,34240330480,532636
648,p1309,20130305,6644,6638,6688,6696,6572,6602,6626,-36,-12,689472,45697060840,634598
649,p1309,20130306,6602,6626,6606,6664,6560,6612,6622,-14,-4,664798,44023914120,584930
650,p1309,20130307,6612,6622,6600,6636,6566,6570,6598,-52,-24,485582,32044320240,599634
651,p1309,20130308,6570,6598,6640,6642,6606,6622,6624,24,26,350178,23197649280,562902
652,p1309,20130311,6622,6624,6626,6636,6576,6578,6600,-46,-24,450108,29715228120,582012
653,p1309,20130312,6578,6600,6598,6602,6500,6510,6546,-90,-54,570042,37317141720,603258
654,p1309,20130313,6510,6546,6510,6510,6336,6340,6396,-206,-150,654390,41865084960,612188
655,p1309,20130314,6340,6396,6350,6358,6246,6264,6290,-132,-106,670986,42216667040,598912
656,p1309,20130315,6264,6290,6280,6390,6252,6362,6320,72,30,742690,46951368040,588568
657,p1309,20130318,6362,6320,6314,6346,6220,6276,6294,-44,-26,542104,34123298160,562516
658,p1309,20130319,6276,6294,6302,6350,6302,6332,6326,38,32,352622,22311847280,562332
659,p1309,20130320,6332,6326,6296,6360,6276,6344,6328,18,2,328446,20790400400,551520
660,p1309,20130321,6344,6328,6380,6460,6374,6412,6426,84,98,499458,32096884480,556712
661,p1309,20130322,6412,6426,6406,6448,6370,6386,6406,-40,-20,434108,27810334120,562458
662,p1309,20130325,6386,6406,6444,6478,6402,6416,6436,10,30,436712,28110309160,546388
663,p1309,20130326,6416,6436,6410,6414,6332,6360,6366,-76,-70,512484,32631782320,535228
664,p1309,20130327,6360,6366,6388,6418,6346,6416,6382,50,16,421224,26886339240,523970
665,p1309,20130328,6416,6382,6410,6420,6278,6294,6328,-88,-54,593314,37553042200,552746
666,p1309,20130329,6294,6328,6208,6266,6102,6246,6222,-82,-106,586028,36469126240,524140
667,p1309,20130401,6246,6222,6210,6246,6118,6120,6172,-102,-50,444522,27443428640,516510
668,p1309,20130402,6120,6172,6120,6232,6112,6228,6162,56,-10,663122,40873785880,511568
669,p1309,20130403,6228,6162,6200,6300,6166,6216,6238,54,76,851898,53153977440,493870
670,p1309,20130408,6216,6238,6170,6294,6168,6282,6260,44,22,537224,33637792440,532840
671,p1309,20130409,6282,6260,6300,6358,6298,6326,6332,66,72,423328,26809171000,527816
672,p1309,20130410,6326,6332,6358,6410,6312,6396,6368,64,36,603664,38445353280,538364
673,p1309,20130411,6396,6368,6360,6392,6288,6292,6338,-76,-30,590408,37421329080,536302
674,p1309,20130412,6292,6338,6294,6338,6268,6326,6306,-12,-32,476378,30043926400,542302
675,p1309,20130415,6326,6306,6260,6276,6130,6168,6190,-138,-116,548920,33983793080,525328
676,p1309,20130416,6168,6190,6100,6162,6034,6148,6116,-42,-74,623680,38150299520,545248
677,p1309,20130417,6148,6116,6170,6210,6080,6112,6144,-4,28,496658,30516652840,518346
678,p1309,20130418,6112,6144,6092,6114,6026,6086,6074,-58,-70,482780,29330429040,519666
679,p1309,20130419,6086,6074,6112,6158,6104,6120,6130,46,56,458732,28128591600,507836
680,p1309,20130422,6120,6130,6088,6090,5958,5958,6012,-172,-118,571482,34364479000,540928
681,p1309,20130423,5958,6012,5958,6046,5938,6020,5998,8,-14,605500,36324650480,538456
682,p1309,20130424,6020,5998,6008,6056,5924,5936,5976,-62,-22,649808,38832723960,532736
683,p1309,20130425,5936,5976,5980,6042,5968,5980,6008,4,32,576998,34671849440,532196
684,p1309,20130426,5980,6008,6022,6048,5950,5950,5996,-58,-12,564616,33859044840,538004
685,p1309,20130502,5950,5996,5900,5900,5826,5834,5844,-162,-152,370838,21678463080,551932
686,p1309,20130503,5834,5844,5844,5926,5844,5884,5888,40,44,476546,28059385960,540552
687,p1309,20130506,5884,5888,5920,5970,5880,5948,5922,60,34,529046,31331536360,548598
688,p1309,20130507,5948,5922,5916,5964,5896,5904,5932,-18,10,491882,29180973520,552930
689,p1309,20130508,5904,5932,5926,5996,5914,5986,5970,54,38,582908,34802788720,563548
690,p1309,20130509,5986,5970,5970,6008,5944,5966,5968,-4,-2,363968,21727451640,565212
691,p1309,20130510,5966,5968,5982,6146,5974,6120,6062,152,94,904302,54830464200,602718
692,p1309,20130513,6120,6062,6118,6170,6102,6118,6132,56,70,613534,37625257000,589420
693,p1309,20130514,6118,6132,6156,6176,6096,6110,6128,-22,-4,496924,30461368240,576502
694,p1309,20130515,6110,6128,6120,6120,5934,5954,6014,-174,-114,716102,43074692360,538212
695,p1309,20130516,5954,6014,5968,6090,5942,6042,6020,28,6,715242,43060052160,524218
696,p1309,20130517,6042,6020,6066,6098,6048,6078,6074,58,54,457586,27799509040,536030
697,p1309,20130520,6078,6074,6092,6094,6016,6046,6054,-28,-20,569074,34452964360,539908
698,p1309,20130521,6046,6054,6040,6070,6000,6048,6030,-6,-24,462942,27922442800,521574
699,p1309,20130522,6048,6030,6060,6136,6056,6104,6102,74,72,557486,34021708840,522598
700,p1309,20130523,6104,6102,6124,6130,6034,6048,6070,-54,-32,435272,26429006160,512390
701,p1309,20130524,6048,6070,6070,6180,6062,6118,6140,48,70,688968,42311061720,531928
702,p1309,20130527,6118,6140,6098,6138,6070,6132,6112,-8,-28,342284,20926010640,537344
703,p1309,20130528,6132,6112,6146,6196,6130,6164,6160,52,48,538896,33201114320,563390
704,p1309,20130529,6164,6160,6170,6254,6162,6200,6204,40,44,536738,33307137800,557468
705,p1309,20130530,6200,6204,6154,6192,6114,6144,6150,-60,-54,494066,30390868960,535202
706,p1309,20130531,6144,6150,6144,6182,6130,6140,6152,-10,2,323952,19933297680,537932
707,p1309,20130603,6140,6152,6160,6208,6158,6192,6186,40,34,316442,19580831480,528810
708,p1309,20130604,6192,6186,6196,6202,6090,6102,6122,-84,-64,420472,25744640600,528122
709,p1309,20130605,6102,6122,6112,6124,6064,6090,6086,-32,-36,335878,20447214480,508200
710,p1309,20130606,6090,6086,6072,6186,6072,6166,6144,80,58,509870,31329267360,474346
711,p1309,20130607,6166,6144,6190,6382,6152,6358,6294,214,150,1177478,74124016760,477692
712,p1309,20130613,6358,6294,6318,6348,6250,6276,6294,-18,0,470396,29610887960,438102
713,p1309,20130614,6276,6294,6270,6270,6186,6210,6212,-84,-82,370464,23017867920,409782
714,p1309,20130617,6210,6212,6230,6236,6192,6208,6214,-4,2,230902,14352190960,408606
715,p1309,20130618,6208,6214,6240,6260,6206,6206,6228,-8,14,198496,12365139720,382386
716,p1309,20130619,6206,6228,6200,6202,6150,6166,6168,-62,-60,154718,9543809320,376194
717,p1309,20130620,6166,6168,6186,6186,6102,6116,6146,-52,-22,194744,11970991320,345390
718,p1309,20130621,6116,6146,6066,6066,5928,5968,5978,-178,-168,254618,15225565360,333828
719,p1309,20130624,5968,5978,5910,5980,5900,5912,5934,-66,-44,205510,12198007440,267682
720,p1309,20130625,5912,5934,5950,5952,5860,5898,5892,-36,-42,146578,8639261320,263356
721,p1309,20130626,5898,5892,5888,5916,5796,5830,5850,-62,-42,116422,6812451120,250896
722,p1309,20130627,5830,5850,5830,5830,5756,5786,5780,-64,-70,94790,5479491680,241186
723,p1309,20130628,5786,5780,5760,5828,5760,5784,5798,4,18,67818,3933045960,235638
724,p1309,20130701,5784,5798,5788,5860,5762,5842,5830,44,32,57560,3356146800,228930
725,p1309,20130702,5842,5830,5828,5870,5808,5828,5834,-2,4,59270,3458920520,224872
726,p1309,20130703,5828,5834,5812,5846,5808,5834,5826,0,-8,47250,2752793480,212432
727,p1309,20130704,5834,5826,5840,5884,5840,5856,5864,30,38,42360,2484758280,208204
728,p1309,20130705,5856,5864,5870,5870,5816,5830,5830,-34,-34,27620,1610666320,205448
729,p1309,20130708,5830,5830,5850,5882,5784,5788,5822,-42,-8,38522,2243045680,196500
730,p1309,20130709,5788,5822,5800,5822,5790,5808,5804,-14,-18,21856,1268905920,191238
731,p1309,20130710,5808,5804,5822,5856,5768,5806,5808,2,4,41206,2393455800,180418
732,p1309,20130711,5806,5808,5812,5894,5812,5850,5846,42,38,49758,2909747200,165784
733,p1309,20130712,5850,5846,5812,5832,5748,5750,5774,-96,-72,34202,1974852240,159888
734,p1309,20130715,5750,5774,5720,5720,5552,5594,5628,-180,-146,42558,2395488360,150246
735,p1309,20130716,5594,5628,5630,5630,5570,5596,5594,-32,-34,18492,1034736400,146968
736,p1309,20130717,5596,5594,5574,5614,5550,5574,5576,-20,-18,26050,1452577720,140180
737,p1309,20130718,5574,5576,5522,5602,5522,5580,5566,4,-10,23620,1314887560,132778
738,p1309,20130719,5580,5566,5590,5610,5536,5560,5576,-6,10,14548,811250840,129810
739,p1309,20130722,5560,5576,5558,5580,5528,5550,5556,-26,-20,17190,955076640,122120
740,p1309,20130723,5550,5556,5528,5568,5528,5562,5552,6,-4,19836,1101546880,115808
741,p1309,20130724,5562,5552,5538,5538,5470,5504,5506,-48,-46,16980,935118880,108378
742,p1309,20130725,5504,5506,5470,5482,5436,5474,5470,-32,-36,21828,1194119640,98530
743,p1309,20130726,5474,5470,5432,5448,5332,5338,5376,-132,-94,23552,1266566880,87278
744,p1309,20130729,5338,5376,5340,5376,5326,5330,5348,-46,-28,11728,627325520,82554
745,p1309,20130730,5330,5348,5290,5388,5278,5376,5344,28,-4,25004,1336407280,76224
746,p1309,20130731,5376,5344,5364,5474,5360,5454,5440,110,96,20340,1106812920,73620
747,p1309,20130801,5454,5440,5440,5482,5422,5474,5450,34,10,8934,487024600,70706
748,p1309,20130802,5474,5450,5488,5584,5488,5550,5542,100,92,25396,1407512240,68494
749,p1309,20130805,5550,5542,5540,5540,5456,5496,5494,-46,-48,12206,670656800,66320
750,p1309,20130806,5496,5494,5490,5546,5458,5468,5488,-26,-6,3680,201994680,65146
751,p1309,20130807,5468,5488,5448,5466,5410,5418,5432,-70,-56,21074,1144856640,65170
752,p1309,20130808,5418,5432,5408,5462,5376,5404,5406,-28,-26,22696,1227338080,51968
753,p1309,20130809,5404,5406,5414,5480,5382,5418,5416,12,10,17072,924626680,47286
754,p1309,20130812,5418,5416,5436,5444,5362,5430,5400,14,-16,13896,750477320,41522
755,p1309,20130813,5430,5400,5480,5574,5470,5552,5534,152,134,12128,671346600,35996
756,p1309,20130814,5552,5534,5542,5570,5406,5418,5482,-116,-52,14952,819705760,29938
757,p1309,20130815,5418,5482,5432,5454,5390,5410,5412,-72,-70,6776,366819360,27664
758,p1309,20130816,5410,5412,5500,5500,5430,5454,5462,42,50,4496,245617080,25338
759,p1309,20130819,5454,5462,5476,5482,5444,5446,5454,-16,-8,4852,264661200,24084
760,p1309,20130820,5446,5454,5478,5478,5368,5388,5430,-66,-24,3472,188593040,22458
761,p1309,20130821,5388,5430,5388,5406,5338,5398,5390,-32,-40,2868,154617280,20882
762,p1309,20130822,5398,5390,5372,5408,5344,5398,5388,8,-2,1432,77175080,20540
763,p1309,20130823,5398,5388,5410,5410,5382,5390,5392,2,4,1024,55223720,20500
764,p1309,20130826,5390,5392,5466,5604,5452,5602,5524,210,132,3654,201882520,19468
765,p1309,20130827,5602,5524,5576,5604,5534,5550,5566,26,42,5908,328911920,18746
766,p1309,20130828,5550,5566,5550,5600,5504,5546,5560,-20,-6,5480,304735480,17330
767,p1309,20130829,5546,5560,5570,5638,5370,5450,5488,-110,-72,2860,156993880,18296
768,p1309,20130830,5450,5488,5402,5420,5320,5380,5398,-108,-90,6128,330859360,16692
769,p1309,20130902,5380,5398,5380,5490,5380,5480,5442,82,44,588,32001240,16304
770,p1309,20130903,5480,5442,5430,5470,5430,5470,5444,28,2,1600,87122800,14992
771,p1309,20130904,5470,5444,5420,5452,5420,5452,5422,8,-22,372,20176960,14892
772,p1309,20130905,5452,5422,5460,5460,5430,5438,5440,16,18,4260,231752400,11032
773,p1309,20130906,5438,5440,5460,5510,5404,5450,5468,10,28,1442,78875600,10840
774,p1309,20130909,5450,5468,0,0,0,5468,5468,0,0,0,0,10840
775,p1309,20130910,5468,5468,5450,5450,5382,5382,5430,-86,-38,340,18466800,10660
776,p1309,20130911,5382,5430,5442,5450,5402,5402,5448,-28,18,468,25497040,10200
777,p1309,20130912,5402,5448,0,0,0,5448,5448,0,0,0,0,10200
778,p1309,20130913,5448,5448,5410,5410,5330,5330,5442,-118,-6,300,16168600,0
779,p1310,20130104,7350,7350,0,0,0,7350,7350,0,0,0,0,12
780,p1310,20130107,7350,7350,0,0,0,7350,7350,0,0,0,0,12
781,p1310,20130108,7350,7350,0,0,0,7350,7350,0,0,0,0,12
782,p1310,20130109,7350,7350,7152,7178,7152,7178,7168,-172,-182,6,430160,12
783,p1310,20130110,7178,7168,7098,7098,7098,7098,7098,-70,-70,2,141960,12
784,p1310,20130111,7098,7098,6992,6992,6950,6950,6970,-148,-128,4,278840,12
785,p1310,20130114,6950,6970,7024,7024,6962,6962,6992,-8,22,4,279720,12
786,p1310,20130115,6962,6992,7046,7046,7046,7046,7046,54,54,2,140920,10
787,p1310,20130116,7046,7046,7090,7090,7090,7090,7090,44,44,2,141800,8
788,p1310,20130117,7090,7090,7160,7162,7058,7058,7112,-32,22,22,1564720,8
789,p1310,20130118,7058,7112,7068,7068,7068,7068,7068,-44,-44,2,141360,8
790,p1310,20130121,7068,7068,0,0,0,7068,7068,0,0,0,0,8
791,p1310,20130122,7068,7068,7072,7072,7072,7072,7072,4,4,2,141440,10
792,p1310,20130123,7072,7072,7210,7210,7088,7132,7144,60,72,8,571600,8
793,p1310,20130124,7132,7144,7056,7056,7040,7040,7044,-104,-100,8,563520,10
794,p1310,20130125,7040,7044,7074,7074,7074,7074,7074,30,30,2,141480,12
795,p1310,20130128,7074,7074,7022,7022,7020,7020,7020,-54,-54,6,421280,12
796,p1310,20130129,7020,7020,0,0,0,7020,7020,0,0,0,0,12
797,p1310,20130130,7020,7020,0,0,0,7020,7020,0,0,0,0,12
798,p1310,20130131,7020,7020,7100,7160,7100,7160,7130,140,110,4,285200,10
799,p1310,20130201,7160,7130,7210,7256,7066,7186,7176,56,46,30,2153080,12
800,p1310,20130204,7186,7176,7186,7286,7186,7238,7236,62,60,14,1013280,10
801,p1310,20130205,7238,7236,7160,7160,7160,7160,7160,-76,-76,2,143200,10
802,p1310,20130206,7160,7160,7118,7182,7118,7170,7154,10,-6,62,4436400,14
803,p1310,20130207,7170,7154,7112,7136,7096,7136,7114,-18,-40,8,569160,14
804,p1310,20130208,7136,7114,7230,7230,7126,7154,7146,40,32,26,1858120,8
805,p1310,20130218,7154,7146,7056,7058,7056,7058,7056,-88,-90,4,282280,8
806,p1310,20130219,7058,7056,7116,7140,7116,7124,7130,68,74,24,1711400,8
807,p1310,20130220,7124,7130,7152,7152,7140,7142,7144,12,14,6,428680,10
808,p1310,20130221,7142,7144,7034,7060,7010,7042,7028,-102,-116,56,3936480,10
809,p1310,20130222,7042,7028,7088,7128,7088,7096,7104,68,76,6,426240,10
810,p1310,20130225,7096,7104,6886,6886,6846,6886,6870,-218,-234,20,1374040,6
811,p1310,20130226,6886,6870,6806,6806,6746,6766,6764,-104,-106,26,1759000,10
812,p1310,20130227,6766,6764,6750,6770,6722,6770,6752,6,-12,182,12288840,14
813,p1310,20130228,6770,6752,0,0,0,6752,6752,0,0,0,0,14
814,p1310,20130301,6752,6752,6734,6734,6734,6734,6734,-18,-18,6,404040,20
815,p1310,20130304,6734,6734,6680,6716,6680,6684,6696,-50,-38,26,1741400,18
816,p1310,20130305,6684,6696,6660,6698,6646,6680,6672,-16,-24,12,800640,18
817,p1310,20130306,6680,6672,6706,6734,6694,6694,6710,22,38,6,402680,18
818,p1310,20130307,6694,6710,6580,6706,6580,6638,6668,-72,-42,76,5067800,18
819,p1310,20130308,6638,6668,6674,6724,6674,6680,6686,12,18,12,802360,16
820,p1310,20130311,6680,6686,6642,6662,6642,6662,6652,-24,-34,20,1330400,12
821,p1310,20130312,6662,6652,6588,6596,6570,6574,6588,-78,-64,24,1581240,12
822,p1310,20130313,6574,6588,6454,6484,6420,6430,6456,-158,-132,26,1678640,10
823,p1310,20130314,6430,6456,6380,6382,6264,6264,6312,-192,-144,44,2777800,24
824,p1310,20130315,6264,6312,6316,6388,6294,6388,6324,76,12,28,1770720,24
825,p1310,20130318,6388,6324,6342,6432,6336,6336,6372,12,48,34,2166560,24
826,p1310,20130319,6336,6372,6368,6376,6368,6376,6372,4,0,4,254880,24
827,p1310,20130320,6376,6372,6330,6436,6282,6378,6342,6,-30,1360,86252680,532
828,p1310,20130321,6378,6342,6402,6452,6402,6422,6422,80,80,146,9378280,608
829,p1310,20130322,6422,6422,6400,6418,6396,6418,6400,-4,-22,22,1408280,604
830,p1310,20130325,6418,6400,6444,6496,6416,6426,6434,26,34,30,1930280,606
831,p1310,20130326,6426,6434,6382,6398,6284,6344,6342,-90,-92,654,41486600,1000
832,p1310,20130327,6344,6342,6372,6430,6370,6418,6410,76,68,358,22951640,1112
833,p1310,20130328,6418,6410,6402,6402,6326,6326,6340,-84,-70,686,43498440,476
834,p1310,20130329,6326,6340,6200,6278,6200,6250,6266,-90,-74,172,10779160,406
835,p1310,20130401,6250,6266,6276,6290,6212,6212,6244,-54,-22,520,32472960,302
836,p1310,20130402,6212,6244,6120,6298,6120,6298,6214,54,-30,8,497240,304
837,p1310,20130403,6298,6214,6336,6340,6290,6290,6310,76,96,16,1009840,306
838,p1310,20130408,6290,6310,6272,6350,6272,6350,6338,40,28,20,1267720,294
839,p1310,20130409,6350,6338,6396,6396,6396,6396,6396,58,58,2,127920,294
840,p1310,20130410,6396,6396,6392,6446,6392,6446,6430,50,34,10,643000,294
841,p1310,20130411,6446,6430,6416,6432,6356,6372,6388,-58,-42,48,3066600,284
842,p1310,20130412,6372,6388,6358,6418,6358,6400,6378,12,-10,32,2041520,286
843,p1310,20130415,6400,6378,6294,6294,6206,6206,6272,-172,-106,60,3763360,330
844,p1310,20130416,6206,6272,6204,6250,6184,6224,6206,-48,-66,68,4220120,288
845,p1310,20130417,6224,6206,6226,6270,6182,6208,6224,2,18,76,4731280,248
846,p1310,20130418,6208,6224,6150,6166,6126,6166,6144,-58,-80,18,1106000,242
847,p1310,20130419,6166,6144,6236,6238,6216,6238,6232,94,88,10,623280,242
848,p1310,20130422,6238,6232,6144,6144,6042,6042,6096,-190,-136,24,1463200,234
849,p1310,20130423,6042,6096,6056,6056,6056,6056,6056,-40,-40,10,605600,224
850,p1310,20130424,6056,6056,0,0,0,6056,6056,0,0,0,0,224
851,p1310,20130425,6056,6056,6046,6088,6046,6088,6066,32,10,4,242680,226
852,p1310,20130426,6088,6066,6090,6128,6064,6110,6104,44,38,20,1221080,224
853,p1310,20130502,6110,6104,0,0,0,5978,5978,-126,-126,0,0,224
854,p1310,20130503,5978,5978,0,0,0,5978,5978,0,0,0,0,224
855,p1310,20130506,5978,5978,0,0,0,5978,5978,0,0,0,0,224
856,p1310,20130507,5978,5978,5990,5990,5990,5990,5990,12,12,2,119800,222
857,p1310,20130508,5990,5990,5990,5990,5990,5990,5990,0,0,2,119800,222
858,p1310,20130509,5990,5990,0,0,0,5992,5992,2,2,0,0,222
859,p1310,20130510,5992,5992,6102,6214,6102,6202,6140,210,148,178,10929480,222
860,p1310,20130513,6202,6140,6240,6256,6216,6218,6230,78,90,136,8474160,190
861,p1310,20130514,6218,6230,6250,6260,6204,6204,6248,-26,18,60,3749560,138
862,p1310,20130515,6204,6248,6110,6110,6042,6042,6098,-206,-150,68,4147440,148
863,p1310,20130516,6042,6098,6060,6158,6034,6108,6100,10,2,124,7564680,106
864,p1310,20130517,6108,6100,6146,6160,6078,6080,6086,-20,-14,4026,245073360,2062
865,p1310,20130520,6080,6086,6074,6078,6048,6078,6064,-8,-22,78,4731240,2062
866,p1310,20130521,6078,6064,6072,6072,6022,6046,6038,-18,-26,144,8696000,2066
867,p1310,20130522,6046,6038,6120,6146,6100,6124,6110,86,72,368,22492120,2064
868,p1310,20130523,6124,6110,6062,6104,6062,6080,6086,-30,-24,72,4382280,2068
869,p1310,20130524,6080,6086,6108,6174,6106,6158,6148,72,62,92,5657520,2088
870,p1310,20130527,6158,6148,6096,6154,6096,6154,6130,6,-18,208,12750800,2106
871,p1310,20130528,6154,6130,6158,6194,6130,6170,6168,40,38,334,20604200,2148
872,p1310,20130529,6170,6168,6200,6250,6188,6204,6206,36,38,102,6331680,2138
873,p1310,20130530,6204,6206,6176,6200,6118,6192,6140,-14,-66,96,5894600,2084
874,p1310,20130531,6192,6140,6170,6186,6144,6146,6172,6,32,20,1234440,2076
875,p1310,20130603,6146,6172,6146,6146,6146,6146,6146,-26,-26,2,122920,2074
876,p1310,20130604,6146,6146,6106,6112,6092,6092,6104,-54,-42,38,2319520,2056
877,p1310,20130605,6092,6104,6076,6096,6034,6096,6080,-8,-24,24,1459360,2046
878,p1310,20130606,6096,6080,6144,6148,6144,6148,6146,68,66,10,614720,2046
879,p1310,20130607,6148,6146,6180,6418,6180,6320,6340,174,194,150,9511360,2008
880,p1310,20130613,6320,6340,6278,6284,6252,6266,6272,-74,-68,18,1128960,2002
881,p1310,20130614,6266,6272,6204,6206,6200,6200,6202,-72,-70,16,992400,2002
882,p1310,20130617,6200,6202,6290,6290,6166,6192,6194,-10,-8,74,4584920,2008
883,p1310,20130618,6192,6194,6216,6232,6192,6196,6212,2,18,76,4721680,2040
884,p1310,20130619,6196,6212,6226,6226,6140,6140,6152,-72,-60,34,2092080,2042
885,p1310,20130620,6140,6152,6116,6152,6088,6100,6122,-52,-30,106,6491000,2034
886,p1310,20130621,6100,6122,6040,6040,5918,5942,5948,-180,-174,30,1784960,2042
887,p1310,20130624,5942,5948,5930,5930,5862,5888,5878,-60,-70,228,13404480,2024
888,p1310,20130625,5888,5878,5890,5914,5840,5860,5862,-18,-16,78,4573440,2014
889,p1310,20130626,5860,5862,5856,5874,5802,5828,5836,-34,-26,436,25451600,1626
890,p1310,20130627,5828,5836,5802,5814,5802,5810,5808,-26,-28,64,3717560,1574
891,p1310,20130628,5810,5808,5800,5840,5800,5800,5806,-8,-2,14,812960,1568
892,p1310,20130701,5800,5806,5838,5840,5828,5840,5834,34,28,6,350120,1566
893,p1310,20130702,5840,5834,5928,5928,5834,5838,5872,4,38,108,6342120,1566
894,p1310,20130703,5838,5872,5872,5872,5826,5832,5846,-40,-26,14,818560,1560
895,p1310,20130704,5832,5846,5878,5878,5872,5872,5874,26,28,6,352440,1560
896,p1310,20130705,5872,5874,5878,5878,5870,5870,5874,-4,0,4,234960,1564
897,p1310,20130708,5870,5874,5838,5838,5830,5830,5834,-44,-40,486,28361000,1084
898,p1310,20130709,5830,5834,5880,5880,5828,5828,5854,-6,20,4,234160,1084
899,p1310,20130710,5828,5854,0,0,0,5854,5854,0,0,0,0,1084
900,p1310,20130711,5854,5854,5856,5878,5856,5878,5866,24,12,4,234680,1084
901,p1310,20130712,5878,5866,5812,5826,5804,5804,5814,-62,-52,10,581480,1084
902,p1310,20130715,5804,5814,5756,5756,5674,5680,5718,-134,-96,188,10752720,1024
903,p1310,20130716,5680,5718,5652,5680,5634,5656,5654,-62,-64,26,1470040,1014
904,p1310,20130717,5656,5654,0,0,0,5654,5654,0,0,0,0,1014
905,p1310,20130718,5654,5654,5624,5648,5602,5642,5632,-12,-22,12,676040,1010
906,p1310,20130719,5642,5632,0,0,0,5632,5632,0,0,0,0,1010
907,p1310,20130722,5632,5632,0,0,0,5632,5632,0,0,0,0,1010
908,p1310,20130723,5632,5632,0,0,0,5632,5632,0,0,0,0,1010
909,p1310,20130724,5632,5632,0,0,0,5632,5632,0,0,0,0,1010
910,p1310,20130725,5632,5632,0,0,0,5632,5632,0,0,0,0,1010
911,p1310,20130726,5632,5632,0,0,0,5536,5536,-96,-96,0,0,1010
912,p1310,20130729,5536,5536,0,0,0,5508,5508,-28,-28,0,0,1010
913,p1310,20130730,5508,5508,5400,5436,5378,5436,5406,-72,-102,22,1189320,1012
914,p1310,20130731,5436,5406,5430,5430,5430,5430,5430,24,24,4,217200,1010
915,p1310,20130801,5430,5430,5416,5510,5416,5488,5476,58,46,10,547600,1006
916,p1310,20130802,5488,5476,0,0,0,5568,5568,92,92,0,0,1006
917,p1310,20130805,5568,5568,0,0,0,5560,5560,-8,-8,0,0,1006
918,p1310,20130806,5560,5560,0,0,0,5560,5560,0,0,0,0,1006
919,p1310,20130807,5560,5560,0,0,0,5504,5504,-56,-56,0,0,1006
920,p1310,20130808,5504,5504,0,0,0,5478,5478,-26,-26,0,0,1006
921,p1310,20130809,5478,5478,0,0,0,5478,5478,0,0,0,0,1006
922,p1310,20130812,5478,5478,0,0,0,5478,5478,0,0,0,0,1006
923,p1310,20130813,5478,5478,5608,5648,5564,5566,5586,88,108,14,782080,1004
924,p1310,20130814,5566,5586,0,0,0,5534,5534,-52,-52,0,0,1004
925,p1310,20130815,5534,5534,0,0,0,5534,5534,0,0,0,0,1004
926,p1310,20130816,5534,5534,0,0,0,5534,5534,0,0,0,0,1004
927,p1310,20130819,5534,5534,0,0,0,5534,5534,0,0,0,0,1004
928,p1310,20130820,5534,5534,5588,5588,5464,5464,5526,-70,-8,20,1105320,1002
929,p1310,20130821,5464,5526,0,0,0,5526,5526,0,0,0,0,1002
930,p1310,20130822,5526,5526,0,0,0,5488,5488,-38,-38,0,0,1002
931,p1310,20130823,5488,5488,5524,5524,5516,5516,5520,28,32,4,220800,1004
932,p1310,20130826,5516,5520,5458,5658,5458,5658,5598,138,78,56,3135720,1010
933,p1310,20130827,5658,5598,5508,5626,5508,5600,5600,2,2,26,1456040,1012
934,p1310,20130828,5600,5600,5554,5670,5554,5560,5628,-40,28,50,2814000,1010
935,p1310,20130829,5560,5628,5616,5616,5542,5542,5578,-86,-50,4,223160,1010
936,p1310,20130830,5542,5578,0,0,0,5488,5488,-90,-90,0,0,1010
937,p1310,20130902,5488,5488,5596,5596,5594,5596,5594,108,106,28,1566840,1014
938,p1310,20130903,5596,5594,5724,5724,5590,5590,5618,-4,24,16,899080,1006
939,p1310,20130904,5590,5618,5558,5558,5558,5558,5558,-60,-60,4,222320,1006
940,p1310,20130905,5558,5558,0,0,0,5558,5558,0,0,0,0,1006
941,p1310,20130906,5558,5558,5480,5528,5458,5520,5498,-38,-60,56,3079200,1002
942,p1310,20130909,5520,5498,5516,5604,5504,5604,5544,106,46,12,665280,1002
943,p1310,20130910,5604,5544,5552,5552,5446,5446,5498,-98,-46,4,219960,1002
944,p1310,20130911,5446,5498,0,0,0,5498,5498,0,0,0,0,1002
945,p1310,20130912,5498,5498,5566,5566,5566,5566,5566,68,68,2,111320,1002
946,p1310,20130913,5566,5566,0,0,0,5564,5564,-2,-2,0,0,1002
947,p1310,20130916,5564,5564,5480,5652,5400,5652,5518,88,-46,10,551800,1004
948,p1310,20130917,5652,5518,5332,5480,5332,5480,5390,-38,-128,14,754720,1004
949,p1310,20130918,5480,5390,5500,5536,5370,5466,5446,76,56,40,2178480,1004
950,p1310,20130923,5466,5446,5466,5466,5466,5466,5466,20,20,2,109320,1004
951,p1310,20130924,5466,5466,5342,5426,5330,5380,5366,-86,-100,24,1288040,1002
952,p1310,20130925,5380,5366,5330,5408,5300,5408,5342,42,-24,14,748040,1002
953,p1310,20130926,5408,5342,0,0,0,5342,5342,0,0,0,0,1002
954,p1310,20130927,5342,5342,0,0,0,5342,5342,0,0,0,0,1002
955,p1310,20130930,5342,5342,5022,5200,5022,5200,5056,-142,-286,76,3843160,1000
956,p1310,20131008,5200,5056,0,0,0,5056,5056,0,0,0,0,1000
957,p1310,20131009,5056,5056,5270,5270,5270,5270,5270,214,214,10,527000,1000
958,p1310,20131010,5270,5270,5350,5350,5350,5350,5350,80,80,10,535000,1000
959,p1310,20131011,5350,5350,5450,5450,5450,5450,5450,100,100,10,545000,1000
960,p1310,20131014,5450,5450,5550,5550,5550,5550,5550,100,100,10,555000,1000
961,p1310,20131015,5550,5550,0,0,0,5550,5550,0,0,0,0,1000
962,p1310,20131016,5550,5550,0,0,0,5550,5550,0,0,0,0,1000
963,p1310,20131017,5550,5550,5650,5650,5650,5650,5650,100,100,40,2260000,1000
964,p1310,20131018,5650,5650,0,0,0,5650,5650,0,0,0,0,1000
965,p1310,20131021,5650,5650,5750,5750,5750,5750,5690,100,40,220,12650000,0
966,p1311,20130104,7184,7184,0,0,0,7184,7184,0,0,0,0,14
967,p1311,20130107,7184,7184,0,0,0,7184,7184,0,0,0,0,14
968,p1311,20130108,7184,7184,7242,7242,7242,7242,7242,58,58,2,144840,16
969,p1311,20130109,7242,7242,0,0,0,7242,7242,0,0,0,0,16
970,p1311,20130110,7242,7242,7126,7126,7126,7126,7126,-116,-116,6,427560,20
971,p1311,20130111,7126,7126,7040,7040,6980,7020,7010,-106,-116,16,1121600,12
972,p1311,20130114,7020,7010,0,0,0,7010,7010,0,0,0,0,12
973,p1311,20130115,7010,7010,0,0,0,7010,7010,0,0,0,0,12
974,p1311,20130116,7010,7010,7188,7194,7104,7110,7140,100,130,50,3570120,12
975,p1311,20130117,7110,7140,7018,7058,7018,7058,7038,-82,-102,4,281520,12
976,p1311,20130118,7058,7038,7060,7060,7060,7060,7060,22,22,2,141200,14
977,p1311,20130121,7060,7060,7126,7126,7126,7126,7126,66,66,2,142520,12
978,p1311,20130122,7126,7126,0,0,0,7126,7126,0,0,0,0,12
979,p1311,20130123,7126,7126,0,0,0,7126,7126,0,0,0,0,12
980,p1311,20130124,7126,7126,0,0,0,7126,7126,0,0,0,0,12
981,p1311,20130125,7126,7126,0,0,0,7126,7126,0,0,0,0,12
982,p1311,20130128,7126,7126,7056,7090,7056,7090,7078,-36,-48,10,707920,12
983,p1311,20130129,7090,7078,0,0,0,7078,7078,0,0,0,0,12
984,p1311,20130130,7078,7078,0,0,0,7078,7078,0,0,0,0,12
985,p1311,20130131,7078,7078,0,0,0,7078,7078,0,0,0,0,12
986,p1311,20130201,7078,7078,7078,7356,6796,7232,7104,154,26,4584,325733120,526
987,p1311,20130204,7232,7104,7242,7276,7234,7240,7264,136,160,38,2760320,500
988,p1311,20130205,7240,7264,7232,7232,7232,7232,7232,-32,-32,2,144640,500
989,p1311,20130206,7232,7232,0,0,0,7232,7232,0,0,0,0,500
990,p1311,20130207,7232,7232,7150,7150,7150,7150,7150,-82,-82,168,12012000,332
991,p1311,20130208,7150,7150,7180,7180,7180,7180,7180,30,30,318,22832400,14
992,p1311,20130218,7180,7180,0,0,0,7180,7180,0,0,0,0,14
993,p1311,20130219,7180,7180,7154,7166,7154,7166,7160,-14,-20,4,286400,14
994,p1311,20130220,7166,7160,0,0,0,7160,7160,0,0,0,0,14
995,p1311,20130221,7160,7160,0,0,0,7160,7160,0,0,0,0,14
996,p1311,20130222,7160,7160,0,0,0,7160,7160,0,0,0,0,14
997,p1311,20130225,7160,7160,6912,6912,6874,6874,6884,-286,-276,20,1376960,26
998,p1311,20130226,6874,6884,6894,6894,6894,6894,6894,10,10,2,137880,24
999,p1311,20130227,6894,6894,0,0,0,6894,6894,0,0,0,0,24
1000,p1311,20130228,6894,6894,0,0,0,6894,6894,0,0,0,0,24
1001,p1311,20130301,6894,6894,0,0,0,6894,6894,0,0,0,0,24
1002,p1311,20130304,6894,6894,0,0,0,6894,6894,0,0,0,0,24
1003,p1311,20130305,6894,6894,0,0,0,6894,6894,0,0,0,0,24
1004,p1311,20130306,6894,6894,0,0,0,6894,6894,0,0,0,0,24
1005,p1311,20130307,6894,6894,0,0,0,6894,6894,0,0,0,0,24
1006,p1311,20130308,6894,6894,0,0,0,6894,6894,0,0,0,0,24
1007,p1311,20130311,6894,6894,0,0,0,6894,6894,0,0,0,0,24
1008,p1311,20130312,6894,6894,0,0,0,6894,6894,0,0,0,0,24
1009,p1311,20130313,6894,6894,0,0,0,6894,6894,0,0,0,0,24
1010,p1311,20130314,6894,6894,6394,6432,6344,6344,6406,-550,-488,40,2562520,32
1011,p1311,20130315,6344,6406,6494,6494,6494,6494,6494,88,88,2,129880,32
1012,p1311,20130318,6494,6494,6432,6432,6424,6424,6428,-70,-66,4,257120,32
1013,p1311,20130319,6424,6428,6444,6444,6444,6444,6444,16,16,2,128880,32
1014,p1311,20130320,6444,6444,6396,6440,6396,6440,6418,-4,-26,4,256720,32
1015,p1311,20130321,6440,6418,6518,6542,6518,6542,6530,124,112,4,261200,30
1016,p1311,20130322,6542,6530,6428,6550,6428,6526,6490,-4,-40,12,778920,28
1017,p1311,20130325,6526,6490,6538,6538,6538,6538,6538,48,48,2,130760,28
1018,p1311,20130326,6538,6538,6492,6492,6492,6492,6492,-46,-46,2,129840,28
1019,p1311,20130327,6492,6492,0,0,0,6492,6492,0,0,0,0,28
1020,p1311,20130328,6492,6492,0,0,0,6492,6492,0,0,0,0,28
1021,p1311,20130329,6492,6492,6352,6360,6340,6340,6350,-152,-142,14,889040,28
1022,p1311,20130401,6340,6350,6340,6340,6268,6268,6304,-82,-46,4,252160,28
1023,p1311,20130402,6268,6304,6258,6298,6258,6298,6278,-6,-26,4,251120,28
1024,p1311,20130403,6298,6278,0,0,0,6278,6278,0,0,0,0,28
1025,p1311,20130408,6278,6278,0,0,0,6278,6278,0,0,0,0,28
1026,p1311,20130409,6278,6278,0,0,0,6278,6278,0,0,0,0,28
1027,p1311,20130410,6278,6278,6490,6490,6490,6490,6490,212,212,6,389400,30
1028,p1311,20130411,6490,6490,0,0,0,6490,6490,0,0,0,0,30
1029,p1311,20130412,6490,6490,6426,6426,6426,6426,6426,-64,-64,2,128520,28
1030,p1311,20130415,6426,6426,0,0,0,6426,6426,0,0,0,0,28
1031,p1311,20130416,6426,6426,6238,6300,6218,6240,6250,-186,-176,18,1125160,26
1032,p1311,20130417,6240,6250,6290,6290,6222,6222,6244,-28,-6,6,374720,22
1033,p1311,20130418,6222,6244,6144,6144,6144,6144,6144,-100,-100,2,122880,22
1034,p1311,20130419,6144,6144,0,0,0,6144,6144,0,0,0,0,22
1035,p1311,20130422,6144,6144,6062,6062,6062,6062,6062,-82,-82,2,121240,22
1036,p1311,20130423,6062,6062,6002,6066,5990,6066,6014,4,-48,8,481200,22
1037,p1311,20130424,6066,6014,6114,6114,6032,6050,6066,36,52,18,1092160,16
1038,p1311,20130425,6050,6066,0,0,0,6066,6066,0,0,0,0,16
1039,p1311,20130426,6066,6066,6046,6046,6046,6046,6046,-20,-20,4,241840,14
1040,p1311,20130502,6046,6046,5908,5908,5908,5908,5908,-138,-138,2,118160,12
1041,p1311,20130503,5908,5908,5966,5966,5966,5966,5966,58,58,2,119320,12
1042,p1311,20130506,5966,5966,0,0,0,5986,5986,20,20,0,0,12
1043,p1311,20130507,5986,5986,6018,6018,5958,5958,5988,-28,2,4,239520,12
1044,p1311,20130508,5958,5988,0,0,0,6030,6030,42,42,0,0,12
1045,p1311,20130509,6030,6030,0,0,0,6030,6030,0,0,0,0,12
1046,p1311,20130510,6030,6030,0,0,0,6144,6144,114,114,0,0,12
1047,p1311,20130513,6144,6144,6212,6220,6190,6192,6200,48,56,50,3100560,18
1048,p1311,20130514,6192,6200,0,0,0,6200,6200,0,0,0,0,18
1049,p1311,20130515,6200,6200,0,0,0,6200,6200,0,0,0,0,18
1050,p1311,20130516,6200,6200,6090,6090,6090,6090,6090,-110,-110,2,121800,16
1051,p1311,20130517,6090,6090,0,0,0,6090,6090,0,0,0,0,16
1052,p1311,20130520,6090,6090,0,0,0,6090,6090,0,0,0,0,16
1053,p1311,20130521,6090,6090,6136,6136,6086,6126,6116,36,26,6,366960,16
1054,p1311,20130522,6126,6116,6196,6196,6196,6196,6196,80,80,2,123920,14
1055,p1311,20130523,6196,6196,0,0,0,6196,6196,0,0,0,0,14
1056,p1311,20130524,6196,6196,6172,6172,6172,6172,6172,-24,-24,2,123440,14
1057,p1311,20130527,6172,6172,0,0,0,6172,6172,0,0,0,0,14
1058,p1311,20130528,6172,6172,0,0,0,6172,6172,0,0,0,0,14
1059,p1311,20130529,6172,6172,0,0,0,6172,6172,0,0,0,0,14
1060,p1311,20130530,6172,6172,6242,6242,6242,6242,6242,70,70,2,124840,12
1061,p1311,20130531,6242,6242,0,0,0,6274,6274,32,32,0,0,12
1062,p1311,20130603,6274,6274,0,0,0,6274,6274,0,0,0,0,12
1063,p1311,20130604,6274,6274,0,0,0,6250,6250,-24,-24,0,0,12
1064,p1311,20130605,6250,6250,6162,6162,6130,6134,6146,-116,-104,200,12295920,16
1065,p1311,20130606,6134,6146,6014,6208,6014,6208,6140,62,-6,32,1965400,20
1066,p1311,20130607,6208,6140,0,0,0,6248,6248,108,108,0,0,20
1067,p1311,20130613,6248,6248,0,0,0,6250,6250,2,2,0,0,20
1068,p1311,20130614,6250,6250,0,0,0,6250,6250,0,0,0,0,20
1069,p1311,20130617,6250,6250,6272,6336,6272,6336,6304,86,54,16,1008880,14
1070,p1311,20130618,6336,6304,6294,6358,6294,6308,6320,4,16,6,379200,18
1071,p1311,20130619,6308,6320,6260,6260,6252,6254,6254,-66,-66,10,625440,16
1072,p1311,20130620,6254,6254,6198,6198,6198,6198,6198,-56,-56,2,123960,14
1073,p1311,20130621,6198,6198,6042,6080,6042,6080,6062,-118,-136,8,485080,14
1074,p1311,20130624,6080,6062,6032,6032,5972,5972,5996,-90,-66,8,479760,18
1075,p1311,20130625,5972,5996,5940,5940,5940,5940,5940,-56,-56,2,118800,18
1076,p1311,20130626,5940,5940,5890,5896,5884,5896,5890,-44,-50,12,706800,14
1077,p1311,20130627,5896,5890,5856,5856,5856,5856,5856,-34,-34,2,117120,14
1078,p1311,20130628,5856,5856,0,0,0,5856,5856,0,0,0,0,14
1079,p1311,20130701,5856,5856,5920,5920,5920,5920,5920,64,64,8,473600,14
1080,p1311,20130702,5920,5920,0,0,0,5958,5958,38,38,0,0,14
1081,p1311,20130703,5958,5958,0,0,0,5932,5932,-26,-26,0,0,14
1082,p1311,20130704,5932,5932,0,0,0,5932,5932,0,0,0,0,14
1083,p1311,20130705,5932,5932,0,0,0,5932,5932,0,0,0,0,14
1084,p1311,20130708,5932,5932,0,0,0,5932,5932,0,0,0,0,14
1085,p1311,20130709,5932,5932,0,0,0,5932,5932,0,0,0,0,14
1086,p1311,20130710,5932,5932,0,0,0,5932,5932,0,0,0,0,14
1087,p1311,20130711,5932,5932,0,0,0,5932,5932,0,0,0,0,14
1088,p1311,20130712,5932,5932,0,0,0,5880,5880,-52,-52,0,0,14
1089,p1311,20130715,5880,5880,0,0,0,5784,5784,-96,-96,0,0,14
1090,p1311,20130716,5784,5784,0,0,0,5720,5720,-64,-64,0,0,14
1091,p1311,20130717,5720,5720,5712,5712,5602,5602,5644,-118,-76,8,451640,14
1092,p1311,20130718,5602,5644,5720,5720,5662,5662,5686,18,42,6,341200,14
1093,p1311,20130719,5662,5686,0,0,0,5686,5686,0,0,0,0,14
1094,p1311,20130722,5686,5686,0,0,0,5666,5666,-20,-20,0,0,14
1095,p1311,20130723,5666,5666,5674,5674,5674,5674,5674,8,8,2,113480,12
1096,p1311,20130724,5674,5674,0,0,0,5628,5628,-46,-46,0,0,12
1097,p1311,20130725,5628,5628,0,0,0,5592,5592,-36,-36,0,0,12
1098,p1311,20130726,5592,5592,5388,5396,5378,5396,5386,-196,-206,14,754120,12
1099,p1311,20130729,5396,5386,5458,5458,5382,5382,5422,-4,36,14,759160,8
1100,p1311,20130730,5382,5422,0,0,0,5422,5422,0,0,0,0,8
1101,p1311,20130731,5422,5422,0,0,0,5422,5422,0,0,0,0,8
1102,p1311,20130801,5422,5422,5480,5480,5480,5480,5480,58,58,2,109600,8
1103,p1311,20130802,5480,5480,5500,5538,5500,5538,5512,58,32,6,330760,10
1104,p1311,20130805,5538,5512,0,0,0,5512,5512,0,0,0,0,10
1105,p1311,20130806,5512,5512,0,0,0,5512,5512,0,0,0,0,10
1106,p1311,20130807,5512,5512,5456,5456,5456,5456,5456,-56,-56,4,218240,10
1107,p1311,20130808,5456,5456,5436,5436,5436,5436,5436,-20,-20,2,108720,12
1108,p1311,20130809,5436,5436,0,0,0,5446,5446,10,10,0,0,12
1109,p1311,20130812,5446,5446,0,0,0,5446,5446,0,0,0,0,12
1110,p1311,20130813,5446,5446,0,0,0,5552,5552,106,106,0,0,12
1111,p1311,20130814,5552,5552,5594,5594,5594,5594,5594,42,42,2,111880,10
1112,p1311,20130815,5594,5594,5656,5656,5578,5578,5620,-16,26,12,674600,10
1113,p1311,20130816,5578,5620,0,0,0,5626,5626,6,6,0,0,10
1114,p1311,20130819,5626,5626,5664,5664,5664,5664,5664,38,38,2,113280,10
1115,p1311,20130820,5664,5664,0,0,0,5656,5656,-8,-8,0,0,10
1116,p1311,20130821,5656,5656,0,0,0,5648,5648,-8,-8,0,0,10
1117,p1311,20130822,5648,5648,0,0,0,5646,5646,-2,-2,0,0,10
1118,p1311,20130823,5646,5646,0,0,0,5678,5678,32,32,0,0,10
1119,p1311,20130826,5678,5678,5670,5670,5670,5670,5670,-8,-8,2,113400,8
1120,p1311,20130827,5670,5670,5808,5880,5776,5880,5816,210,146,10,581600,8
1121,p1311,20130828,5880,5816,5830,5830,5830,5830,5830,14,14,4,233200,10
1122,p1311,20130829,5830,5830,5782,5782,5700,5700,5742,-130,-88,22,1263520,16
1123,p1311,20130830,5700,5742,0,0,0,5700,5700,-42,-42,0,0,16
1124,p1311,20130902,5700,5700,0,0,0,5810,5810,110,110,0,0,16
1125,p1311,20130903,5810,5810,0,0,0,5834,5834,24,24,0,0,16
1126,p1311,20130904,5834,5834,0,0,0,5772,5772,-62,-62,0,0,16
1127,p1311,20130905,5772,5772,0,0,0,5790,5790,18,18,0,0,16
1128,p1311,20130906,5790,5790,0,0,0,5790,5790,0,0,0,0,16
1129,p1311,20130909,5790,5790,0,0,0,5838,5838,48,48,0,0,16
1130,p1311,20130910,5838,5838,5606,5610,5606,5610,5606,-228,-232,8,448560,18
1131,p1311,20130911,5610,5606,5596,5596,5596,5596,5596,-10,-10,6,335760,18
1132,p1311,20130912,5596,5596,0,0,0,5664,5664,68,68,0,0,18
1133,p1311,20130913,5664,5664,5506,5650,5506,5514,5556,-150,-108,6,333400,16
1134,p1311,20130916,5514,5556,0,0,0,5556,5556,0,0,0,0,16
1135,p1311,20130917,5556,5556,0,0,0,5556,5556,0,0,0,0,16
1136,p1311,20130918,5556,5556,5560,5560,5500,5500,5530,-56,-26,4,221200,16
1137,p1311,20130923,5500,5530,0,0,0,5530,5530,0,0,0,0,16
1138,p1311,20130924,5530,5530,0,0,0,5530,5530,0,0,0,0,16
1139,p1311,20130925,5530,5530,0,0,0,5530,5530,0,0,0,0,16
1140,p1311,20130926,5530,5530,0,0,0,5530,5530,0,0,0,0,16
1141,p1311,20130927,5530,5530,5360,5360,5360,5360,5360,-170,-170,4,214400,12
1142,p1311,20130930,5360,5360,0,0,0,5074,5074,-286,-286,0,0,12
1143,p1311,20131008,5074,5074,5378,5378,5378,5378,5378,304,304,2,107560,10
1144,p1311,20131009,5378,5378,0,0,0,5604,5604,226,226,0,0,10
1145,p1311,20131010,5604,5604,5706,5706,5706,5706,5706,102,102,6,342360,6
1146,p1311,20131011,5706,5706,0,0,0,5812,5812,106,106,0,0,6
1147,p1311,20131014,5812,5812,0,0,0,5812,5812,0,0,0,0,6
1148,p1311,20131015,5812,5812,0,0,0,5812,5812,0,0,0,0,6
1149,p1311,20131016,5812,5812,5702,5702,5702,5702,5702,-110,-110,2,114040,6
1150,p1311,20131017,5702,5702,0,0,0,5804,5804,102,102,0,0,6
1151,p1311,20131018,5804,5804,5790,5790,5642,5750,5726,-54,-78,6,343640,8
1152,p1311,20131021,5750,5726,5798,5798,5798,5798,5798,72,72,6,347880,6
1153,p1311,20131022,5798,5798,0,0,0,5798,5798,0,0,0,0,6
1154,p1311,20131023,5798,5798,0,0,0,5798,5798,0,0,0,0,6
1155,p1311,20131024,5798,5798,0,0,0,5798,5798,0,0,0,0,6
1156,p1311,20131025,5798,5798,0,0,0,5798,5798,0,0,0,0,6
1157,p1311,20131028,5798,5798,0,0,0,5798,5798,0,0,0,0,6
1158,p1311,20131029,5798,5798,5798,5798,5798,5798,5798,0,0,4,231920,2
1159,p1311,20131030,5798,5798,0,0,0,5798,5798,0,0,0,0,2
1160,p1311,20131031,5798,5798,5798,5798,5798,5798,5798,0,0,2,115960,0
1161,p1311,20131101,5798,5798,0,0,0,5798,5798,0,0,0,0,0
1162,p1311,20131104,5798,5798,0,0,0,5798,5798,0,0,0,0,0
1163,p1311,20131105,5798,5798,0,0,0,5798,5798,0,0,0,0,0
1164,p1311,20131106,5798,5798,0,0,0,5798,5798,0,0,0,0,0
1165,p1311,20131107,5798,5798,0,0,0,5798,5798,0,0,0,0,0
1166,p1311,20131108,5798,5798,0,0,0,5798,5798,0,0,0,0,0
1167,p1311,20131111,5798,5798,0,0,0,5798,5798,0,0,0,0,0
1168,p1311,20131112,5798,5798,0,0,0,5798,5798,0,0,0,0,0
1169,p1311,20131113,5798,5798,0,0,0,5798,5798,0,0,0,0,0
1170,p1311,20131114,5798,5798,0,0,0,5798,5798,0,0,0,0,0
1171,p1312,20130104,7212,7212,0,0,0,7212,7212,0,0,0,0,6
1172,p1312,20130107,7212,7212,0,0,0,7212,7212,0,0,0,0,6
1173,p1312,20130108,7212,7212,0,0,0,7212,7212,0,0,0,0,6
1174,p1312,20130109,7212,7212,7190,7190,7190,7190,7190,-22,-22,2,143800,6
1175,p1312,20130110,7190,7190,7246,7246,7080,7080,7162,-110,-28,16,1146080,6
1176,p1312,20130111,7080,7162,7010,7026,7010,7026,7022,-136,-140,8,561760,10
1177,p1312,20130114,7026,7022,7030,7082,7026,7076,7054,54,32,12,846520,12
1178,p1312,20130115,7076,7054,7108,7110,7108,7110,7108,56,54,4,284360,10
1179,p1312,20130116,7110,7108,7092,7158,7092,7136,7138,28,30,24,1713120,28
1180,p1312,20130117,7136,7138,7138,7138,7104,7104,7120,-34,-18,4,284840,24
1181,p1312,20130118,7104,7120,7100,7134,7090,7134,7112,14,-8,12,853480,24
1182,p1312,20130121,7134,7112,7142,7142,7110,7110,7130,-2,18,6,427880,22
1183,p1312,20130122,7110,7130,7128,7218,7128,7218,7168,88,38,10,716800,14
1184,p1312,20130123,7218,7168,0,0,0,7168,7168,0,0,0,0,14
1185,p1312,20130124,7168,7168,7168,7168,7168,7168,7168,0,0,2,143360,12
1186,p1312,20130125,7168,7168,0,0,0,7168,7168,0,0,0,0,12
1187,p1312,20130128,7168,7168,0,0,0,7168,7168,0,0,0,0,12
1188,p1312,20130129,7168,7168,0,0,0,7168,7168,0,0,0,0,12
1189,p1312,20130130,7168,7168,0,0,0,7168,7168,0,0,0,0,12
1190,p1312,20130131,7168,7168,0,0,0,7168,7168,0,0,0,0,12
1191,p1312,20130201,7168,7168,7240,7242,7240,7242,7240,74,72,12,869000,6
1192,p1312,20130204,7242,7240,7312,7312,7312,7312,7312,72,72,2,146240,4
1193,p1312,20130205,7312,7312,0,0,0,7312,7312,0,0,0,0,4
1194,p1312,20130206,7312,7312,0,0,0,7312,7312,0,0,0,0,4
1195,p1312,20130207,7312,7312,0,0,0,7312,7312,0,0,0,0,4
1196,p1312,20130208,7312,7312,0,0,0,7312,7312,0,0,0,0,4
1197,p1312,20130218,7312,7312,0,0,0,7312,7312,0,0,0,0,4
1198,p1312,20130219,7312,7312,0,0,0,7312,7312,0,0,0,0,4
1199,p1312,20130220,7312,7312,0,0,0,7312,7312,0,0,0,0,4
1200,p1312,20130221,7312,7312,0,0,0,7312,7312,0,0,0,0,4
1201,p1312,20130222,7312,7312,0,0,0,7312,7312,0,0,0,0,4
1202,p1312,20130225,7312,7312,0,0,0,7312,7312,0,0,0,0,4
1203,p1312,20130226,7312,7312,0,0,0,7312,7312,0,0,0,0,4
1204,p1312,20130227,7312,7312,0,0,0,7312,7312,0,0,0,0,4
1205,p1312,20130228,7312,7312,0,0,0,7312,7312,0,0,0,0,4
1206,p1312,20130301,7312,7312,0,0,0,7312,7312,0,0,0,0,4
1207,p1312,20130304,7312,7312,0,0,0,7312,7312,0,0,0,0,4
1208,p1312,20130305,7312,7312,0,0,0,7312,7312,0,0,0,0,4
1209,p1312,20130306,7312,7312,0,0,0,7312,7312,0,0,0,0,4
1210,p1312,20130307,7312,7312,0,0,0,7312,7312,0,0,0,0,4
1211,p1312,20130308,7312,7312,0,0,0,7312,7312,0,0,0,0,4
1212,p1312,20130311,7312,7312,0,0,0,7312,7312,0,0,0,0,4
1213,p1312,20130312,7312,7312,0,0,0,7312,7312,0,0,0,0,4
1214,p1312,20130313,7312,7312,0,0,0,7312,7312,0,0,0,0,4
1215,p1312,20130314,7312,7312,0,0,0,7312,7312,0,0,0,0,4
1216,p1312,20130315,7312,7312,0,0,0,7312,7312,0,0,0,0,4
1217,p1312,20130318,7312,7312,0,0,0,7312,7312,0,0,0,0,4
1218,p1312,20130319,7312,7312,0,0,0,7312,7312,0,0,0,0,4
1219,p1312,20130320,7312,7312,0,0,0,7312,7312,0,0,0,0,4
1220,p1312,20130321,7312,7312,0,0,0,7312,7312,0,0,0,0,4
1221,p1312,20130322,7312,7312,0,0,0,7312,7312,0,0,0,0,4
1222,p1312,20130325,7312,7312,0,0,0,7312,7312,0,0,0,0,4
1223,p1312,20130326,7312,7312,0,0,0,7312,7312,0,0,0,0,4
1224,p1312,20130327,7312,7312,6728,6728,6728,6728,6728,-584,-584,6,403680,8
1225,p1312,20130328,6728,6728,6460,6460,6460,6460,6460,-268,-268,4,258400,12
1226,p1312,20130329,6460,6460,0,0,0,6460,6460,0,0,0,0,12
1227,p1312,20130401,6460,6460,6330,6330,6330,6330,6330,-130,-130,2,126600,12
1228,p1312,20130402,6330,6330,0,0,0,6330,6330,0,0,0,0,12
1229,p1312,20130403,6330,6330,6350,6350,6350,6350,6350,20,20,2,127000,12
1230,p1312,20130408,6350,6350,6446,6446,6446,6446,6446,96,96,2,128920,12
1231,p1312,20130409,6446,6446,6478,6478,6478,6478,6478,32,32,2,129560,10
1232,p1312,20130410,6478,6478,0,0,0,6478,6478,0,0,0,0,10
1233,p1312,20130411,6478,6478,0,0,0,6478,6478,0,0,0,0,10
1234,p1312,20130412,6478,6478,0,0,0,6478,6478,0,0,0,0,10
1235,p1312,20130415,6478,6478,0,0,0,6332,6332,-146,-146,0,0,10
1236,p1312,20130416,6332,6332,0,0,0,6324,6324,-8,-8,0,0,10
1237,p1312,20130417,6324,6324,0,0,0,6286,6286,-38,-38,0,0,10
1238,p1312,20130418,6286,6286,0,0,0,6186,6186,-100,-100,0,0,10
1239,p1312,20130419,6186,6186,0,0,0,6186,6186,0,0,0,0,10
1240,p1312,20130422,6186,6186,0,0,0,6138,6138,-48,-48,0,0,10
1241,p1312,20130423,6138,6138,0,0,0,6138,6138,0,0,0,0,10
1242,p1312,20130424,6138,6138,0,0,0,6102,6102,-36,-36,0,0,10
1243,p1312,20130425,6102,6102,0,0,0,6102,6102,0,0,0,0,10
1244,p1312,20130426,6102,6102,6144,6144,6144,6144,6144,42,42,2,122880,12
1245,p1312,20130502,6144,6144,0,0,0,6074,6074,-70,-70,0,0,12
1246,p1312,20130503,6074,6074,0,0,0,6054,6054,-20,-20,0,0,12
1247,p1312,20130506,6054,6054,6034,6066,6034,6066,6050,12,-4,4,242000,12
1248,p1312,20130507,6066,6050,0,0,0,6050,6050,0,0,0,0,12
1249,p1312,20130508,6050,6050,0,0,0,6050,6050,0,0,0,0,12
1250,p1312,20130509,6050,6050,0,0,0,6050,6050,0,0,0,0,12
1251,p1312,20130510,6050,6050,6152,6206,6092,6206,6140,156,90,10,614040,16
1252,p1312,20130513,6206,6140,6260,6260,6260,6260,6260,120,120,2,125200,14
1253,p1312,20130514,6260,6260,0,0,0,6260,6260,0,0,0,0,14
1254,p1312,20130515,6260,6260,6126,6162,6080,6130,6124,-130,-136,8,489960,12
1255,p1312,20130516,6130,6124,0,0,0,6124,6124,0,0,0,0,12
1256,p1312,20130517,6124,6124,0,0,0,6186,6186,62,62,0,0,12
1257,p1312,20130520,6186,6186,0,0,0,6186,6186,0,0,0,0,12
1258,p1312,20130521,6186,6186,6186,6186,6110,6110,6148,-76,-38,4,245920,14
1259,p1312,20130522,6110,6148,6198,6288,6198,6212,6238,64,90,16,998280,14
1260,p1312,20130523,6212,6238,6220,6234,6220,6234,6226,-4,-12,4,249080,12
1261,p1312,20130524,6234,6226,0,0,0,6226,6226,0,0,0,0,12
1262,p1312,20130527,6226,6226,0,0,0,6226,6226,0,0,0,0,12
1263,p1312,20130528,6226,6226,6226,6328,6226,6230,6260,4,34,6,375680,12
1264,p1312,20130529,6230,6260,6328,6328,6328,6328,6328,68,68,2,126560,12
1265,p1312,20130530,6328,6328,6346,6346,6346,6346,6346,18,18,2,126920,14
1266,p1312,20130531,6346,6346,6346,6346,6346,6346,6346,0,0,2,126920,16
1267,p1312,20130603,6346,6346,6284,6286,6284,6286,6284,-60,-62,6,377120,16
1268,p1312,20130604,6286,6284,6206,6206,6206,6206,6206,-78,-78,2,124120,16
1269,p1312,20130605,6206,6206,0,0,0,6206,6206,0,0,0,0,16
1270,p1312,20130606,6206,6206,0,0,0,6206,6206,0,0,0,0,16
1271,p1312,20130607,6206,6206,6168,6326,6168,6326,6222,120,16,14,871320,12
1272,p1312,20130613,6326,6222,6360,6418,6312,6328,6352,106,130,10,635280,12
1273,p1312,20130614,6328,6352,0,0,0,6336,6336,-16,-16,0,0,12
1274,p1312,20130617,6336,6336,0,0,0,6336,6336,0,0,0,0,12
1275,p1312,20130618,6336,6336,0,0,0,6336,6336,0,0,0,0,12
1276,p1312,20130619,6336,6336,0,0,0,6320,6320,-16,-16,0,0,12
1277,p1312,20130620,6320,6320,6276,6276,6220,6220,6246,-100,-74,14,874480,16
1278,p1312,20130621,6220,6246,6028,6094,6028,6094,6080,-152,-166,10,608080,22
1279,p1312,20130624,6094,6080,6006,6010,6006,6010,6008,-70,-72,8,480640,20
1280,p1312,20130625,6010,6008,5956,5956,5956,5956,5956,-52,-52,2,119120,20
1281,p1312,20130626,5956,5956,0,0,0,5956,5956,0,0,0,0,20
1282,p1312,20130627,5956,5956,0,0,0,5922,5922,-34,-34,0,0,20
1283,p1312,20130628,5922,5922,0,0,0,5922,5922,0,0,0,0,20
1284,p1312,20130701,5922,5922,0,0,0,5922,5922,0,0,0,0,20
1285,p1312,20130702,5922,5922,0,0,0,5922,5922,0,0,0,0,20
1286,p1312,20130703,5922,5922,0,0,0,5922,5922,0,0,0,0,20
1287,p1312,20130704,5922,5922,5998,6000,5936,5956,5970,34,48,18,1074720,20
1288,p1312,20130705,5956,5970,0,0,0,5970,5970,0,0,0,0,20
1289,p1312,20130708,5970,5970,0,0,0,5930,5930,-40,-40,0,0,20
1290,p1312,20130709,5930,5930,0,0,0,5930,5930,0,0,0,0,20
1291,p1312,20130710,5930,5930,5910,5910,5910,5910,5910,-20,-20,8,472800,28
1292,p1312,20130711,5910,5910,5954,5970,5954,5970,5958,60,48,14,834200,22
1293,p1312,20130712,5970,5958,5928,5928,5928,5928,5928,-30,-30,2,118560,24
1294,p1312,20130715,5928,5928,0,0,0,5832,5832,-96,-96,0,0,24
1295,p1312,20130716,5832,5832,0,0,0,5768,5768,-64,-64,0,0,24
1296,p1312,20130717,5768,5768,0,0,0,5758,5758,-10,-10,0,0,24
1297,p1312,20130718,5758,5758,5702,5714,5652,5714,5694,-44,-64,8,455640,22
1298,p1312,20130719,5714,5694,0,0,0,5704,5704,10,10,0,0,22
1299,p1312,20130722,5704,5704,0,0,0,5704,5704,0,0,0,0,22
1300,p1312,20130723,5704,5704,5688,5720,5614,5666,5674,-38,-30,120,6809080,22
1301,p1312,20130724,5666,5674,5658,5658,5658,5658,5658,-16,-16,2,113160,24
1302,p1312,20130725,5658,5658,5572,5580,5510,5578,5534,-80,-124,948,52466880,284
1303,p1312,20130726,5578,5534,5544,5546,5476,5488,5504,-46,-30,274,15083000,126
1304,p1312,20130729,5488,5504,5472,5494,5468,5468,5482,-36,-22,66,3619120,118
1305,p1312,20130730,5468,5482,5450,5472,5450,5472,5458,-10,-24,32,1747040,94
1306,p1312,20130731,5472,5458,5538,5548,5538,5548,5544,90,86,10,554400,84
1307,p1312,20130801,5548,5544,5534,5566,5400,5536,5474,-8,-70,388,21239720,134
1308,p1312,20130802,5536,5474,5552,5590,5552,5590,5558,116,84,48,2667880,118
1309,p1312,20130805,5590,5558,5576,5576,5558,5572,5572,14,14,50,2786200,76
1310,p1312,20130806,5572,5572,5722,5722,5550,5550,5616,-22,44,130,7302920,52
1311,p1312,20130807,5550,5616,0,0,0,5504,5504,-112,-112,0,0,52
1312,p1312,20130808,5504,5504,5462,5462,5462,5462,5462,-42,-42,4,218480,52
1313,p1312,20130809,5462,5462,5502,5502,5502,5502,5502,40,40,6,330120,46
1314,p1312,20130812,5502,5502,5422,5474,5422,5474,5448,-28,-54,32,1743360,28
1315,p1312,20130813,5474,5448,5548,5648,5548,5640,5626,192,178,22,1237920,6
1316,p1312,20130814,5640,5626,5642,5642,5642,5642,5642,16,16,2,112840,6
1317,p1312,20130815,5642,5642,5638,5640,5638,5640,5638,-2,-4,6,338360,12
1318,p1312,20130816,5640,5638,5676,5678,5676,5678,5676,40,38,8,454120,8
1319,p1312,20130819,5678,5676,0,0,0,5676,5676,0,0,0,0,8
1320,p1312,20130820,5676,5676,0,0,0,5674,5674,-2,-2,0,0,8
1321,p1312,20130821,5674,5674,5600,5600,5600,5600,5600,-74,-74,4,224000,8
1322,p1312,20130822,5600,5600,5600,5600,5600,5600,5600,0,0,4,224000,6
1323,p1312,20130823,5600,5600,0,0,0,5600,5600,0,0,0,0,6
1324,p1312,20130826,5600,5600,0,0,0,5594,5594,-6,-6,0,0,6
1325,p1312,20130827,5594,5594,0,0,0,5738,5738,144,144,0,0,6
1326,p1312,20130828,5738,5738,0,0,0,5738,5738,0,0,0,0,6
1327,p1312,20130829,5738,5738,0,0,0,5652,5652,-86,-86,0,0,6
1328,p1312,20130830,5652,5652,0,0,0,5652,5652,0,0,0,0,6
1329,p1312,20130902,5652,5652,0,0,0,5760,5760,108,108,0,0,6
1330,p1312,20130903,5760,5760,5690,5730,5686,5696,5700,-64,-60,10,570040,8
1331,p1312,20130904,5696,5700,5698,5698,5582,5582,5640,-118,-60,4,225600,8
1332,p1312,20130905,5582,5640,5722,5722,5722,5722,5722,82,82,4,228880,12
1333,p1312,20130906,5722,5722,5670,5694,5662,5694,5672,-28,-50,10,567360,8
1334,p1312,20130909,5694,5672,0,0,0,5672,5672,0,0,0,0,8
1335,p1312,20130910,5672,5672,5676,5676,5676,5676,5676,4,4,4,227040,8
1336,p1312,20130911,5676,5676,0,0,0,5656,5656,-20,-20,0,0,8
1337,p1312,20130912,5656,5656,0,0,0,5724,5724,68,68,0,0,8
1338,p1312,20130913,5724,5724,0,0,0,5600,5600,-124,-124,0,0,8
1339,p1312,20130916,5600,5600,5540,5560,5482,5482,5518,-118,-82,8,441440,8
1340,p1312,20130917,5482,5518,5404,5510,5404,5422,5450,-96,-68,30,1635160,12
1341,p1312,20130918,5422,5450,0,0,0,5450,5450,0,0,0,0,12
1342,p1312,20130923,5450,5450,0,0,0,5450,5450,0,0,0,0,12
1343,p1312,20130924,5450,5450,5420,5502,5394,5502,5456,52,6,24,1309800,10
1344,p1312,20130925,5502,5456,0,0,0,5456,5456,0,0,0,0,10
1345,p1312,20130926,5456,5456,5422,5422,5422,5422,5422,-34,-34,4,216880,8
1346,p1312,20130927,5422,5422,5540,5540,5540,5540,5540,118,118,4,221600,8
1347,p1312,20130930,5540,5540,5552,5552,5428,5478,5486,-62,-54,298,16352440,10
1348,p1312,20131008,5478,5486,0,0,0,5814,5814,328,328,0,0,10
1349,p1312,20131009,5814,5814,0,0,0,6046,6046,232,232,0,0,10
1350,p1312,20131010,6046,6046,0,0,0,5806,5806,-240,-240,0,0,10
1351,p1312,20131011,5806,5806,0,0,0,5914,5914,108,108,0,0,10
1352,p1312,20131014,5914,5914,5678,5812,5678,5812,5738,-102,-176,16,918120,8
1353,p1312,20131015,5812,5738,5780,5780,5614,5614,5698,-124,-40,798,45472360,398
1354,p1312,20131016,5614,5698,5702,5754,5668,5680,5694,-18,-4,416,23691000,8
1355,p1312,20131017,5680,5694,0,0,0,5796,5796,102,102,0,0,8
1356,p1312,20131018,5796,5796,0,0,0,5720,5720,-76,-76,0,0,8
1357,p1312,20131021,5720,5720,5910,5910,5882,5884,5890,164,170,14,824720,12
1358,p1312,20131022,5884,5890,0,0,0,5890,5890,0,0,0,0,12
1359,p1312,20131023,5890,5890,0,0,0,5910,5910,20,20,0,0,12
1360,p1312,20131024,5910,5910,0,0,0,5910,5910,0,0,0,0,12
1361,p1312,20131025,5910,5910,5908,5908,5908,5908,5908,-2,-2,8,472640,8
1362,p1312,20131028,5908,5908,5912,5954,5912,5954,5932,46,24,4,237320,8
1363,p1312,20131029,5954,5932,0,0,0,5932,5932,0,0,0,0,8
1364,p1312,20131030,5932,5932,0,0,0,5932,5932,0,0,0,0,8
1365,p1312,20131031,5932,5932,0,0,0,5932,5932,0,0,0,0,8
1366,p1312,20131101,5932,5932,0,0,0,5932,5932,0,0,0,0,8
1367,p1312,20131104,5932,5932,5932,5932,5932,5932,5932,0,0,2,118640,8
1368,p1312,20131105,5932,5932,6090,6090,6090,6090,6090,158,158,2,121800,8
1369,p1312,20131106,6090,6090,6114,6116,5950,6090,6048,0,-42,10,604800,8
1370,p1312,20131107,6090,6048,0,0,0,6048,6048,0,0,0,0,8
1371,p1312,20131108,6048,6048,0,0,0,6048,6048,0,0,0,0,8
1372,p1312,20131111,6048,6048,6008,6008,5858,5954,5964,-94,-84,14,835000,8
1373,p1312,20131112,5954,5964,0,0,0,5964,5964,0,0,0,0,8
1374,p1312,20131113,5964,5964,0,0,0,5964,5964,0,0,0,0,8
1375,p1312,20131114,5964,5964,0,0,0,5964,5964,0,0,0,0,8
1376,p1312,20131115,5964,5964,0,0,0,5964,5964,0,0,0,0,8
1377,p1312,20131118,5964,5964,0,0,0,5964,5964,0,0,0,0,8
1378,p1312,20131119,5964,5964,0,0,0,5964,5964,0,0,0,0,8
1379,p1312,20131120,5964,5964,0,0,0,5964,5964,0,0,0,0,8
1380,p1312,20131121,5964,5964,0,0,0,5964,5964,0,0,0,0,8
1381,p1312,20131122,5964,5964,0,0,0,5964,5964,0,0,0,0,8
1382,p1312,20131125,5964,5964,0,0,0,5964,5964,0,0,0,0,8
1383,p1312,20131126,5964,5964,0,0,0,5964,5964,0,0,0,0,8
1384,p1312,20131127,5964,5964,6202,6202,6202,6202,6202,238,238,2,124040,8
1385,p1312,20131128,6202,6202,6000,6000,6000,6000,6000,-202,-202,2,120000,6
1386,p1312,20131129,6000,6000,5760,6000,5760,6000,5940,0,-60,8,475200,0
1387,p1312,20131202,6000,5940,0,0,0,5940,5940,0,0,0,0,0
1388,p1312,20131203,5940,5940,0,0,0,5940,5940,0,0,0,0,0
1389,p1312,20131204,5940,5940,0,0,0,5940,5940,0,0,0,0,0
1390,p1312,20131205,5940,5940,0,0,0,5940,5940,0,0,0,0,0
1391,p1312,20131206,5940,5940,0,0,0,5940,5940,0,0,0,0,0
1392,p1312,20131209,5940,5940,0,0,0,5940,5940,0,0,0,0,0
1393,p1312,20131210,5940,5940,0,0,0,5940,5940,0,0,0,0,0
1394,p1312,20131211,5940,5940,0,0,0,5940,5940,0,0,0,0,0
1395,p1312,20131212,5940,5940,0,0,0,5940,5940,0,0,0,0,0
1396,p1312,20131213,5940,5940,0,0,0,5940,5940,0,0,0,0,0
1397,p1401,20130121,7136,7090,7158,7180,7122,7148,7136,58,46,616,43958680,1106
1398,p1401,20130122,7148,7136,7150,7238,7150,7238,7184,102,48,490,35207440,1212
1399,p1401,20130123,7238,7184,7266,7270,7222,7258,7240,74,56,436,31569240,1412
1400,p1401,20130124,7258,7240,7232,7232,7120,7130,7172,-110,-68,996,71437680,1860
1401,p1401,20130125,7130,7172,7180,7190,7146,7154,7160,-18,-12,370,26497960,1976
1402,p1401,20130128,7154,7160,7148,7160,7084,7156,7120,-4,-40,974,69352880,2446
1403,p1401,20130129,7156,7120,7136,7148,7110,7132,7126,12,6,518,36916640,2652
1404,p1401,20130130,7132,7126,7138,7220,7128,7204,7198,78,72,1362,98062560,3164
1405,p1401,20130131,7204,7198,7422,7422,7234,7312,7288,114,90,1462,106576440,3444
1406,p1401,20130201,7312,7288,7306,7340,7280,7338,7312,50,24,1096,80159360,3604
1407,p1401,20130204,7338,7312,7340,7384,7328,7342,7360,30,48,1064,78330800,4252
1408,p1401,20130205,7342,7360,7298,7322,7290,7290,7306,-70,-54,1318,96318200,4372
1409,p1401,20130206,7290,7306,7304,7322,7262,7268,7284,-38,-22,482,35110520,4658
1410,p1401,20130207,7268,7284,7268,7268,7220,7250,7244,-34,-40,2098,151990760,5672
1411,p1401,20130208,7250,7244,7254,7286,7230,7230,7256,-14,12,1962,142393080,5476
1412,p1401,20130218,7230,7256,7230,7230,7156,7194,7196,-62,-60,1714,123361560,5976
1413,p1401,20130219,7194,7196,7202,7272,7202,7266,7244,70,48,3004,217630120,7244
1414,p1401,20130220,7266,7244,7128,7320,7128,7294,7294,50,50,1164,84920600,7480
1415,p1401,20130221,7294,7294,7242,7244,7154,7200,7196,-94,-98,2944,211857160,7660
1416,p1401,20130222,7200,7196,7190,7260,7178,7236,7212,40,16,3102,223749080,8890
1417,p1401,20130225,7236,7212,7130,7130,6936,6956,7008,-256,-204,3236,226817560,9144
1418,p1401,20130226,6956,7008,6966,6990,6872,6882,6928,-126,-80,3532,244762240,9916
1419,p1401,20130227,6882,6928,6890,6904,6850,6884,6876,-44,-52,3340,229676120,9708
1420,p1401,20130228,6884,6876,6898,6906,6768,6774,6818,-102,-58,7254,494593440,12290
1421,p1401,20130301,6774,6818,6774,6774,6710,6746,6738,-72,-80,5678,382586040,14296
1422,p1401,20130304,6746,6738,6768,6798,6732,6776,6772,38,34,4712,319108960,16090
1423,p1401,20130305,6776,6772,6800,6834,6720,6748,6780,-24,8,3900,264451200,16800
1424,p1401,20130306,6748,6780,6740,6796,6702,6748,6758,-32,-22,6252,422603960,18296
1425,p1401,20130307,6748,6758,6730,6768,6704,6704,6732,-54,-26,5962,401412040,18842
1426,p1401,20130308,6704,6732,6768,6776,6738,6750,6756,18,24,6214,419925600,20472
1427,p1401,20130311,6750,6756,6752,6754,6676,6676,6708,-80,-48,12642,848221640,23798
1428,p1401,20130312,6676,6708,6686,6698,6572,6580,6632,-128,-76,20536,1362267960,35926
1429,p1401,20130313,6580,6632,6576,6576,6420,6428,6470,-204,-162,27778,1797614240,44678
1430,p1401,20130314,6428,6470,6420,6444,6330,6374,6378,-96,-92,32044,2044272800,50108
1431,p1401,20130315,6374,6378,6378,6488,6366,6472,6430,94,52,38468,2473614200,56056
1432,p1401,20130318,6472,6430,6396,6448,6344,6390,6402,-40,-28,24972,1599158080,56070
1433,p1401,20130319,6390,6402,6418,6450,6416,6440,6432,38,30,24758,1592612800,64016
1434,p1401,20130320,6440,6432,6420,6460,6388,6448,6428,16,-4,19696,1266074440,66210
1435,p1401,20130321,6448,6428,6498,6574,6476,6532,6538,104,110,33148,2167234440,64964
1436,p1401,20130322,6532,6538,6530,6570,6512,6532,6540,-6,2,35086,2294851920,64802
1437,p1401,20130325,6532,6540,6558,6634,6558,6576,6596,36,56,51554,3400842400,74714
1438,p1401,20130326,6576,6596,6570,6570,6492,6508,6526,-88,-70,57410,3746581160,72982
1439,p1401,20130327,6508,6526,6538,6576,6504,6570,6538,44,12,39796,2602513280,72084
1440,p1401,20130328,6570,6538,6562,6572,6456,6476,6502,-62,-36,53042,3449011160,72268
1441,p1401,20130329,6476,6502,6380,6452,6296,6414,6406,-88,-96,72876,4669554480,76374
1442,p1401,20130401,6414,6406,6374,6422,6290,6292,6344,-114,-62,37218,2361838960,79002
1443,p1401,20130402,6292,6344,6344,6380,6270,6376,6318,32,-26,55328,3495848400,81462
1444,p1401,20130403,6376,6318,6338,6418,6318,6352,6374,34,56,51130,3259205720,85802
1445,p1401,20130408,6352,6374,6348,6428,6310,6418,6394,44,20,33590,2147903840,88854
1446,p1401,20130409,6418,6394,6430,6492,6430,6456,6468,62,74,33340,2156999120,91292
1447,p1401,20130410,6456,6468,6490,6522,6444,6514,6488,46,20,45800,2971857320,91588
1448,p1401,20130411,6514,6488,6490,6526,6414,6422,6468,-66,-20,45526,2944884600,96674
1449,p1401,20130412,6422,6468,6400,6456,6390,6440,6424,-28,-44,34790,2235134840,100014
1450,p1401,20130415,6440,6424,6384,6390,6264,6312,6326,-112,-98,71792,4542468200,94934
1451,p1401,20130416,6312,6326,6202,6314,6178,6294,6262,-32,-64,73874,4626479040,98196
1452,p1401,20130417,6294,6262,6310,6346,6230,6266,6290,4,28,54448,3425816480,106498
1453,p1401,20130418,6266,6290,6202,6266,6172,6234,6222,-56,-68,52326,3256681480,109392
1454,p1401,20130419,6234,6222,6246,6296,6246,6268,6274,46,52,47724,2994489640,112670
1455,p1401,20130422,6268,6274,6250,6250,6100,6100,6158,-174,-116,69258,4265094480,118484
1456,p1401,20130423,6100,6158,6110,6170,6072,6136,6114,-22,-44,69952,4277595320,127636
1457,p1401,20130424,6136,6114,6136,6182,6058,6060,6110,-54,-4,74726,4566350400,128058
1458,p1401,20130425,6060,6110,6110,6154,6092,6098,6124,-12,14,55672,3409613800,129896
1459,p1401,20130426,6098,6124,6148,6152,6068,6078,6110,-46,-14,51978,3176181760,138030
1460,p1401,20130502,6078,6110,5998,6004,5950,5968,5976,-142,-134,55964,3344462680,139004
1461,p1401,20130503,5968,5976,5978,6060,5976,5996,6014,20,38,103218,6208141000,156142
1462,p1401,20130506,5996,6014,6040,6076,5998,6066,6036,52,22,129948,7844409760,192120
1463,p1401,20130507,6066,6036,6028,6088,6004,6012,6044,-24,8,160144,9679385720,205628
1464,p1401,20130508,6012,6044,6036,6102,6020,6098,6070,54,26,138882,8432358040,219622
1465,p1401,20130509,6098,6070,6074,6114,6052,6070,6076,0,6,94944,5769090480,236238
1466,p1401,20130510,6070,6076,6092,6266,6092,6242,6180,166,104,305618,18890160480,281646
1467,p1401,20130513,6242,6180,6240,6290,6218,6232,6248,52,68,254568,15907546080,307562
1468,p1401,20130514,6232,6248,6290,6290,6208,6234,6246,-14,-2,173708,10851156560,300466
1469,p1401,20130515,6234,6246,6248,6248,6084,6100,6150,-146,-96,243444,14975303720,298788
1470,p1401,20130516,6100,6150,6128,6214,6096,6180,6158,30,8,199770,12303837080,307398
1471,p1401,20130517,6180,6158,6204,6246,6194,6236,6226,78,68,179962,11205264920,295404
1472,p1401,20130520,6236,6226,6238,6250,6178,6214,6218,-12,-8,210518,13091310600,301426
1473,p1401,20130521,6214,6218,6218,6226,6146,6190,6184,-28,-34,216140,13367603760,285874
1474,p1401,20130522,6190,6184,6200,6270,6200,6240,6244,56,60,183104,11434323560,283434
1475,p1401,20130523,6240,6244,6250,6266,6170,6178,6210,-66,-34,171606,10659627120,280464
1476,p1401,20130524,6178,6210,6206,6304,6200,6236,6264,26,54,241202,15110081840,302034
1477,p1401,20130527,6236,6264,6194,6246,6184,6244,6222,-20,-42,134906,8396398520,325886
1478,p1401,20130528,6244,6222,6260,6292,6222,6258,6256,36,34,207014,12953279480,354530
1479,p1401,20130529,6258,6256,6280,6346,6252,6294,6302,38,46,294644,18568808640,358392
1480,p1401,20130530,6294,6302,6220,6280,6192,6226,6230,-76,-72,238156,14841539040,368334
1481,p1401,20130531,6226,6230,6234,6258,6180,6198,6218,-32,-12,218374,13580838320,376632
1482,p1401,20130603,6198,6218,6226,6288,6224,6274,6260,56,42,281134,17603339880,384880
1483,p1401,20130604,6274,6260,6288,6288,6150,6158,6194,-102,-66,319424,19786255320,389200
1484,p1401,20130605,6158,6194,6170,6186,6106,6114,6132,-80,-62,392836,24088807440,419398
1485,p1401,20130606,6114,6132,6100,6188,6090,6148,6144,16,12,449794,27641017080,401886
1486,p1401,20130607,6148,6144,6176,6336,6124,6330,6244,186,100,648298,40482021840,390580
1487,p1401,20130613,6330,6244,6284,6356,6254,6276,6290,32,46,498960,31392851080,442574
1488,p1401,20130614,6276,6290,6264,6268,6182,6218,6210,-72,-80,452664,28114009360,466796
1489,p1401,20130617,6218,6210,6222,6276,6210,6256,6252,46,42,477216,29842079040,475986
1490,p1401,20130618,6256,6252,6276,6342,6270,6272,6302,20,50,450990,28427549640,473508
1491,p1401,20130619,6272,6302,6252,6268,6210,6238,6230,-64,-72,417978,26045524720,508786
1492,p1401,20130620,6238,6230,6240,6274,6184,6198,6230,-32,0,460298,28677469480,481684
1493,p1401,20130621,6198,6230,6096,6100,5982,5998,6036,-232,-194,781474,47179449040,509556
1494,p1401,20130624,5998,6036,5956,6016,5902,5918,5950,-118,-86,562994,33501226240,515724
1495,p1401,20130625,5918,5950,5948,5966,5880,5924,5920,-26,-30,655698,38826024640,519990
1496,p1401,20130626,5924,5920,5910,5960,5818,5878,5882,-42,-38,649500,38204952400,524200
1497,p1401,20130627,5878,5882,5846,5864,5806,5828,5830,-54,-52,405884,23666781400,523034
1498,p1401,20130628,5828,5830,5818,5878,5790,5844,5848,14,18,391178,22876951680,540030
1499,p1401,20130701,5844,5848,5820,5932,5814,5910,5894,62,46,450376,26549486440,523836
1500,p1401,20130702,5910,5894,5900,5930,5862,5898,5896,4,2,348176,20533877600,512142
1501,p1401,20130703,5898,5896,5904,5918,5878,5888,5894,-8,-2,313970,18508052920,525074
1502,p1401,20130704,5888,5894,5908,5962,5902,5928,5930,34,36,448638,26608983640,536514
1503,p1401,20130705,5928,5930,5928,5934,5870,5890,5888,-40,-42,304182,17915413000,540742
1504,p1401,20130708,5890,5888,5930,5960,5834,5850,5888,-38,0,487148,28685043840,550564
1505,p1401,20130709,5850,5888,5858,5892,5852,5872,5872,-16,-16,287772,16903229680,546422
1506,p1401,20130710,5872,5872,5900,5926,5824,5882,5876,10,4,405236,23814108440,559192
1507,p1401,20130711,5882,5876,5894,5982,5888,5932,5930,56,54,480354,28488544640,555930
1508,p1401,20130712,5932,5930,5906,5916,5806,5818,5842,-112,-88,583298,34083097960,610958
1509,p1401,20130715,5818,5842,5780,5780,5638,5640,5684,-202,-158,787282,44762008000,662098
1510,p1401,20130716,5640,5684,5660,5678,5610,5636,5640,-48,-44,501280,28280475480,656236
1511,p1401,20130717,5636,5640,5600,5662,5590,5616,5624,-24,-16,647856,36435514800,684310
1512,p1401,20130718,5616,5624,5600,5664,5568,5642,5620,18,-4,563072,31645463680,648204
1513,p1401,20130719,5642,5620,5650,5676,5582,5596,5628,-24,8,437980,24653250920,675550
1514,p1401,20130722,5596,5628,5600,5636,5572,5616,5608,-12,-20,426550,23923670600,669482
1515,p1401,20130723,5616,5608,5610,5642,5588,5634,5618,26,10,479042,26921919160,666018
1516,p1401,20130724,5634,5618,5580,5594,5540,5568,5572,-50,-46,410580,22879633000,678474
1517,p1401,20130725,5568,5572,5502,5536,5502,5516,5518,-56,-54,365652,20182973800,687336
1518,p1401,20130726,5516,5518,5460,5488,5360,5368,5418,-150,-100,506426,27447707200,677678
1519,p1401,20130729,5368,5418,5376,5408,5354,5356,5380,-62,-38,303176,16313703320,678360
1520,p1401,20130730,5356,5380,5316,5366,5306,5350,5334,-30,-46,435450,23233329680,684034
1521,p1401,20130731,5350,5334,5364,5468,5346,5424,5426,90,92,672746,36509621640,674928
1522,p1401,20130801,5424,5426,5418,5442,5394,5412,5416,-14,-10,317060,17176564080,669130
1523,p1401,20130802,5412,5416,5430,5514,5424,5506,5470,90,54,590064,32277545040,695010
1524,p1401,20130805,5506,5470,5486,5486,5434,5446,5454,-24,-16,336382,18348055520,700006
1525,p1401,20130806,5446,5454,5464,5468,5418,5422,5440,-32,-14,273202,14864907200,696012
1526,p1401,20130807,5422,5440,5400,5406,5326,5328,5354,-112,-86,410118,21959740160,682410
1527,p1401,20130808,5328,5354,5322,5366,5316,5330,5342,-24,-12,320742,17139170320,678072
1528,p1401,20130809,5330,5342,5340,5414,5340,5358,5378,16,36,514098,27649707600,690340
1529,p1401,20130812,5358,5378,5354,5432,5346,5414,5390,36,12,501566,27038395160,741066
1530,p1401,20130813,5414,5390,5470,5596,5462,5570,5546,180,156,791636,43909920680,695242
1531,p1401,20130814,5570,5546,5570,5626,5494,5510,5556,-36,10,730174,40571339760,706954
1532,p1401,20130815,5510,5556,5532,5580,5522,5542,5550,-14,-6,491876,27308649000,708922
1533,p1401,20130816,5542,5550,5610,5678,5586,5610,5632,60,82,517682,29162754000,636392
1534,p1401,20130819,5610,5632,5650,5674,5612,5634,5640,2,8,358864,20240575800,626080
1535,p1401,20130820,5634,5640,5680,5684,5522,5540,5584,-100,-56,535970,29931097280,618842
1536,p1401,20130821,5540,5584,5540,5570,5512,5536,5542,-48,-42,286308,15872513920,613304
1537,p1401,20130822,5536,5542,5520,5564,5490,5524,5526,-18,-16,349752,19331937800,618032
1538,p1401,20130823,5524,5526,5534,5552,5502,5550,5534,24,8,360392,19946729400,628240
1539,p1401,20130826,5550,5534,5650,5754,5650,5754,5728,220,194,221738,12701473520,592066
1540,p1401,20130827,5754,5728,5854,5862,5778,5826,5818,98,90,623748,36298612120,622652
1541,p1401,20130828,5826,5818,5800,5842,5700,5724,5794,-94,-24,513300,29748157760,580002
1542,p1401,20130829,5724,5794,5760,5764,5564,5594,5654,-200,-140,766712,43365207120,581894
1543,p1401,20130830,5594,5654,5598,5598,5532,5554,5562,-100,-92,546672,30406015200,616134
1544,p1401,20130902,5554,5562,5586,5650,5574,5650,5622,88,60,408810,22986492240,600854
1545,p1401,20130903,5650,5622,5678,5696,5562,5624,5616,2,-6,513616,28846862800,611482
1546,p1401,20130904,5624,5616,5578,5604,5550,5584,5580,-32,-36,414388,23130968520,627660
1547,p1401,20130905,5584,5580,5568,5620,5556,5570,5584,-10,4,363864,20323444200,626152
1548,p1401,20130906,5570,5584,5590,5660,5568,5652,5614,68,30,511894,28746586560,637606
1549,p1401,20130909,5652,5614,5650,5680,5632,5640,5648,26,34,303300,17135207680,650958
1550,p1401,20130910,5640,5648,5578,5578,5454,5494,5516,-154,-132,701638,38706482240,691694
1551,p1401,20130911,5494,5516,5508,5528,5488,5524,5506,8,-10,338610,18645358680,694926
1552,p1401,20130912,5524,5506,5500,5540,5474,5498,5502,-8,-4,417396,22968816240,686622
1553,p1401,20130913,5498,5502,5550,5580,5446,5470,5490,-32,-12,528066,28999951320,674482
1554,p1401,20130916,5470,5490,5416,5452,5382,5392,5418,-98,-72,370454,20077531760,667380
1555,p1401,20130917,5392,5418,5402,5414,5354,5412,5390,-6,-28,412372,22232063680,665016
1556,p1401,20130918,5412,5390,5400,5452,5378,5392,5416,2,26,402222,21784925800,670530
1557,p1401,20130923,5392,5416,5348,5378,5310,5364,5346,-52,-70,244514,13075910640,686192
1558,p1401,20130924,5364,5346,5380,5434,5370,5410,5410,64,64,314586,17021793760,680882
1559,p1401,20130925,5410,5410,5398,5446,5380,5400,5410,-10,0,301976,16342261560,688010
1560,p1401,20130926,5400,5410,5390,5426,5364,5404,5394,-6,-16,214026,11546836240,675726
1561,p1401,20130927,5404,5394,5400,5418,5364,5378,5386,-16,-8,320470,17266042360,625776
1562,p1401,20130930,5378,5386,5386,5418,5370,5384,5392,-2,6,230740,12442835800,615826
1563,p1401,20131008,5384,5392,5400,5556,5380,5500,5496,108,104,444452,24430659440,644802
1564,p1401,20131009,5500,5496,5516,5564,5506,5528,5536,32,40,321544,17803521320,662992
1565,p1401,20131010,5528,5536,5560,5632,5530,5610,5584,74,48,511818,28581146040,646564
1566,p1401,20131011,5610,5584,5630,5664,5592,5620,5624,36,40,324218,18234508040,641746
1567,p1401,20131014,5620,5624,5610,5700,5600,5680,5670,56,46,330052,18719630040,630022
1568,p1401,20131015,5680,5670,5674,5682,5640,5674,5660,4,-10,222032,12569436280,612726
1569,p1401,20131016,5674,5660,5684,5712,5650,5662,5676,2,16,226716,12870357840,605670
1570,p1401,20131017,5662,5676,5708,5790,5708,5746,5748,70,72,341188,19615301280,582538
1571,p1401,20131018,5746,5748,5736,5780,5702,5778,5742,30,-6,228002,13095710280,577996
1572,p1401,20131021,5778,5742,5850,5938,5808,5906,5896,164,154,395288,23306976840,540750
1573,p1401,20131022,5906,5896,5938,5938,5852,5862,5882,-34,-14,236982,13943373760,501374
1574,p1401,20131023,5862,5882,5908,5952,5872,5920,5912,38,30,332824,19679482520,478246
1575,p1401,20131024,5920,5912,5954,5958,5866,5894,5902,-18,-10,255388,15073662480,465998
1576,p1401,20131025,5894,5902,5882,5884,5832,5858,5858,-44,-44,242794,14222991160,440484
1577,p1401,20131028,5858,5858,5850,5892,5834,5848,5860,-10,2,167226,9801499400,432080
1578,p1401,20131029,5848,5860,5838,5882,5820,5878,5854,18,-6,173484,10156191560,411016
1579,p1401,20131030,5878,5854,5912,6088,5912,6088,6022,234,168,385468,23219266760,456616
1580,p1401,20131031,6088,6022,6060,6096,6038,6060,6066,38,44,238852,14489829640,432988
1581,p1401,20131101,6060,6066,6090,6182,6074,6178,6118,112,52,307214,18795819480,428418
1582,p1401,20131104,6178,6118,6180,6180,6070,6100,6110,-18,-8,245524,15004673520,378914
1583,p1401,20131105,6100,6110,6066,6086,6000,6060,6040,-50,-70,186624,11273739000,366488
1584,p1401,20131106,6060,6040,6040,6094,6034,6058,6064,18,24,179974,10915937120,346030
1585,p1401,20131107,6058,6064,6040,6088,6028,6042,6050,-22,-14,128960,7804384760,330106
1586,p1401,20131108,6042,6050,6050,6058,5988,6018,6016,-32,-34,88640,5333521720,323066
1587,p1401,20131111,6018,6016,6030,6096,5974,5984,6010,-32,-6,124288,7470228480,297664
1588,p1401,20131112,5984,6010,6006,6012,5946,6004,5978,-6,-32,98214,5871616160,279772
1589,p1401,20131113,6004,5978,6060,6096,6046,6090,6072,112,94,98262,5967426040,270914
1590,p1401,20131114,6090,6072,6080,6118,6066,6102,6084,30,12,55688,3388946680,269868
1591,p1401,20131115,6102,6084,6086,6128,6062,6070,6092,-14,8,80070,4878134680,257858
1592,p1401,20131118,6070,6092,6058,6074,6028,6032,6048,-60,-44,39782,2406164880,247758
1593,p1401,20131119,6032,6048,6016,6052,6000,6006,6020,-42,-28,52758,3176668280,233902
1594,p1401,20131120,6006,6020,5998,6058,5986,6054,6014,34,-6,36542,2197896440,226870
1595,p1401,20131121,6054,6014,6066,6192,6052,6138,6124,124,110,110642,6777309040,216834
1596,p1401,20131122,6138,6124,6192,6248,6192,6226,6220,102,96,87310,5431755200,199122
1597,p1401,20131125,6226,6220,6220,6278,6190,6232,6234,12,14,88358,5508904520,186394
1598,p1401,20131126,6232,6234,6228,6228,6084,6088,6144,-146,-90,85546,5256921360,176674
1599,p1401,20131127,6088,6144,6090,6126,6064,6106,6088,-38,-56,52200,3178039720,169002
1600,p1401,20131128,6106,6088,6092,6142,6086,6110,6116,22,28,37942,2321099520,159772
1601,p1401,20131129,6110,6116,6150,6150,6094,6138,6118,22,2,43036,2633360200,160084
1602,p1401,20131202,6138,6118,6146,6146,6080,6098,6100,-20,-18,26580,1621456520,155608
1603,p1401,20131203,6098,6100,6096,6100,5986,6002,6030,-98,-70,53508,3226992480,144052
1604,p1401,20131204,6002,6030,5998,6026,5970,6010,6006,-20,-24,28506,1712348120,134644
1605,p1401,20131205,6010,6006,6038,6058,5920,5930,5992,-76,-14,37980,2275784840,124846
1606,p1401,20131206,5930,5992,5948,5964,5898,5952,5932,-40,-60,28728,1704306280,116542
1607,p1401,20131209,5952,5932,5964,6044,5960,5994,6000,62,68,56322,3379333360,98538
1608,p1401,20131210,5994,6000,5982,5998,5946,5984,5972,-16,-28,30360,1813508960,89456
1609,p1401,20131211,5984,5972,5972,5998,5950,5994,5978,22,6,20690,1237099240,84962
1610,p1401,20131212,5994,5978,5988,6012,5934,5944,5974,-34,-4,24688,1475289640,73290
1611,p1401,20131213,5944,5974,5902,5914,5792,5824,5858,-150,-116,37458,2194577360,56470
1612,p1401,20131216,5824,5858,5822,5856,5792,5808,5824,-50,-34,10186,593256880,51882
1613,p1401,20131217,5808,5824,5824,5868,5816,5822,5842,-2,18,9764,570480720,47590
1614,p1401,20131218,5822,5842,5800,5820,5740,5816,5766,-26,-76,14200,818773400,41050
1615,p1401,20131219,5816,5766,5810,5810,5762,5768,5792,2,26,8086,468394760,36268
1616,p1401,20131220,5768,5792,5792,5828,5780,5784,5802,-8,10,5172,300130040,35022
1617,p1401,20131223,5784,5802,5800,5812,5724,5794,5774,-8,-28,11336,654749320,30100
1618,p1401,20131224,5794,5774,5798,5798,5750,5754,5766,-20,-8,4334,249947800,28204
1619,p1401,20131225,5754,5766,5754,5764,5698,5700,5722,-66,-44,8080,462466320,22790
1620,p1401,20131226,5700,5722,5708,5730,5696,5710,5710,-12,-12,2758,157509600,21140
1621,p1401,20131227,5710,5710,5704,5800,5704,5782,5750,72,40,3642,209462360,20004
1622,p1401,20131230,5782,5750,5774,5858,5768,5840,5836,90,86,4908,286512920,18878
1623,p1401,20131231,5840,5836,5840,5840,5776,5828,5798,-8,-38,2614,151600080,16974
1624,p1402,20130225,7292,7292,0,0,0,7292,7292,0,0,0,0,0
1625,p1402,20130226,7292,7292,0,0,0,7292,7292,0,0,0,0,0
1626,p1402,20130227,7292,7292,0,0,0,7292,7292,0,0,0,0,0
1627,p1402,20130228,7292,7292,6910,6910,6878,6878,6894,-414,-398,4,275760,4
1628,p1402,20130301,6878,6894,6846,6850,6774,6796,6814,-98,-80,36,2453360,2
1629,p1402,20130304,6796,6814,6802,6840,6802,6836,6826,22,12,6,409560,4
1630,p1402,20130305,6836,6826,0,0,0,6826,6826,0,0,0,0,4
1631,p1402,20130306,6826,6826,0,0,0,6826,6826,0,0,0,0,4
1632,p1402,20130307,6826,6826,0,0,0,6826,6826,0,0,0,0,4
1633,p1402,20130308,6826,6826,0,0,0,6826,6826,0,0,0,0,4
1634,p1402,20130311,6826,6826,0,0,0,6826,6826,0,0,0,0,4
1635,p1402,20130312,6826,6826,6664,6664,6664,6664,6664,-162,-162,6,399840,6
1636,p1402,20130313,6664,6664,6544,6544,6544,6544,6544,-120,-120,2,130880,8
1637,p1402,20130314,6544,6544,0,0,0,6544,6544,0,0,0,0,8
1638,p1402,20130315,6544,6544,6452,6502,6420,6502,6456,-42,-88,8,516520,6
1639,p1402,20130318,6502,6456,6472,6472,6472,6472,6472,16,16,4,258880,6
1640,p1402,20130319,6472,6472,0,0,0,6472,6472,0,0,0,0,6
1641,p1402,20130320,6472,6472,6450,6520,6440,6520,6486,48,14,24,1556640,4
1642,p1402,20130321,6520,6486,6568,6568,6568,6568,6568,82,82,2,131360,2
1643,p1402,20130322,6568,6568,0,0,0,6568,6568,0,0,0,0,2
1644,p1402,20130325,6568,6568,6640,6640,6640,6640,6640,72,72,2,132800,4
1645,p1402,20130326,6640,6640,0,0,0,6640,6640,0,0,0,0,4
1646,p1402,20130327,6640,6640,0,0,0,6640,6640,0,0,0,0,4
1647,p1402,20130328,6640,6640,0,0,0,6640,6640,0,0,0,0,4
1648,p1402,20130329,6640,6640,0,0,0,6640,6640,0,0,0,0,4
1649,p1402,20130401,6640,6640,0,0,0,6640,6640,0,0,0,0,4
1650,p1402,20130402,6640,6640,6376,6450,6376,6450,6414,-190,-226,14,898080,8
1651,p1402,20130403,6450,6414,6480,6480,6480,6480,6480,66,66,2,129600,6
1652,p1402,20130408,6480,6480,0,0,0,6480,6480,0,0,0,0,6
1653,p1402,20130409,6480,6480,6498,6526,6498,6526,6512,46,32,4,260480,4
1654,p1402,20130410,6526,6512,6524,6560,6524,6560,6542,48,30,4,261680,6
1655,p1402,20130411,6560,6542,0,0,0,6542,6542,0,0,0,0,6
1656,p1402,20130412,6542,6542,0,0,0,6542,6542,0,0,0,0,6
1657,p1402,20130415,6542,6542,0,0,0,6450,6450,-92,-92,0,0,6
1658,p1402,20130416,6450,6450,0,0,0,6450,6450,0,0,0,0,6
1659,p1402,20130417,6450,6450,0,0,0,6374,6374,-76,-76,0,0,6
1660,p1402,20130418,6374,6374,0,0,0,6336,6336,-38,-38,0,0,6
1661,p1402,20130419,6336,6336,0,0,0,6336,6336,0,0,0,0,6
1662,p1402,20130422,6336,6336,0,0,0,6254,6254,-82,-82,0,0,6
1663,p1402,20130423,6254,6254,0,0,0,6236,6236,-18,-18,0,0,6
1664,p1402,20130424,6236,6236,6190,6190,6178,6178,6186,-58,-50,6,371160,6
1665,p1402,20130425,6178,6186,0,0,0,6186,6186,0,0,0,0,6
1666,p1402,20130426,6186,6186,0,0,0,6186,6186,0,0,0,0,6
1667,p1402,20130502,6186,6186,6100,6100,6042,6042,6070,-144,-116,4,242840,6
1668,p1402,20130503,6042,6070,0,0,0,6070,6070,0,0,0,0,6
1669,p1402,20130506,6070,6070,0,0,0,6070,6070,0,0,0,0,6
1670,p1402,20130507,6070,6070,6090,6090,6090,6090,6090,20,20,4,243600,4
1671,p1402,20130508,6090,6090,0,0,0,6120,6120,30,30,0,0,4
1672,p1402,20130509,6120,6120,6164,6164,6128,6128,6146,8,26,8,491680,4
1673,p1402,20130510,6128,6146,0,0,0,6146,6146,0,0,0,0,4
1674,p1402,20130513,6146,6146,6240,6350,6240,6320,6312,174,166,14,883920,4
1675,p1402,20130514,6320,6312,6266,6266,6266,6266,6266,-46,-46,2,125320,4
1676,p1402,20130515,6266,6266,6164,6170,6164,6170,6166,-96,-100,4,246680,4
1677,p1402,20130516,6170,6166,6252,6252,6232,6232,6242,66,76,4,249680,4
1678,p1402,20130517,6232,6242,6314,6314,6250,6250,6282,8,40,4,251280,6
1679,p1402,20130520,6250,6282,6236,6290,6212,6258,6244,-24,-38,456,28474200,16
1680,p1402,20130521,6258,6244,6206,6210,6206,6210,6208,-34,-36,8,496640,12
1681,p1402,20130522,6210,6208,0,0,0,6238,6238,30,30,0,0,12
1682,p1402,20130523,6238,6238,0,0,0,6238,6238,0,0,0,0,12
1683,p1402,20130524,6238,6238,0,0,0,6252,6252,14,14,0,0,12
1684,p1402,20130527,6252,6252,6278,6278,6240,6240,6258,-12,6,4,250360,12
1685,p1402,20130528,6240,6258,0,0,0,6258,6258,0,0,0,0,12
1686,p1402,20130529,6258,6258,0,0,0,6310,6310,52,52,0,0,12
1687,p1402,20130530,6310,6310,6232,6232,6232,6232,6232,-78,-78,2,124640,14
1688,p1402,20130531,6232,6232,6202,6236,6202,6236,6218,4,-14,8,497520,14
1689,p1402,20130603,6236,6218,0,0,0,6220,6220,2,2,0,0,14
1690,p1402,20130604,6220,6220,0,0,0,6220,6220,0,0,0,0,14
1691,p1402,20130605,6220,6220,6138,6166,6138,6140,6150,-80,-70,10,615040,14
1692,p1402,20130606,6140,6150,0,0,0,6150,6150,0,0,0,0,14
1693,p1402,20130607,6150,6150,0,0,0,6280,6280,130,130,0,0,14
1694,p1402,20130613,6280,6280,0,0,0,6280,6280,0,0,0,0,14
1695,p1402,20130614,6280,6280,6238,6242,6238,6242,6238,-38,-42,6,374360,12
1696,p1402,20130617,6242,6238,0,0,0,6238,6238,0,0,0,0,12
1697,p1402,20130618,6238,6238,0,0,0,6238,6238,0,0,0,0,12
1698,p1402,20130619,6238,6238,0,0,0,6238,6238,0,0,0,0,12
1699,p1402,20130620,6238,6238,0,0,0,6238,6238,0,0,0,0,12
1700,p1402,20130621,6238,6238,6100,6100,6100,6100,6100,-138,-138,2,122000,10
1701,p1402,20130624,6100,6100,5984,5984,5960,5960,5972,-140,-128,4,238880,10
1702,p1402,20130625,5960,5972,0,0,0,5972,5972,0,0,0,0,10
1703,p1402,20130626,5972,5972,5878,5938,5878,5900,5904,-72,-68,6,354320,10
1704,p1402,20130627,5900,5904,5882,5902,5882,5902,5892,-2,-12,4,235680,10
1705,p1402,20130628,5902,5892,0,0,0,5892,5892,0,0,0,0,10
1706,p1402,20130701,5892,5892,0,0,0,5942,5942,50,50,0,0,10
1707,p1402,20130702,5942,5942,0,0,0,5942,5942,0,0,0,0,10
1708,p1402,20130703,5942,5942,0,0,0,5940,5940,-2,-2,0,0,10
1709,p1402,20130704,5940,5940,0,0,0,5964,5964,24,24,0,0,10
1710,p1402,20130705,5964,5964,5918,5918,5918,5918,5918,-46,-46,4,236720,12
1711,p1402,20130708,5918,5918,5994,5998,5994,5998,5996,80,78,4,239840,10
1712,p1402,20130709,5998,5996,0,0,0,5996,5996,0,0,0,0,10
1713,p1402,20130710,5996,5996,0,0,0,5996,5996,0,0,0,0,10
1714,p1402,20130711,5996,5996,6006,6006,5850,5850,5960,-146,-36,28,1668920,4
1715,p1402,20130712,5850,5960,0,0,0,5960,5960,0,0,0,0,4
1716,p1402,20130715,5960,5960,0,0,0,5800,5800,-160,-160,0,0,4
1717,p1402,20130716,5800,5800,0,0,0,5756,5756,-44,-44,0,0,4
1718,p1402,20130717,5756,5756,0,0,0,5740,5740,-16,-16,0,0,4
1719,p1402,20130718,5740,5740,0,0,0,5736,5736,-4,-4,0,0,4
1720,p1402,20130719,5736,5736,0,0,0,5744,5744,8,8,0,0,4
1721,p1402,20130722,5744,5744,0,0,0,5744,5744,0,0,0,0,4
1722,p1402,20130723,5744,5744,0,0,0,5754,5754,10,10,0,0,4
1723,p1402,20130724,5754,5754,5582,5656,5564,5610,5600,-144,-154,56,3136080,4
1724,p1402,20130725,5610,5600,0,0,0,5546,5546,-54,-54,0,0,4
1725,p1402,20130726,5546,5546,5766,5766,5468,5538,5690,-8,144,14,796720,16
1726,p1402,20130729,5538,5690,5464,5504,5464,5486,5486,-204,-204,12,658320,24
1727,p1402,20130730,5486,5486,5438,5470,5378,5470,5438,-16,-48,18,978840,18
1728,p1402,20130731,5470,5438,0,0,0,5480,5480,42,42,0,0,18
1729,p1402,20130801,5480,5480,0,0,0,5500,5500,20,20,0,0,18
1730,p1402,20130802,5500,5500,5472,5706,5472,5706,5576,206,76,18,1003840,16
1731,p1402,20130805,5706,5576,5592,5592,5592,5592,5592,16,16,2,111840,16
1732,p1402,20130806,5592,5592,0,0,0,5592,5592,0,0,0,0,16
1733,p1402,20130807,5592,5592,5516,5516,5434,5460,5472,-132,-120,12,656680,16
1734,p1402,20130808,5460,5472,0,0,0,5472,5472,0,0,0,0,16
1735,p1402,20130809,5472,5472,5506,5506,5506,5506,5506,34,34,2,110120,16
1736,p1402,20130812,5506,5506,0,0,0,5506,5506,0,0,0,0,16
1737,p1402,20130813,5506,5506,5626,5726,5286,5708,5598,202,92,54,3023000,20
1738,p1402,20130814,5708,5598,5688,5720,5650,5650,5686,52,88,16,909760,16
1739,p1402,20130815,5650,5686,5690,5690,5656,5656,5672,-30,-14,4,226920,16
1740,p1402,20130816,5656,5672,0,0,0,5690,5690,18,18,0,0,16
1741,p1402,20130819,5690,5690,5784,5784,5734,5734,5758,44,68,4,230360,18
1742,p1402,20130820,5734,5758,5740,5740,5674,5674,5708,-84,-50,6,342520,16
1743,p1402,20130821,5674,5708,5690,5690,5632,5658,5658,-50,-50,8,452760,16
1744,p1402,20130822,5658,5658,0,0,0,5658,5658,0,0,0,0,16
1745,p1402,20130823,5658,5658,0,0,0,5658,5658,0,0,0,0,16
1746,p1402,20130826,5658,5658,5884,5884,5884,5884,5884,226,226,10,588400,16
1747,p1402,20130827,5884,5884,5920,5920,5900,5910,5908,26,24,10,590800,6
1748,p1402,20130828,5910,5908,0,0,0,5908,5908,0,0,0,0,6
1749,p1402,20130829,5908,5908,0,0,0,5766,5766,-142,-142,0,0,6
1750,p1402,20130830,5766,5766,0,0,0,5748,5748,-18,-18,0,0,6
1751,p1402,20130902,5748,5748,5786,5786,5646,5646,5716,-102,-32,4,228640,8
1752,p1402,20130903,5646,5716,0,0,0,5716,5716,0,0,0,0,8
1753,p1402,20130904,5716,5716,0,0,0,5680,5680,-36,-36,0,0,8
1754,p1402,20130905,5680,5680,5638,5698,5638,5696,5666,16,-14,8,453400,8
1755,p1402,20130906,5696,5666,5770,5770,5620,5732,5706,66,40,6,342440,10
1756,p1402,20130909,5732,5706,0,0,0,5706,5706,0,0,0,0,10
1757,p1402,20130910,5706,5706,0,0,0,5574,5574,-132,-132,0,0,10
1758,p1402,20130911,5574,5574,0,0,0,5574,5574,0,0,0,0,10
1759,p1402,20130912,5574,5574,0,0,0,5574,5574,0,0,0,0,10
1760,p1402,20130913,5574,5574,5648,5648,5536,5536,5592,-38,18,4,223680,10
1761,p1402,20130916,5536,5592,0,0,0,5540,5540,-52,-52,0,0,10
1762,p1402,20130917,5540,5540,0,0,0,5512,5512,-28,-28,0,0,10
1763,p1402,20130918,5512,5512,5622,5622,5504,5504,5562,-8,50,4,222520,8
1764,p1402,20130923,5504,5562,0,0,0,5492,5492,-70,-70,0,0,8
1765,p1402,20130924,5492,5492,0,0,0,5492,5492,0,0,0,0,8
1766,p1402,20130925,5492,5492,0,0,0,5492,5492,0,0,0,0,8
1767,p1402,20130926,5492,5492,0,0,0,5492,5492,0,0,0,0,8
1768,p1402,20130927,5492,5492,5564,5564,5442,5442,5502,-50,10,4,220120,8
1769,p1402,20130930,5442,5502,0,0,0,5502,5502,0,0,0,0,8
1770,p1402,20131008,5502,5502,0,0,0,5608,5608,106,106,0,0,8
1771,p1402,20131009,5608,5608,5584,5698,5584,5678,5652,70,44,6,339200,8
1772,p1402,20131010,5678,5652,0,0,0,5652,5652,0,0,0,0,8
1773,p1402,20131011,5652,5652,5744,5774,5660,5660,5720,8,68,36,2059640,10
1774,p1402,20131014,5660,5720,5854,5854,5854,5854,5854,134,134,2,117080,10
1775,p1402,20131015,5854,5854,5726,5726,5726,5726,5726,-128,-128,2,114520,10
1776,p1402,20131016,5726,5726,0,0,0,5726,5726,0,0,0,0,10
1777,p1402,20131017,5726,5726,0,0,0,5726,5726,0,0,0,0,10
1778,p1402,20131018,5726,5726,0,0,0,5730,5730,4,4,0,0,10
1779,p1402,20131021,5730,5730,0,0,0,5958,5958,228,228,0,0,10
1780,p1402,20131022,5958,5958,0,0,0,5958,5958,0,0,0,0,10
1781,p1402,20131023,5958,5958,6082,6170,6010,6170,6140,212,182,72,4421560,72
1782,p1402,20131024,6170,6140,6010,6010,6010,6010,6010,-130,-130,10,601000,68
1783,p1402,20131025,6010,6010,6044,6044,5948,6000,5994,-10,-16,54,3237800,68
1784,p1402,20131028,6000,5994,5988,5988,5920,5956,5944,-38,-50,120,7132840,28
1785,p1402,20131029,5956,5944,5926,5976,5922,5976,5944,32,0,14,832320,22
1786,p1402,20131030,5976,5944,6056,6180,6056,6136,6110,192,166,18,1099840,14
1787,p1402,20131031,6136,6110,6134,6134,6134,6134,6134,24,24,2,122680,12
1788,p1402,20131101,6134,6134,0,0,0,6180,6180,46,46,0,0,12
1789,p1402,20131104,6180,6180,0,0,0,6180,6180,0,0,0,0,12
1790,p1402,20131105,6180,6180,6074,6158,6072,6120,6122,-60,-58,44,2693760,12
1791,p1402,20131106,6120,6122,6172,6172,6086,6086,6128,-36,6,4,245160,12
1792,p1402,20131107,6086,6128,6124,6124,6114,6114,6122,-14,-6,12,734680,4
1793,p1402,20131108,6114,6122,6080,6120,6080,6118,6106,-4,-16,20,1221400,10
1794,p1402,20131111,6118,6106,6088,6122,6052,6052,6086,-54,-20,6,365240,8
1795,p1402,20131112,6052,6086,0,0,0,6086,6086,0,0,0,0,8
1796,p1402,20131113,6086,6086,6132,6182,6132,6182,6154,96,68,12,738600,4
1797,p1402,20131114,6182,6154,0,0,0,6154,6154,0,0,0,0,4
1798,p1402,20131115,6154,6154,6178,6178,6126,6126,6152,-28,-2,4,246080,4
1799,p1402,20131118,6126,6152,6146,6160,6080,6160,6124,8,-28,10,612520,4
1800,p1402,20131119,6160,6124,0,0,0,6096,6096,-28,-28,0,0,4
1801,p1402,20131120,6096,6096,6168,6168,6080,6080,6124,-16,28,4,244960,4
1802,p1402,20131121,6080,6124,6254,6254,6172,6200,6192,76,68,76,4707320,4
1803,p1402,20131122,6200,6192,0,0,0,6192,6192,0,0,0,0,4
1804,p1402,20131125,6192,6192,6272,6328,6254,6328,6284,136,92,6,377080,2
1805,p1402,20131126,6328,6284,0,0,0,6194,6194,-90,-90,0,0,2
1806,p1402,20131127,6194,6194,0,0,0,6194,6194,0,0,0,0,2
1807,p1402,20131128,6194,6194,0,0,0,6222,6222,28,28,0,0,2
1808,p1402,20131129,6222,6222,0,0,0,6224,6224,2,2,0,0,2
1809,p1402,20131202,6224,6224,0,0,0,6206,6206,-18,-18,0,0,2
1810,p1402,20131203,6206,6206,0,0,0,6206,6206,0,0,0,0,2
1811,p1402,20131204,6206,6206,0,0,0,6178,6178,-28,-28,0,0,2
1812,p1402,20131205,6178,6178,6214,6214,6088,6088,6146,-90,-32,48,2950920,8
1813,p1402,20131206,6088,6146,6150,6150,6054,6054,6102,-92,-44,8,488160,8
1814,p1402,20131209,6054,6102,0,0,0,6102,6102,0,0,0,0,8
1815,p1402,20131210,6102,6102,0,0,0,6102,6102,0,0,0,0,8
1816,p1402,20131211,6102,6102,0,0,0,6102,6102,0,0,0,0,8
1817,p1402,20131212,6102,6102,0,0,0,6102,6102,0,0,0,0,8
1818,p1402,20131213,6102,6102,0,0,0,6000,6000,-102,-102,0,0,8
1819,p1402,20131216,6000,6000,0,0,0,6000,6000,0,0,0,0,8
1820,p1402,20131217,6000,6000,0,0,0,6000,6000,0,0,0,0,8
1821,p1402,20131218,6000,6000,0,0,0,6000,6000,0,0,0,0,8
1822,p1402,20131219,6000,6000,0,0,0,6000,6000,0,0,0,0,8
1823,p1402,20131220,6000,6000,0,0,0,6000,6000,0,0,0,0,8
1824,p1402,20131223,6000,6000,0,0,0,6000,6000,0,0,0,0,8
1825,p1402,20131224,6000,6000,0,0,0,5998,5998,-2,-2,0,0,8
1826,p1402,20131225,5998,5998,5870,5942,5870,5942,5906,-56,-92,4,236240,10
1827,p1402,20131226,5942,5906,0,0,0,5900,5900,-6,-6,0,0,10
1828,p1402,20131227,5900,5900,0,0,0,5930,5930,30,30,0,0,10
1829,p1402,20131230,5930,5930,0,0,0,5960,5960,30,30,0,0,10
1830,p1402,20131231,5960,5960,0,0,0,5960,5960,0,0,0,0,10
1831,p1403,20130318,6468,6468,6440,6440,6440,6440,6440,-28,-28,2,128800,2
1832,p1403,20130319,6440,6440,0,0,0,6440,6440,0,0,0,0,2
1833,p1403,20130320,6440,6440,0,0,0,6440,6440,0,0,0,0,2
1834,p1403,20130321,6440,6440,0,0,0,6440,6440,0,0,0,0,2
1835,p1403,20130322,6440,6440,0,0,0,6440,6440,0,0,0,0,2
1836,p1403,20130325,6440,6440,0,0,0,6440,6440,0,0,0,0,2
1837,p1403,20130326,6440,6440,0,0,0,6440,6440,0,0,0,0,2
1838,p1403,20130327,6440,6440,0,0,0,6440,6440,0,0,0,0,2
1839,p1403,20130328,6440,6440,0,0,0,6440,6440,0,0,0,0,2
1840,p1403,20130329,6440,6440,0,0,0,6440,6440,0,0,0,0,2
1841,p1403,20130401,6440,6440,6428,6428,6428,6428,6428,-12,-12,2,128560,2
1842,p1403,20130402,6428,6428,0,0,0,6428,6428,0,0,0,0,2
1843,p1403,20130403,6428,6428,0,0,0,6428,6428,0,0,0,0,2
1844,p1403,20130408,6428,6428,0,0,0,6428,6428,0,0,0,0,2
1845,p1403,20130409,6428,6428,0,0,0,6428,6428,0,0,0,0,2
1846,p1403,20130410,6428,6428,0,0,0,6428,6428,0,0,0,0,2
1847,p1403,20130411,6428,6428,0,0,0,6428,6428,0,0,0,0,2
1848,p1403,20130412,6428,6428,0,0,0,6428,6428,0,0,0,0,2
1849,p1403,20130415,6428,6428,0,0,0,6428,6428,0,0,0,0,2
1850,p1403,20130416,6428,6428,0,0,0,6428,6428,0,0,0,0,2
1851,p1403,20130417,6428,6428,0,0,0,6414,6414,-14,-14,0,0,2
1852,p1403,20130418,6414,6414,0,0,0,6404,6404,-10,-10,0,0,2
1853,p1403,20130419,6404,6404,0,0,0,6404,6404,0,0,0,0,2
1854,p1403,20130422,6404,6404,0,0,0,6286,6286,-118,-118,0,0,2
1855,p1403,20130423,6286,6286,0,0,0,6286,6286,0,0,0,0,2
1856,p1403,20130424,6286,6286,0,0,0,6276,6276,-10,-10,0,0,2
1857,p1403,20130425,6276,6276,0,0,0,6274,6274,-2,-2,0,0,2
1858,p1403,20130426,6274,6274,0,0,0,6274,6274,0,0,0,0,2
1859,p1403,20130502,6274,6274,0,0,0,6146,6146,-128,-128,0,0,2
1860,p1403,20130503,6146,6146,0,0,0,6130,6130,-16,-16,0,0,2
1861,p1403,20130506,6130,6130,0,0,0,6130,6130,0,0,0,0,2
1862,p1403,20130507,6130,6130,0,0,0,6130,6130,0,0,0,0,2
1863,p1403,20130508,6130,6130,0,0,0,6130,6130,0,0,0,0,2
1864,p1403,20130509,6130,6130,0,0,0,6130,6130,0,0,0,0,2
1865,p1403,20130510,6130,6130,0,0,0,6130,6130,0,0,0,0,2
1866,p1403,20130513,6130,6130,0,0,0,6260,6260,130,130,0,0,2
1867,p1403,20130514,6260,6260,0,0,0,6262,6262,2,2,0,0,2
1868,p1403,20130515,6262,6262,0,0,0,6238,6238,-24,-24,0,0,2
1869,p1403,20130516,6238,6238,0,0,0,6238,6238,0,0,0,0,2
1870,p1403,20130517,6238,6238,6360,6360,6252,6290,6300,52,62,6,378040,2
1871,p1403,20130520,6290,6300,0,0,0,6300,6300,0,0,0,0,2
1872,p1403,20130521,6300,6300,0,0,0,6300,6300,0,0,0,0,2
1873,p1403,20130522,6300,6300,0,0,0,6300,6300,0,0,0,0,2
1874,p1403,20130523,6300,6300,0,0,0,6300,6300,0,0,0,0,2
1875,p1403,20130524,6300,6300,6418,6418,6418,6418,6418,118,118,2,128360,4
1876,p1403,20130527,6418,6418,6354,6354,6232,6232,6292,-186,-126,20,1258600,4
1877,p1403,20130528,6232,6292,0,0,0,6292,6292,0,0,0,0,4
1878,p1403,20130529,6292,6292,0,0,0,6304,6304,12,12,0,0,4
1879,p1403,20130530,6304,6304,0,0,0,6304,6304,0,0,0,0,4
1880,p1403,20130531,6304,6304,0,0,0,6304,6304,0,0,0,0,4
1881,p1403,20130603,6304,6304,6400,6400,6400,6400,6400,96,96,2,128000,6
1882,p1403,20130604,6400,6400,6300,6306,6248,6306,6278,-94,-122,126,7910640,8
1883,p1403,20130605,6306,6278,0,0,0,6218,6218,-60,-60,0,0,8
1884,p1403,20130606,6218,6218,6222,6222,6222,6222,6222,4,4,2,124440,10
1885,p1403,20130607,6222,6222,6202,6370,6202,6370,6308,148,86,6,378560,8
1886,p1403,20130613,6370,6308,0,0,0,6308,6308,0,0,0,0,8
1887,p1403,20130614,6308,6308,0,0,0,6308,6308,0,0,0,0,8
1888,p1403,20130617,6308,6308,0,0,0,6308,6308,0,0,0,0,8
1889,p1403,20130618,6308,6308,0,0,0,6308,6308,0,0,0,0,8
1890,p1403,20130619,6308,6308,0,0,0,6308,6308,0,0,0,0,8
1891,p1403,20130620,6308,6308,0,0,0,6302,6302,-6,-6,0,0,8
1892,p1403,20130621,6302,6302,6124,6126,6108,6108,6120,-194,-182,8,489680,4
1893,p1403,20130624,6108,6120,0,0,0,6120,6120,0,0,0,0,4
1894,p1403,20130625,6120,6120,0,0,0,6120,6120,0,0,0,0,4
1895,p1403,20130626,6120,6120,0,0,0,6120,6120,0,0,0,0,4
1896,p1403,20130627,6120,6120,0,0,0,6120,6120,0,0,0,0,4
1897,p1403,20130628,6120,6120,0,0,0,6072,6072,-48,-48,0,0,4
1898,p1403,20130701,6072,6072,0,0,0,6072,6072,0,0,0,0,4
1899,p1403,20130702,6072,6072,5990,5990,5918,5988,5964,-84,-108,20,1193160,14
1900,p1403,20130703,5988,5964,0,0,0,5964,5964,0,0,0,0,14
1901,p1403,20130704,5964,5964,0,0,0,5986,5986,22,22,0,0,14
1902,p1403,20130705,5986,5986,0,0,0,5986,5986,0,0,0,0,14
1903,p1403,20130708,5986,5986,0,0,0,5986,5986,0,0,0,0,14
1904,p1403,20130709,5986,5986,0,0,0,5970,5970,-16,-16,0,0,14
1905,p1403,20130710,5970,5970,5962,5962,5950,5950,5956,-20,-14,22,1310440,4
1906,p1403,20130711,5950,5956,0,0,0,5956,5956,0,0,0,0,4
1907,p1403,20130712,5956,5956,0,0,0,5868,5868,-88,-88,0,0,4
1908,p1403,20130715,5868,5868,5854,5854,5752,5752,5802,-116,-66,4,232120,4
1909,p1403,20130716,5752,5802,0,0,0,5758,5758,-44,-44,0,0,4
1910,p1403,20130717,5758,5758,0,0,0,5758,5758,0,0,0,0,4
1911,p1403,20130718,5758,5758,0,0,0,5758,5758,0,0,0,0,4
1912,p1403,20130719,5758,5758,0,0,0,5766,5766,8,8,0,0,4
1913,p1403,20130722,5766,5766,0,0,0,5746,5746,-20,-20,0,0,4
1914,p1403,20130723,5746,5746,0,0,0,5756,5756,10,10,0,0,4
1915,p1403,20130724,5756,5756,0,0,0,5602,5602,-154,-154,0,0,4
1916,p1403,20130725,5602,5602,0,0,0,5548,5548,-54,-54,0,0,4
1917,p1403,20130726,5548,5548,0,0,0,5692,5692,144,144,0,0,4
1918,p1403,20130729,5692,5692,5520,5526,5520,5526,5520,-166,-172,10,552120,12
1919,p1403,20130730,5526,5520,0,0,0,5520,5520,0,0,0,0,12
1920,p1403,20130731,5520,5520,5550,5560,5550,5560,5554,40,34,8,444400,8
1921,p1403,20130801,5560,5554,0,0,0,5554,5554,0,0,0,0,8
1922,p1403,20130802,5554,5554,0,0,0,5560,5560,6,6,0,0,8
1923,p1403,20130805,5560,5560,0,0,0,5574,5574,14,14,0,0,8
1924,p1403,20130806,5574,5574,5624,5624,5574,5592,5596,18,22,6,335800,8
1925,p1403,20130807,5592,5596,0,0,0,5476,5476,-120,-120,0,0,8
1926,p1403,20130808,5476,5476,5516,5516,5506,5506,5512,30,36,8,441080,14
1927,p1403,20130809,5506,5512,5530,5560,5530,5536,5542,24,30,22,1219600,12
1928,p1403,20130812,5536,5542,0,0,0,5550,5550,8,8,0,0,12
1929,p1403,20130813,5550,5550,5742,5742,5730,5730,5736,180,186,4,229440,16
1930,p1403,20130814,5730,5736,5690,5690,5690,5690,5690,-46,-46,2,113800,18
1931,p1403,20130815,5690,5690,5714,5714,5708,5708,5710,18,20,4,228440,20
1932,p1403,20130816,5708,5710,0,0,0,5710,5710,0,0,0,0,20
1933,p1403,20130819,5710,5710,5814,5814,5814,5814,5814,104,104,2,116280,18
1934,p1403,20130820,5814,5814,0,0,0,5814,5814,0,0,0,0,18
1935,p1403,20130821,5814,5814,0,0,0,5736,5736,-78,-78,0,0,18
1936,p1403,20130822,5736,5736,0,0,0,5722,5722,-14,-14,0,0,18
1937,p1403,20130823,5722,5722,0,0,0,5722,5722,0,0,0,0,18
1938,p1403,20130826,5722,5722,5734,5900,5734,5900,5816,178,94,4,232680,18
1939,p1403,20130827,5900,5816,5994,6000,5994,6000,5996,184,180,6,359760,16
1940,p1403,20130828,6000,5996,5990,5990,5950,5950,5970,-46,-26,4,238800,16
1941,p1403,20130829,5950,5970,0,0,0,5826,5826,-144,-144,0,0,16
1942,p1403,20130830,5826,5826,5748,5748,5748,5748,5748,-78,-78,2,114960,16
1943,p1403,20130902,5748,5748,0,0,0,5748,5748,0,0,0,0,16
1944,p1403,20130903,5748,5748,5808,5858,5808,5858,5826,110,78,6,349640,16
1945,p1403,20130904,5858,5826,0,0,0,5800,5800,-26,-26,0,0,16
1946,p1403,20130905,5800,5800,0,0,0,5782,5782,-18,-18,0,0,16
1947,p1403,20130906,5782,5782,0,0,0,5782,5782,0,0,0,0,16
1948,p1403,20130909,5782,5782,0,0,0,5810,5810,28,28,0,0,16
1949,p1403,20130910,5810,5810,5728,5728,5728,5728,5728,-82,-82,2,114560,18
1950,p1403,20130911,5728,5728,5650,5724,5650,5716,5696,-12,-32,6,341800,20
1951,p1403,20130912,5716,5696,5670,5670,5670,5670,5670,-26,-26,8,453600,20
1952,p1403,20130913,5670,5670,5676,5700,5676,5700,5684,30,14,6,341040,18
1953,p1403,20130916,5700,5684,5642,5642,5630,5630,5636,-54,-48,4,225440,18
1954,p1403,20130917,5630,5636,5574,5574,5574,5574,5574,-62,-62,4,222960,14
1955,p1403,20130918,5574,5574,0,0,0,5574,5574,0,0,0,0,14
1956,p1403,20130923,5574,5574,0,0,0,5574,5574,0,0,0,0,14
1957,p1403,20130924,5574,5574,0,0,0,5574,5574,0,0,0,0,14
1958,p1403,20130925,5574,5574,0,0,0,5574,5574,0,0,0,0,14
1959,p1403,20130926,5574,5574,0,0,0,5574,5574,0,0,0,0,14
1960,p1403,20130927,5574,5574,0,0,0,5574,5574,0,0,0,0,14
1961,p1403,20130930,5574,5574,0,0,0,5574,5574,0,0,0,0,14
1962,p1403,20131008,5574,5574,5608,5658,5608,5658,5636,84,62,6,338160,10
1963,p1403,20131009,5658,5636,0,0,0,5636,5636,0,0,0,0,10
1964,p1403,20131010,5636,5636,0,0,0,5636,5636,0,0,0,0,10
1965,p1403,20131011,5636,5636,5860,5860,5796,5796,5828,160,192,4,233120,10
1966,p1403,20131014,5796,5828,0,0,0,5828,5828,0,0,0,0,10
1967,p1403,20131015,5828,5828,0,0,0,5828,5828,0,0,0,0,10
1968,p1403,20131016,5828,5828,0,0,0,5828,5828,0,0,0,0,10
1969,p1403,20131017,5828,5828,0,0,0,5900,5900,72,72,0,0,10
1970,p1403,20131018,5900,5900,5966,5966,5902,5902,5938,2,38,16,950080,14
1971,p1403,20131021,5902,5938,6162,6162,6094,6094,6128,156,190,4,245120,14
1972,p1403,20131022,6094,6128,0,0,0,6100,6100,-28,-28,0,0,14
1973,p1403,20131023,6100,6100,0,0,0,6286,6286,186,186,0,0,14
1974,p1403,20131024,6286,6286,0,0,0,6286,6286,0,0,0,0,14
1975,p1403,20131025,6286,6286,0,0,0,6270,6270,-16,-16,0,0,14
1976,p1403,20131028,6270,6270,0,0,0,6218,6218,-52,-52,0,0,14
1977,p1403,20131029,6218,6218,0,0,0,6088,6088,-130,-130,0,0,14
1978,p1403,20131030,6088,6088,0,0,0,6224,6224,136,136,0,0,14
1979,p1403,20131031,6224,6224,6298,6298,6246,6246,6272,22,48,4,250880,14
1980,p1403,20131101,6246,6272,6300,6300,6300,6300,6300,28,28,2,126000,12
1981,p1403,20131104,6300,6300,0,0,0,6300,6300,0,0,0,0,12
1982,p1403,20131105,6300,6300,0,0,0,6300,6300,0,0,0,0,12
1983,p1403,20131106,6300,6300,0,0,0,6274,6274,-26,-26,0,0,12
1984,p1403,20131107,6274,6274,0,0,0,6272,6272,-2,-2,0,0,12
1985,p1403,20131108,6272,6272,0,0,0,6220,6220,-52,-52,0,0,12
1986,p1403,20131111,6220,6220,0,0,0,6220,6220,0,0,0,0,12
1987,p1403,20131112,6220,6220,0,0,0,6200,6200,-20,-20,0,0,12
1988,p1403,20131113,6200,6200,0,0,0,6200,6200,0,0,0,0,12
1989,p1403,20131114,6200,6200,6304,6304,6246,6246,6274,46,74,4,251000,12
1990,p1403,20131115,6246,6274,0,0,0,6274,6274,0,0,0,0,12
1991,p1403,20131118,6274,6274,6268,6268,6198,6220,6222,-54,-52,10,622200,6
1992,p1403,20131119,6220,6222,0,0,0,6222,6222,0,0,0,0,6
1993,p1403,20131120,6222,6222,0,0,0,6212,6212,-10,-10,0,0,6
1994,p1403,20131121,6212,6212,0,0,0,6226,6226,14,14,0,0,6
1995,p1403,20131122,6226,6226,6410,6422,6346,6370,6386,144,160,8,510960,6
1996,p1403,20131125,6370,6386,0,0,0,6480,6480,94,94,0,0,6
1997,p1403,20131126,6480,6480,0,0,0,6388,6388,-92,-92,0,0,6
1998,p1403,20131127,6388,6388,0,0,0,6330,6330,-58,-58,0,0,6
1999,p1403,20131128,6330,6330,6304,6308,6304,6308,6304,-22,-26,24,1513040,24
2000,p1403,20131129,6308,6304,6310,6310,6304,6306,6308,2,4,20,1261800,8
2001,p1403,20131202,6306,6308,0,0,0,6308,6308,0,0,0,0,8
2002,p1403,20131203,6308,6308,0,0,0,6308,6308,0,0,0,0,8
2003,p1403,20131204,6308,6308,0,0,0,6268,6268,-40,-40,0,0,8
2004,p1403,20131205,6268,6268,0,0,0,6236,6236,-32,-32,0,0,8
2005,p1403,20131206,6236,6236,0,0,0,6236,6236,0,0,0,0,8
2006,p1403,20131209,6236,6236,0,0,0,6236,6236,0,0,0,0,8
2007,p1403,20131210,6236,6236,0,0,0,6226,6226,-10,-10,0,0,8
2008,p1403,20131211,6226,6226,0,0,0,6226,6226,0,0,0,0,8
2009,p1403,20131212,6226,6226,6170,6170,6170,6170,6170,-56,-56,2,123400,8
2010,p1403,20131213,6170,6170,5992,6008,5992,6008,5996,-162,-174,6,359840,8
2011,p1403,20131216,6008,5996,0,0,0,5962,5962,-34,-34,0,0,8
2012,p1403,20131217,5962,5962,0,0,0,5974,5974,12,12,0,0,8
2013,p1403,20131218,5974,5974,0,0,0,5898,5898,-76,-76,0,0,8
2014,p1403,20131219,5898,5898,0,0,0,5924,5924,26,26,0,0,8
2015,p1403,20131220,5924,5924,0,0,0,5934,5934,10,10,0,0,8
2016,p1403,20131223,5934,5934,0,0,0,5906,5906,-28,-28,0,0,8
2017,p1403,20131224,5906,5906,6010,6010,5982,5982,5996,76,90,4,239840,8
2018,p1403,20131225,5982,5996,0,0,0,5936,5936,-60,-60,0,0,8
2019,p1403,20131226,5936,5936,0,0,0,5936,5936,0,0,0,0,8
2020,p1403,20131227,5936,5936,0,0,0,5936,5936,0,0,0,0,8
2021,p1403,20131230,5936,5936,0,0,0,6004,6004,68,68,0,0,8
2022,p1403,20131231,6004,6004,0,0,0,6004,6004,0,0,0,0,8
2023,p1404,20130418,6324,6324,0,0,0,6324,6324,0,0,0,0,0
2024,p1404,20130419,6324,6324,0,0,0,6324,6324,0,0,0,0,0
2025,p1404,20130422,6324,6324,6156,6340,6156,6200,6232,-124,-92,6,373920,0
2026,p1404,20130423,6200,6232,0,0,0,6232,6232,0,0,0,0,0
2027,p1404,20130424,6232,6232,6176,6176,6168,6168,6172,-64,-60,18,1111040,2
2028,p1404,20130425,6168,6172,6336,6346,6232,6240,6270,68,98,12,752400,2
2029,p1404,20130426,6240,6270,0,0,0,6252,6252,-18,-18,0,0,2
2030,p1404,20130502,6252,6252,0,0,0,6212,6212,-40,-40,0,0,2
2031,p1404,20130503,6212,6212,0,0,0,6178,6178,-34,-34,0,0,2
2032,p1404,20130506,6178,6178,0,0,0,6178,6178,0,0,0,0,2
2033,p1404,20130507,6178,6178,0,0,0,6178,6178,0,0,0,0,2
2034,p1404,20130508,6178,6178,0,0,0,6178,6178,0,0,0,0,2
2035,p1404,20130509,6178,6178,0,0,0,6178,6178,0,0,0,0,2
2036,p1404,20130510,6178,6178,6424,6424,6424,6424,6424,246,246,2,128480,4
2037,p1404,20130513,6424,6424,6332,6332,6332,6332,6332,-92,-92,2,126640,4
2038,p1404,20130514,6332,6332,6368,6368,6368,6368,6368,36,36,2,127360,4
2039,p1404,20130515,6368,6368,0,0,0,6250,6250,-118,-118,0,0,4
2040,p1404,20130516,6250,6250,0,0,0,6250,6250,0,0,0,0,4
2041,p1404,20130517,6250,6250,0,0,0,6250,6250,0,0,0,0,4
2042,p1404,20130520,6250,6250,0,0,0,6250,6250,0,0,0,0,4
2043,p1404,20130521,6250,6250,0,0,0,6250,6250,0,0,0,0,4
2044,p1404,20130522,6250,6250,0,0,0,6250,6250,0,0,0,0,4
2045,p1404,20130523,6250,6250,0,0,0,6250,6250,0,0,0,0,4
2046,p1404,20130524,6250,6250,0,0,0,6276,6276,26,26,0,0,4
2047,p1404,20130527,6276,6276,0,0,0,6276,6276,0,0,0,0,4
2048,p1404,20130528,6276,6276,0,0,0,6276,6276,0,0,0,0,4
2049,p1404,20130529,6276,6276,0,0,0,6276,6276,0,0,0,0,4
2050,p1404,20130530,6276,6276,0,0,0,6276,6276,0,0,0,0,4
2051,p1404,20130531,6276,6276,0,0,0,6276,6276,0,0,0,0,4
2052,p1404,20130603,6276,6276,6426,6470,6210,6370,6390,94,114,190,12144560,4
2053,p1404,20130604,6370,6390,6374,6374,6316,6316,6350,-74,-40,10,635080,6
2054,p1404,20130605,6316,6350,6190,6196,6116,6196,6142,-154,-208,44,2702720,30
2055,p1404,20130606,6196,6142,6200,6220,6200,6220,6206,78,64,10,620600,28
2056,p1404,20130607,6220,6206,6272,6340,6272,6340,6310,134,104,20,1262360,28
2057,p1404,20130613,6340,6310,6390,6390,6326,6350,6362,40,52,48,3054080,36
2058,p1404,20130614,6350,6362,6272,6272,6272,6272,6272,-90,-90,6,376320,30
2059,p1404,20130617,6272,6272,0,0,0,6272,6272,0,0,0,0,30
2060,p1404,20130618,6272,6272,0,0,0,6306,6306,34,34,0,0,30
2061,p1404,20130619,6306,6306,0,0,0,6306,6306,0,0,0,0,30
2062,p1404,20130620,6306,6306,6462,6462,6272,6334,6408,28,102,260,16662320,34
2063,p1404,20130621,6334,6408,6154,6188,6154,6188,6180,-220,-228,22,1359680,30
2064,p1404,20130624,6188,6180,0,0,0,6180,6180,0,0,0,0,30
2065,p1404,20130625,6180,6180,0,0,0,6134,6134,-46,-46,0,0,30
2066,p1404,20130626,6134,6134,5960,5960,5960,5960,5960,-174,-174,2,119200,30
2067,p1404,20130627,5960,5960,5952,6006,5952,6006,5978,46,18,4,239160,30
2068,p1404,20130628,6006,5978,0,0,0,5978,5978,0,0,0,0,30
2069,p1404,20130701,5978,5978,0,0,0,5978,5978,0,0,0,0,30
2070,p1404,20130702,5978,5978,6100,6100,6034,6034,6066,56,88,4,242680,30
2071,p1404,20130703,6034,6066,0,0,0,6066,6066,0,0,0,0,30
2072,p1404,20130704,6066,6066,6062,6116,6062,6116,6088,50,22,4,243560,30
2073,p1404,20130705,6116,6088,0,0,0,6088,6088,0,0,0,0,30
2074,p1404,20130708,6088,6088,0,0,0,6168,6168,80,80,0,0,30
2075,p1404,20130709,6168,6168,0,0,0,6168,6168,0,0,0,0,30
2076,p1404,20130710,6168,6168,0,0,0,6168,6168,0,0,0,0,30
2077,p1404,20130711,6168,6168,5930,6106,5930,6106,6066,-62,-102,12,727960,32
2078,p1404,20130712,6106,6066,0,0,0,6062,6062,-4,-4,0,0,32
2079,p1404,20130715,6062,6062,5880,5880,5880,5880,5880,-182,-182,2,117600,34
2080,p1404,20130716,5880,5880,0,0,0,5880,5880,0,0,0,0,34
2081,p1404,20130717,5880,5880,0,0,0,5814,5814,-66,-66,0,0,34
2082,p1404,20130718,5814,5814,5858,5858,5780,5780,5820,-34,6,26,1513400,34
2083,p1404,20130719,5780,5820,0,0,0,5810,5810,-10,-10,0,0,34
2084,p1404,20130722,5810,5810,5762,5762,5762,5762,5762,-48,-48,6,345720,34
2085,p1404,20130723,5762,5762,0,0,0,5764,5764,2,2,0,0,34
2086,p1404,20130724,5764,5764,0,0,0,5764,5764,0,0,0,0,34
2087,p1404,20130725,5764,5764,5664,5664,5664,5664,5664,-100,-100,2,113280,32
2088,p1404,20130726,5664,5664,0,0,0,5582,5582,-82,-82,0,0,32
2089,p1404,20130729,5582,5582,0,0,0,5582,5582,0,0,0,0,32
2090,p1404,20130730,5582,5582,5516,5516,5516,5516,5516,-66,-66,6,330960,32
2091,p1404,20130731,5516,5516,5582,5726,5524,5598,5570,82,54,372,20726080,38
2092,p1404,20130801,5598,5570,0,0,0,5570,5570,0,0,0,0,38
2093,p1404,20130802,5570,5570,5604,5604,5604,5604,5604,34,34,2,112080,36
2094,p1404,20130805,5604,5604,0,0,0,5604,5604,0,0,0,0,36
2095,p1404,20130806,5604,5604,0,0,0,5604,5604,0,0,0,0,36
2096,p1404,20130807,5604,5604,5490,5490,5490,5490,5490,-114,-114,2,109800,36
2097,p1404,20130808,5490,5490,5476,5476,5476,5476,5476,-14,-14,2,109520,36
2098,p1404,20130809,5476,5476,5550,5550,5550,5550,5550,74,74,2,111000,38
2099,p1404,20130812,5550,5550,5566,5566,5566,5566,5566,16,16,2,111320,38
2100,p1404,20130813,5566,5566,0,0,0,5566,5566,0,0,0,0,38
2101,p1404,20130814,5566,5566,5750,5768,5720,5720,5746,154,180,8,459760,34
2102,p1404,20130815,5720,5746,0,0,0,5742,5742,-4,-4,0,0,34
2103,p1404,20130816,5742,5742,0,0,0,5742,5742,0,0,0,0,34
2104,p1404,20130819,5742,5742,0,0,0,5760,5760,18,18,0,0,34
2105,p1404,20130820,5760,5760,5760,5760,5728,5728,5742,-32,-18,6,344600,36
2106,p1404,20130821,5728,5742,0,0,0,5742,5742,0,0,0,0,36
2107,p1404,20130822,5742,5742,5760,5760,5760,5760,5760,18,18,2,115200,34
2108,p1404,20130823,5760,5760,0,0,0,5760,5760,0,0,0,0,34
2109,p1404,20130826,5760,5760,0,0,0,5854,5854,94,94,0,0,34
2110,p1404,20130827,5854,5854,6008,6008,5946,6000,5984,146,130,12,718080,34
2111,p1404,20130828,6000,5984,6030,6030,6000,6000,6024,16,40,12,722880,38
2112,p1404,20130829,6000,6024,5784,5856,5784,5856,5800,-168,-224,10,580000,36
2113,p1404,20130830,5856,5800,5786,5786,5702,5720,5752,-80,-48,16,920360,44
2114,p1404,20130902,5720,5752,5828,5830,5770,5770,5812,18,60,22,1278640,42
2115,p1404,20130903,5770,5812,5802,5802,5756,5772,5776,-40,-36,6,346600,40
2116,p1404,20130904,5772,5776,0,0,0,5776,5776,0,0,0,0,40
2117,p1404,20130905,5776,5776,0,0,0,5776,5776,0,0,0,0,40
2118,p1404,20130906,5776,5776,0,0,0,5782,5782,6,6,0,0,40
2119,p1404,20130909,5782,5782,5886,5888,5792,5792,5862,10,80,12,703440,46
2120,p1404,20130910,5792,5862,5770,5780,5718,5732,5768,-130,-94,238,13728440,242
2121,p1404,20130911,5732,5768,5730,5772,5704,5772,5740,4,-28,8,459240,242
2122,p1404,20130912,5772,5740,5720,5742,5720,5742,5730,2,-10,4,229240,240
2123,p1404,20130913,5742,5730,5674,5674,5674,5674,5674,-56,-56,2,113480,238
2124,p1404,20130916,5674,5674,0,0,0,5674,5674,0,0,0,0,238
2125,p1404,20130917,5674,5674,5600,5600,5600,5600,5600,-74,-74,8,448000,238
2126,p1404,20130918,5600,5600,5654,5654,5592,5592,5622,-8,22,8,449840,238
2127,p1404,20130923,5592,5622,5550,5568,5542,5568,5552,-54,-70,12,666280,240
2128,p1404,20130924,5568,5552,5584,5584,5584,5584,5584,32,32,2,111680,240
2129,p1404,20130925,5584,5584,5592,5594,5592,5594,5592,10,8,6,335600,244
2130,p1404,20130926,5594,5592,5582,5582,5582,5582,5582,-10,-10,2,111640,244
2131,p1404,20130927,5582,5582,0,0,0,5582,5582,0,0,0,0,244
2132,p1404,20130930,5582,5582,0,0,0,5582,5582,0,0,0,0,244
2133,p1404,20131008,5582,5582,5638,5722,5638,5722,5680,140,98,4,227200,240
2134,p1404,20131009,5722,5680,5716,5716,5716,5716,5716,36,36,2,114320,240
2135,p1404,20131010,5716,5716,5750,5784,5750,5784,5766,68,50,4,230680,236
2136,p1404,20131011,5784,5766,5822,5828,5804,5828,5814,62,48,238,13838400,58
2137,p1404,20131014,5828,5814,5874,5878,5874,5878,5876,64,62,10,587720,48
2138,p1404,20131015,5878,5876,5842,5846,5822,5822,5838,-54,-38,20,1167800,34
2139,p1404,20131016,5822,5838,0,0,0,5838,5838,0,0,0,0,34
2140,p1404,20131017,5838,5838,5948,6006,5948,6006,5982,168,144,12,717920,34
2141,p1404,20131018,6006,5982,5970,5974,5970,5974,5972,-8,-10,80,4777600,34
2142,p1404,20131021,5974,5972,6132,6160,6132,6148,6144,176,172,94,5775720,32
2143,p1404,20131022,6148,6144,6078,6078,6078,6078,6078,-66,-66,2,121560,32
2144,p1404,20131023,6078,6078,6140,6140,6112,6134,6126,56,48,20,1225400,32
2145,p1404,20131024,6134,6126,6184,6184,6164,6164,6174,38,48,168,10375000,38
2146,p1404,20131025,6164,6174,6056,6070,6056,6070,6062,-104,-112,4,242520,36
2147,p1404,20131028,6070,6062,6102,6102,6072,6072,6082,10,20,18,1094800,36
2148,p1404,20131029,6072,6082,6092,6096,6080,6096,6084,14,2,218,13267080,32
2149,p1404,20131030,6096,6084,6254,6254,6254,6254,6254,170,170,2,125080,32
2150,p1404,20131031,6254,6254,6224,6224,6224,6224,6224,-30,-30,2,124480,30
2151,p1404,20131101,6224,6224,6314,6316,6294,6294,6310,70,86,8,504800,30
2152,p1404,20131104,6294,6310,6470,6470,6290,6336,6378,26,68,204,13014760,70
2153,p1404,20131105,6336,6378,6236,6236,6236,6236,6236,-142,-142,2,124720,68
2154,p1404,20131106,6236,6236,6292,6292,6292,6292,6292,56,56,24,1510080,70
2155,p1404,20131107,6292,6292,6262,6300,6262,6270,6276,-22,-16,14,878800,62
2156,p1404,20131108,6270,6276,6236,6236,6198,6198,6210,-78,-66,28,1739120,44
2157,p1404,20131111,6198,6210,0,0,0,6190,6190,-20,-20,0,0,44
2158,p1404,20131112,6190,6190,6198,6198,6166,6166,6182,-24,-8,4,247280,44
2159,p1404,20131113,6166,6182,0,0,0,6262,6262,80,80,0,0,44
2160,p1404,20131114,6262,6262,0,0,0,6280,6280,18,18,0,0,44
2161,p1404,20131115,6280,6280,6290,6290,6290,6290,6290,10,10,6,377400,44
2162,p1404,20131118,6290,6290,6254,6254,6254,6254,6254,-36,-36,6,375240,38
2163,p1404,20131119,6254,6254,6248,6248,6248,6248,6248,-6,-6,2,124960,38
2164,p1404,20131120,6248,6248,0,0,0,6240,6240,-8,-8,0,0,38
2165,p1404,20131121,6240,6240,6300,6394,6300,6318,6336,78,96,6,380240,38
2166,p1404,20131122,6318,6336,6472,6472,6400,6400,6434,64,98,26,1673120,26
2167,p1404,20131125,6400,6434,6476,6476,6430,6444,6452,10,18,120,7742680,22
2168,p1404,20131126,6444,6452,6378,6392,6298,6298,6334,-154,-118,50,3167120,30
2169,p1404,20131127,6298,6334,6280,6332,6280,6332,6298,-2,-36,8,503880,32
2170,p1404,20131128,6332,6298,6296,6336,6296,6324,6324,26,26,12,758920,30
2171,p1404,20131129,6324,6324,6314,6328,6314,6328,6318,4,-6,6,379120,24
2172,p1404,20131202,6328,6318,6308,6322,6308,6322,6318,4,0,16,1011160,22
2173,p1404,20131203,6322,6318,6280,6280,6254,6254,6264,-64,-54,6,375840,22
2174,p1404,20131204,6254,6264,6256,6256,6234,6256,6252,-8,-12,26,1625600,22
2175,p1404,20131205,6256,6252,6186,6324,6186,6236,6250,-16,-2,36,2250600,22
2176,p1404,20131206,6236,6250,0,0,0,6250,6250,0,0,0,0,22
2177,p1404,20131209,6250,6250,6228,6228,6228,6228,6228,-22,-22,10,622800,12
2178,p1404,20131210,6228,6228,6162,6228,6162,6228,6194,0,-34,8,495600,12
2179,p1404,20131211,6228,6194,0,0,0,6194,6194,0,0,0,0,12
2180,p1404,20131212,6194,6194,0,0,0,6194,6194,0,0,0,0,12
2181,p1404,20131213,6194,6194,6060,6152,6060,6152,6106,-42,-88,20,1221200,12
2182,p1404,20131216,6152,6106,0,0,0,6058,6058,-48,-48,0,0,12
2183,p1404,20131217,6058,6058,6042,6128,6042,6068,6086,10,28,12,730480,12
2184,p1404,20131218,6068,6086,6000,6040,5986,6040,6004,-46,-82,10,600440,12
2185,p1404,20131219,6040,6004,0,0,0,6004,6004,0,0,0,0,12
2186,p1404,20131220,6004,6004,0,0,0,6004,6004,0,0,0,0,12
2187,p1404,20131223,6004,6004,0,0,0,6004,6004,0,0,0,0,12
2188,p1404,20131224,6004,6004,0,0,0,6004,6004,0,0,0,0,12
2189,p1404,20131225,6004,6004,0,0,0,5960,5960,-44,-44,0,0,12
2190,p1404,20131226,5960,5960,0,0,0,5960,5960,0,0,0,0,12
2191,p1404,20131227,5960,5960,5874,6028,5874,6028,5990,68,30,10,599160,12
2192,p1404,20131230,6028,5990,6080,6118,6080,6118,6098,128,108,4,243960,12
2193,p1404,20131231,6118,6098,0,0,0,6082,6082,-16,-16,0,0,12
2194,p1405,20130517,6298,6274,6318,6370,6318,6364,6354,90,80,2124,134987280,5700
2195,p1405,20130520,6364,6354,6360,6390,6318,6352,6354,-2,0,1722,109432120,7020
2196,p1405,20130521,6352,6354,6350,6362,6302,6340,6340,-14,-14,686,43501040,7138
2197,p1405,20130522,6340,6340,6340,6422,6338,6396,6386,56,46,3188,203602040,9652
2198,p1405,20130523,6396,6386,6420,6420,6320,6328,6374,-58,-12,1412,90005560,10350
2199,p1405,20130524,6328,6374,6332,6450,6332,6388,6424,14,50,698,44844160,10382
2200,p1405,20130527,6388,6424,6424,6424,6330,6390,6376,-34,-48,380,24232760,10420
2201,p1405,20130528,6390,6376,6390,6432,6346,6376,6382,0,6,12012,766654720,17580
2202,p1405,20130529,6376,6382,6396,6460,6374,6436,6424,54,42,2796,179655280,18002
2203,p1405,20130530,6436,6424,6386,6408,6336,6362,6364,-62,-60,436,27751200,17914
2204,p1405,20130531,6362,6364,6346,6390,6318,6328,6346,-36,-18,272,17263760,17880
2205,p1405,20130603,6328,6346,6358,6422,6358,6410,6398,64,52,1122,71807840,18180
2206,p1405,20130604,6410,6398,6408,6408,6290,6298,6304,-100,-94,3310,208706080,20278
2207,p1405,20130605,6298,6304,6312,6320,6252,6258,6270,-46,-34,652,40892920,20306
2208,p1405,20130606,6258,6270,6270,6320,6238,6292,6284,22,14,3478,218598720,21788
2209,p1405,20130607,6292,6284,6312,6468,6266,6458,6396,174,112,4436,283768360,22406
2210,p1405,20130613,6458,6396,6418,6486,6390,6410,6432,14,36,6830,439439840,25168
2211,p1405,20130614,6410,6432,6384,6410,6360,6388,6380,-44,-52,7810,498361720,28488
2212,p1405,20130617,6388,6380,6390,6428,6374,6412,6406,32,26,16146,1034407800,40022
2213,p1405,20130618,6412,6406,6450,6482,6414,6418,6438,12,32,17124,1102776920,51162
2214,p1405,20130619,6418,6438,6406,6406,6362,6390,6382,-48,-56,2212,141173840,51656
2215,p1405,20130620,6390,6382,6400,6422,6350,6368,6384,-14,2,2800,178807920,51234
2216,p1405,20130621,6368,6384,6258,6266,6166,6196,6224,-188,-160,12038,749344120,47646
2217,p1405,20130624,6196,6224,6124,6220,6102,6126,6168,-98,-56,6572,405408800,49674
2218,p1405,20130625,6126,6168,6160,6170,6092,6126,6126,-42,-42,4982,305200080,49526
2219,p1405,20130626,6126,6126,6078,6146,6020,6068,6082,-58,-44,10518,639811520,52482
2220,p1405,20130627,6068,6082,6050,6056,6002,6022,6022,-60,-60,5476,329838640,52368
2221,p1405,20130628,6022,6022,6014,6074,5990,6048,6048,26,26,5754,348071320,53228
2222,p1405,20130701,6048,6048,6020,6122,6020,6108,6086,60,38,6058,368735800,53626
2223,p1405,20130702,6108,6086,6098,6128,6062,6088,6098,2,12,8250,503180720,58162
2224,p1405,20130703,6088,6098,6080,6118,6080,6104,6102,6,4,5502,335732440,60208
2225,p1405,20130704,6104,6102,6126,6168,6122,6146,6146,44,44,6774,416419720,61878
2226,p1405,20130705,6146,6146,6140,6140,6088,6106,6100,-40,-46,5594,341324360,62068
2227,p1405,20130708,6106,6100,6156,6166,6072,6084,6102,-16,2,7246,442197480,62790
2228,p1405,20130709,6084,6102,6080,6126,6078,6100,6096,-2,-6,5920,360977320,61584
2229,p1405,20130710,6100,6096,6124,6148,6064,6112,6094,16,-2,6488,395468560,61270
2230,p1405,20130711,6112,6094,6128,6190,6110,6148,6146,54,52,12134,745982400,62292
2231,p1405,20130712,6148,6146,6120,6130,6000,6036,6056,-110,-90,13522,819124880,63688
2232,p1405,20130715,6036,6056,5962,6000,5830,5830,5880,-226,-176,50968,2997729240,69444
2233,p1405,20130716,5830,5880,5854,5866,5796,5842,5830,-38,-50,46250,2696593800,71828
2234,p1405,20130717,5842,5830,5820,5874,5810,5832,5842,2,12,40578,2370578800,64254
2235,p1405,20130718,5832,5842,5800,5880,5648,5852,5840,10,-2,28984,1692970560,66480
2236,p1405,20130719,5852,5840,5860,5884,5804,5822,5854,-18,14,24984,1463033160,68262
2237,p1405,20130722,5822,5854,5820,5848,5780,5812,5808,-42,-46,44434,2580926360,78950
2238,p1405,20130723,5812,5808,5810,5844,5792,5834,5822,26,14,37202,2166104120,80526
2239,p1405,20130724,5834,5822,5750,5808,5736,5782,5788,-40,-34,39110,2263927920,74230
2240,p1405,20130725,5782,5788,5722,5752,5712,5724,5734,-64,-54,24618,1411649320,71248
2241,p1405,20130726,5724,5734,5682,5696,5562,5576,5618,-158,-116,53682,3016657760,80228
2242,p1405,20130729,5576,5618,5590,5604,5560,5568,5582,-50,-36,27440,1532033360,81592
2243,p1405,20130730,5568,5582,5520,5564,5518,5558,5542,-24,-40,39290,2177728920,82886
2244,p1405,20130731,5558,5542,5560,5662,5554,5618,5622,76,80,58414,3284811920,88794
2245,p1405,20130801,5618,5622,5602,5632,5582,5606,5608,-16,-14,29264,1641319840,86624
2246,p1405,20130802,5606,5608,5628,5686,5598,5680,5640,72,32,50086,2824852920,100774
2247,p1405,20130805,5680,5640,5662,5662,5604,5610,5626,-30,-14,34078,1917530120,106130
2248,p1405,20130806,5610,5626,5636,5636,5582,5586,5606,-40,-20,31224,1750438120,106342
2249,p1405,20130807,5586,5606,5562,5568,5490,5490,5516,-116,-90,53148,2932182720,116198
2250,p1405,20130808,5490,5516,5482,5538,5482,5504,5514,-12,-2,38972,2149429600,116576
2251,p1405,20130809,5504,5514,5518,5582,5512,5532,5548,18,34,47498,2635956720,115650
2252,p1405,20130812,5532,5548,5534,5598,5522,5590,5560,42,12,51802,2880478520,125576
2253,p1405,20130813,5590,5560,5660,5776,5644,5766,5726,206,166,119696,6855265360,106924
2254,p1405,20130814,5766,5726,5750,5818,5710,5712,5754,-14,28,92260,5309569960,110800
2255,p1405,20130815,5712,5754,5738,5784,5726,5752,5754,-2,0,71440,4111504800,113400
2256,p1405,20130816,5752,5754,5812,5880,5800,5836,5846,82,92,78346,4580675840,114086
2257,p1405,20130819,5836,5846,5862,5900,5838,5856,5864,10,18,68094,3993925200,114352
2258,p1405,20130820,5856,5864,5890,5902,5750,5770,5810,-94,-54,81204,4718380200,112016
2259,p1405,20130821,5770,5810,5770,5800,5744,5770,5772,-40,-38,44122,2547021440,111378
2260,p1405,20130822,5770,5772,5700,5788,5700,5758,5760,-14,-12,56312,3243665080,114156
2261,p1405,20130823,5758,5760,5758,5782,5740,5776,5766,16,6,61246,3531975280,115548
2262,p1405,20130826,5776,5766,5880,5996,5880,5996,5962,230,196,28026,1670977760,114066
2263,p1405,20130827,5996,5962,6040,6080,5992,6024,6026,62,64,93934,5661167520,120560
2264,p1405,20130828,6024,6026,6002,6048,5896,5924,5994,-102,-32,91436,5481422480,121920
2265,p1405,20130829,5924,5994,5942,5968,5756,5810,5880,-184,-114,130232,7658004280,123706
2266,p1405,20130830,5810,5880,5800,5810,5730,5750,5772,-130,-108,100614,5809003240,135152
2267,p1405,20130902,5750,5772,5780,5850,5776,5850,5824,78,52,102710,5983651200,141118
2268,p1405,20130903,5850,5824,5866,5900,5760,5818,5818,-6,-6,134266,7812348880,151358
2269,p1405,20130904,5818,5818,5770,5810,5750,5792,5786,-26,-32,93340,5402030040,160540
2270,p1405,20130905,5792,5786,5786,5842,5772,5790,5804,4,18,128696,7470242960,161384
2271,p1405,20130906,5790,5804,5812,5880,5782,5880,5830,76,26,135062,7874491200,159086
2272,p1405,20130909,5880,5830,5880,5908,5862,5888,5884,58,54,86822,5109145200,157556
2273,p1405,20130910,5888,5884,5800,5810,5692,5746,5762,-138,-122,169548,9771058080,146732
2274,p1405,20130911,5746,5762,5750,5788,5734,5784,5756,22,-6,107398,6183503680,150500
2275,p1405,20130912,5784,5756,5756,5780,5730,5732,5750,-24,-6,114054,6560032560,151360
2276,p1405,20130913,5732,5750,5796,5810,5698,5720,5744,-30,-6,148134,8510040480,146730
2277,p1405,20130916,5720,5744,5688,5694,5602,5608,5646,-136,-98,141116,7969606560,164442
2278,p1405,20130917,5608,5646,5620,5628,5568,5618,5600,-28,-46,167356,9372154200,177822
2279,p1405,20130918,5618,5600,5638,5660,5594,5606,5626,6,26,125840,7081804600,178922
2280,p1405,20130923,5606,5626,5558,5582,5534,5570,5558,-56,-68,83162,4623624960,181736
2281,p1405,20130924,5570,5558,5580,5638,5578,5612,5614,54,56,125180,7028463400,183936
2282,p1405,20130925,5612,5614,5600,5628,5576,5588,5596,-26,-18,135390,7578936480,186870
2283,p1405,20130926,5588,5596,5606,5618,5564,5590,5586,-6,-10,90222,5040836640,188036
2284,p1405,20130927,5590,5586,5586,5602,5550,5554,5570,-32,-16,100878,5620025000,178078
2285,p1405,20130930,5554,5570,5554,5586,5540,5566,5560,-4,-10,77374,4303301160,167276
2286,p1405,20131008,5566,5560,5550,5746,5550,5684,5682,124,122,167714,9530204360,187560
2287,p1405,20131009,5684,5682,5712,5738,5690,5708,5710,26,28,142952,8163124440,223332
2288,p1405,20131010,5708,5710,5720,5810,5708,5790,5750,80,40,210824,12125978520,241954
2289,p1405,20131011,5790,5750,5810,5858,5792,5816,5816,66,66,207968,12098495880,259044
2290,p1405,20131014,5816,5816,5810,5914,5804,5862,5866,46,50,232440,13636545400,256786
2291,p1405,20131015,5862,5866,5870,5908,5830,5888,5870,22,4,218882,12848662600,266792
2292,p1405,20131016,5888,5870,5888,5918,5860,5882,5888,12,18,300852,17719468360,289236
2293,p1405,20131017,5882,5888,5950,6038,5934,5974,5990,86,102,554138,33193540000,283018
2294,p1405,20131018,5974,5990,5954,6034,5940,6020,5984,30,-6,429630,25711751600,321910
2295,p1405,20131021,6020,5984,6080,6186,6058,6154,6140,170,156,652638,40073132640,327118
2296,p1405,20131022,6154,6140,6150,6164,6084,6106,6122,-34,-18,516742,31642531760,327706
2297,p1405,20131023,6106,6122,6156,6204,6110,6178,6158,56,36,973574,59969962800,391682
2298,p1405,20131024,6178,6158,6200,6218,6108,6124,6154,-34,-4,991834,61038595520,389428
2299,p1405,20131025,6124,6154,6100,6132,6060,6084,6098,-70,-56,940706,57371600000,422744
2300,p1405,20131028,6084,6098,6066,6122,6062,6084,6090,-14,-8,494162,30095281600,400742
2301,p1405,20131029,6084,6090,6082,6136,6042,6104,6090,14,0,812172,49477348200,411962
2302,p1405,20131030,6104,6090,6180,6332,6166,6332,6258,242,168,1057172,66169917640,491124
2303,p1405,20131031,6332,6258,6308,6332,6264,6292,6300,34,42,886694,55878365240,467104
2304,p1405,20131101,6292,6300,6310,6374,6284,6374,6320,74,20,864288,54635780440,466932
2305,p1405,20131104,6374,6320,6368,6372,6284,6318,6318,-2,-2,701628,44339472240,447544
2306,p1405,20131105,6318,6318,6284,6322,6232,6290,6278,-28,-40,754750,47385393320,452006
2307,p1405,20131106,6290,6278,6264,6300,6252,6270,6276,-8,-2,566750,35569436560,457938
2308,p1405,20131107,6270,6276,6252,6306,6234,6260,6270,-16,-6,753576,47261462880,463676
2309,p1405,20131108,6260,6270,6256,6274,6192,6228,6228,-42,-42,669258,41689543760,468992
2310,p1405,20131111,6228,6228,6228,6300,6174,6184,6218,-44,-10,775084,48203393520,434110
2311,p1405,20131112,6184,6218,6194,6228,6142,6226,6182,8,-36,767368,47450571600,433548
2312,p1405,20131113,6226,6182,6282,6326,6260,6314,6296,132,114,951168,59904446840,468000
2313,p1405,20131114,6314,6296,6310,6344,6282,6332,6304,36,8,624410,39369517280,476902
2314,p1405,20131115,6332,6304,6302,6342,6270,6280,6304,-24,0,839862,52953212440,474292
2315,p1405,20131118,6280,6304,6250,6282,6236,6242,6256,-62,-48,517320,32365034480,458850
2316,p1405,20131119,6242,6256,6230,6264,6206,6216,6234,-40,-22,744268,46400483720,454440
2317,p1405,20131120,6216,6234,6208,6270,6192,6268,6224,34,-10,605918,37714890400,488236
2318,p1405,20131121,6268,6224,6260,6406,6260,6370,6342,146,118,1278012,81061303720,558174
2319,p1405,20131122,6370,6342,6430,6488,6424,6440,6452,98,110,917988,59244786400,563754
2320,p1405,20131125,6440,6452,6430,6494,6400,6450,6450,-2,-2,832040,53673108200,585900
2321,p1405,20131126,6450,6450,6410,6436,6288,6294,6354,-156,-96,1184336,75271897400,501218
2322,p1405,20131127,6294,6354,6294,6330,6268,6314,6294,-40,-60,811020,51058413240,488528
2323,p1405,20131128,6314,6294,6288,6358,6284,6318,6326,24,32,787198,49800730280,495704
2324,p1405,20131129,6318,6326,6332,6370,6312,6366,6338,40,12,756338,47946051840,498186
2325,p1405,20131202,6366,6338,6360,6370,6290,6304,6320,-34,-18,833512,52683176760,493510
2326,p1405,20131203,6304,6320,6298,6308,6224,6226,6254,-94,-66,872490,54570297600,497726
2327,p1405,20131204,6226,6254,6206,6268,6202,6252,6240,-2,-14,547510,34172224000,494046
2328,p1405,20131205,6252,6240,6280,6296,6158,6160,6232,-80,-8,895292,55795315440,526058
2329,p1405,20131206,6160,6232,6182,6196,6122,6182,6164,-50,-68,791358,48790276360,488902
2330,p1405,20131209,6182,6164,6194,6274,6192,6244,6242,80,78,1019802,63664454320,476478
2331,p1405,20131210,6244,6242,6220,6256,6190,6242,6226,0,-16,888952,55350691440,466082
2332,p1405,20131211,6242,6226,6220,6260,6200,6260,6230,34,4,644756,40174516520,473970
2333,p1405,20131212,6260,6230,6250,6278,6192,6206,6238,-24,8,772540,48193884000,465868
2334,p1405,20131213,6206,6238,6180,6180,6038,6058,6104,-180,-134,964248,58861225280,490806
2335,p1405,20131216,6058,6104,6070,6092,6032,6036,6064,-68,-40,610974,37056606760,486502
2336,p1405,20131217,6036,6064,6070,6118,6062,6076,6088,12,24,714330,43498267600,475240
2337,p1405,20131218,6076,6088,6038,6088,5984,6088,6016,0,-72,886816,53360603400,502580
2338,p1405,20131219,6088,6016,6060,6078,6010,6028,6046,12,30,572124,34593117000,486408
2339,p1405,20131220,6028,6046,6050,6094,6040,6046,6060,0,14,756028,45818387680,466184
2340,p1405,20131223,6046,6060,6060,6080,5974,6056,6034,-4,-26,926502,55905436000,474708
2341,p1405,20131224,6056,6034,6046,6056,6000,6010,6024,-24,-10,663666,39982362840,471746
2342,p1405,20131225,6010,6024,6010,6022,5916,5926,5966,-98,-58,755054,45055044840,448926
2343,p1405,20131226,5926,5966,5922,5958,5916,5942,5938,-24,-28,505814,30035246720,461812
2344,p1405,20131227,5942,5938,5930,6066,5928,6050,6000,112,62,860784,51651118680,462640
2345,p1405,20131230,6050,6000,6050,6116,6026,6066,6080,66,80,860460,52323248320,459008
2346,p1405,20131231,6066,6080,6030,6072,6016,6038,6038,-42,-42,523028,31587270040,441864
2347,p1406,20130621,6438,6438,0,0,0,6388,6388,-50,-50,0,0,0
2348,p1406,20130624,6388,6388,0,0,0,6312,6312,-76,-76,0,0,0
2349,p1406,20130625,6312,6312,0,0,0,6188,6188,-124,-124,0,0,0
2350,p1406,20130626,6188,6188,0,0,0,6166,6166,-22,-22,0,0,0
2351,p1406,20130627,6166,6166,0,0,0,6166,6166,0,0,0,0,0
2352,p1406,20130628,6166,6166,0,0,0,6166,6166,0,0,0,0,0
2353,p1406,20130701,6166,6166,0,0,0,6166,6166,0,0,0,0,0
2354,p1406,20130702,6166,6166,6166,6166,6166,6166,6166,0,0,2,123320,2
2355,p1406,20130703,6166,6166,0,0,0,6132,6132,-34,-34,0,0,2
2356,p1406,20130704,6132,6132,0,0,0,6132,6132,0,0,0,0,2
2357,p1406,20130705,6132,6132,0,0,0,6132,6132,0,0,0,0,2
2358,p1406,20130708,6132,6132,0,0,0,6134,6134,2,2,0,0,2
2359,p1406,20130709,6134,6134,5942,6080,5942,6080,6010,-54,-124,4,240440,2
2360,p1406,20130710,6080,6010,0,0,0,6010,6010,0,0,0,0,2
2361,p1406,20130711,6010,6010,6134,6136,6134,6136,6134,126,124,4,245400,2
2362,p1406,20130712,6136,6134,0,0,0,6134,6134,0,0,0,0,2
2363,p1406,20130715,6134,6134,5900,5900,5900,5900,5900,-234,-234,2,118000,2
2364,p1406,20130716,5900,5900,0,0,0,5900,5900,0,0,0,0,2
2365,p1406,20130717,5900,5900,0,0,0,5900,5900,0,0,0,0,2
2366,p1406,20130718,5900,5900,0,0,0,5900,5900,0,0,0,0,2
2367,p1406,20130719,5900,5900,0,0,0,5898,5898,-2,-2,0,0,2
2368,p1406,20130722,5898,5898,0,0,0,5898,5898,0,0,0,0,2
2369,p1406,20130723,5898,5898,0,0,0,5898,5898,0,0,0,0,2
2370,p1406,20130724,5898,5898,0,0,0,5862,5862,-36,-36,0,0,2
2371,p1406,20130725,5862,5862,0,0,0,5802,5802,-60,-60,0,0,2
2372,p1406,20130726,5802,5802,0,0,0,5686,5686,-116,-116,0,0,2
2373,p1406,20130729,5686,5686,0,0,0,5642,5642,-44,-44,0,0,2
2374,p1406,20130730,5642,5642,0,0,0,5642,5642,0,0,0,0,2
2375,p1406,20130731,5642,5642,0,0,0,5642,5642,0,0,0,0,2
2376,p1406,20130801,5642,5642,0,0,0,5642,5642,0,0,0,0,2
2377,p1406,20130802,5642,5642,0,0,0,5642,5642,0,0,0,0,2
2378,p1406,20130805,5642,5642,0,0,0,5642,5642,0,0,0,0,2
2379,p1406,20130806,5642,5642,0,0,0,5642,5642,0,0,0,0,2
2380,p1406,20130807,5642,5642,0,0,0,5600,5600,-42,-42,0,0,2
2381,p1406,20130808,5600,5600,0,0,0,5600,5600,0,0,0,0,2
2382,p1406,20130809,5600,5600,5626,5650,5590,5620,5618,20,18,34,1910680,4
2383,p1406,20130812,5620,5618,5528,5616,5512,5512,5560,-106,-58,8,444920,2
2384,p1406,20130813,5512,5560,5782,5782,5782,5782,5782,222,222,2,115640,0
2385,p1406,20130814,5782,5782,0,0,0,5782,5782,0,0,0,0,0
2386,p1406,20130815,5782,5782,0,0,0,5782,5782,0,0,0,0,0
2387,p1406,20130816,5782,5782,0,0,0,5782,5782,0,0,0,0,0
2388,p1406,20130819,5782,5782,0,0,0,5798,5798,16,16,0,0,0
2389,p1406,20130820,5798,5798,5818,5836,5818,5836,5826,38,28,8,466120,2
2390,p1406,20130821,5836,5826,0,0,0,5826,5826,0,0,0,0,2
2391,p1406,20130822,5826,5826,0,0,0,5814,5814,-12,-12,0,0,2
2392,p1406,20130823,5814,5814,0,0,0,5820,5820,6,6,0,0,2
2393,p1406,20130826,5820,5820,0,0,0,6016,6016,196,196,0,0,2
2394,p1406,20130827,6016,6016,0,0,0,6080,6080,64,64,0,0,2
2395,p1406,20130828,6080,6080,0,0,0,6048,6048,-32,-32,0,0,2
2396,p1406,20130829,6048,6048,0,0,0,5934,5934,-114,-114,0,0,2
2397,p1406,20130830,5934,5934,5886,5886,5784,5784,5834,-150,-100,4,233400,4
2398,p1406,20130902,5784,5834,5876,5876,5876,5876,5876,42,42,2,117520,4
2399,p1406,20130903,5876,5876,5902,5902,5858,5858,5892,-18,16,16,942720,14
2400,p1406,20130904,5858,5892,5868,5868,5844,5844,5862,-48,-30,8,468960,12
2401,p1406,20130905,5844,5862,5932,5932,5826,5864,5898,2,36,46,2713360,10
2402,p1406,20130906,5864,5898,5930,5930,5860,5872,5880,-26,-18,10,588120,12
2403,p1406,20130909,5872,5880,0,0,0,5880,5880,0,0,0,0,12
2404,p1406,20130910,5880,5880,5866,5870,5866,5870,5868,-10,-12,4,234720,14
2405,p1406,20130911,5870,5868,0,0,0,5862,5862,-6,-6,0,0,14
2406,p1406,20130912,5862,5862,5844,5844,5844,5844,5844,-18,-18,2,116880,14
2407,p1406,20130913,5844,5844,5804,5810,5738,5810,5776,-34,-68,18,1040000,12
2408,p1406,20130916,5810,5776,0,0,0,5736,5736,-40,-40,0,0,12
2409,p1406,20130917,5736,5736,5630,5660,5630,5660,5634,-76,-102,12,676200,10
2410,p1406,20130918,5660,5634,0,0,0,5634,5634,0,0,0,0,10
2411,p1406,20130923,5634,5634,0,0,0,5566,5566,-68,-68,0,0,10
2412,p1406,20130924,5566,5566,5648,5668,5640,5640,5650,74,84,8,452080,2
2413,p1406,20130925,5640,5650,5602,5622,5602,5622,5614,-28,-36,6,336920,6
2414,p1406,20130926,5622,5614,5568,5658,5568,5640,5624,26,10,18,1012480,2
2415,p1406,20130927,5640,5624,5638,5638,5638,5638,5638,14,14,2,112760,2
2416,p1406,20130930,5638,5638,0,0,0,5628,5628,-10,-10,0,0,2
2417,p1406,20131008,5628,5628,5720,5780,5708,5780,5736,152,108,6,344160,2
2418,p1406,20131009,5780,5736,0,0,0,5736,5736,0,0,0,0,2
2419,p1406,20131010,5736,5736,0,0,0,5736,5736,0,0,0,0,2
2420,p1406,20131011,5736,5736,0,0,0,5736,5736,0,0,0,0,2
2421,p1406,20131014,5736,5736,0,0,0,5736,5736,0,0,0,0,2
2422,p1406,20131015,5736,5736,5882,5922,5882,5900,5902,164,166,54,3187200,2
2423,p1406,20131016,5900,5902,0,0,0,5920,5920,18,18,0,0,2
2424,p1406,20131017,5920,5920,6026,6102,5954,5954,5982,34,62,228,13641360,104
2425,p1406,20131018,5954,5982,6012,6012,6012,6012,6012,30,30,2,120240,102
2426,p1406,20131021,6012,6012,6200,6200,6180,6180,6190,168,178,196,12132800,4
2427,p1406,20131022,6180,6190,6196,6196,6110,6110,6150,-80,-40,28,1722120,4
2428,p1406,20131023,6110,6150,6150,6180,6150,6178,6152,28,2,174,10705120,170
2429,p1406,20131024,6178,6152,6160,6174,6132,6138,6150,-14,-2,38,2337680,154
2430,p1406,20131025,6138,6150,6130,6164,6110,6110,6124,-40,-26,164,10043480,8
2431,p1406,20131028,6110,6124,6126,6126,6094,6094,6108,-30,-16,6,366560,8
2432,p1406,20131029,6094,6108,6166,6166,6166,6166,6166,58,58,2,123320,6
2433,p1406,20131030,6166,6166,6324,6324,6324,6324,6324,158,158,4,252960,10
2434,p1406,20131031,6324,6324,6362,6390,6336,6344,6360,20,36,64,4071560,16
2435,p1406,20131101,6344,6360,6392,6478,6306,6448,6428,88,68,34,2185880,34
2436,p1406,20131104,6448,6428,6372,6432,6316,6370,6376,-58,-52,56,3571400,6
2437,p1406,20131105,6370,6376,0,0,0,6376,6376,0,0,0,0,6
2438,p1406,20131106,6376,6376,6310,6368,6298,6344,6336,-32,-40,16,1014000,8
2439,p1406,20131107,6344,6336,6342,6342,6320,6320,6332,-16,-4,22,1393320,2
2440,p1406,20131108,6320,6332,6242,6328,6242,6308,6280,-24,-52,28,1758800,8
2441,p1406,20131111,6308,6280,6262,6262,6262,6262,6262,-18,-18,2,125240,8
2442,p1406,20131112,6262,6262,6242,6276,6216,6276,6234,14,-28,14,872760,4
2443,p1406,20131113,6276,6234,6278,6374,6278,6348,6356,114,122,26,1652720,28
2444,p1406,20131114,6348,6356,0,0,0,6364,6364,8,8,0,0,28
2445,p1406,20131115,6364,6364,6400,6450,6306,6334,6348,-30,-16,58,3682760,32
2446,p1406,20131118,6334,6348,6312,6330,6308,6330,6320,-18,-28,24,1516960,12
2447,p1406,20131119,6330,6320,0,0,0,6320,6320,0,0,0,0,12
2448,p1406,20131120,6320,6320,6308,6308,6268,6268,6284,-52,-36,20,1256800,32
2449,p1406,20131121,6268,6284,6414,6426,6394,6422,6410,138,126,44,2821200,16
2450,p1406,20131122,6422,6410,6460,6524,6460,6524,6484,114,74,6,389040,14
2451,p1406,20131125,6524,6484,6442,6514,6442,6506,6490,22,6,18,1168320,12
2452,p1406,20131126,6506,6490,6490,6490,6416,6416,6440,-74,-50,10,644000,10
2453,p1406,20131127,6416,6440,6302,6330,6302,6330,6312,-110,-128,10,631320,8
2454,p1406,20131128,6330,6312,6368,6368,6366,6368,6366,56,54,40,2546840,14
2455,p1406,20131129,6368,6366,0,0,0,6366,6366,0,0,0,0,14
2456,p1406,20131202,6366,6366,6398,6400,6324,6324,6368,-42,2,28,1783040,20
2457,p1406,20131203,6324,6368,6310,6310,6258,6258,6298,-110,-70,16,1007880,14
2458,p1406,20131204,6258,6298,6272,6272,6260,6260,6266,-38,-32,8,501400,14
2459,p1406,20131205,6260,6266,6240,6240,6240,6240,6240,-26,-26,2,124800,12
2460,p1406,20131206,6240,6240,6216,6228,6206,6228,6214,-12,-26,24,1491720,4
2461,p1406,20131209,6228,6214,6240,6284,6240,6270,6252,56,38,20,1250640,12
2462,p1406,20131210,6270,6252,6252,6286,6252,6270,6264,18,12,16,1002360,4
2463,p1406,20131211,6270,6264,6240,6284,6240,6268,6266,4,2,34,2130600,6
2464,p1406,20131212,6268,6266,6268,6268,6240,6240,6258,-26,-8,8,500640,2
2465,p1406,20131213,6240,6258,6152,6170,6146,6170,6150,-88,-108,44,2706560,40
2466,p1406,20131216,6170,6150,6106,6108,6052,6052,6098,-98,-52,68,4147200,28
2467,p1406,20131217,6052,6098,6092,6132,6076,6124,6108,26,10,34,2076960,14
2468,p1406,20131218,6124,6108,6006,6036,6006,6036,6020,-72,-88,4,240840,14
2469,p1406,20131219,6036,6020,6062,6076,6034,6034,6070,14,50,106,6434440,10
2470,p1406,20131220,6034,6070,6060,6126,6060,6086,6088,16,18,16,974160,6
2471,p1406,20131223,6086,6088,6108,6108,5998,6074,6060,-14,-28,66,4000000,6
2472,p1406,20131224,6074,6060,6048,6072,6048,6072,6064,12,4,6,363840,4
2473,p1406,20131225,6072,6064,6070,6070,5990,6008,6026,-56,-38,16,964160,8
2474,p1406,20131226,6008,6026,0,0,0,6004,6004,-22,-22,0,0,8
2475,p1406,20131227,6004,6004,5974,6098,5974,6098,6016,94,12,10,601680,8
2476,p1406,20131230,6098,6016,6080,6156,6080,6108,6112,92,96,26,1589240,10
2477,p1406,20131231,6108,6112,6068,6068,6068,6068,6068,-44,-44,2,121360,12
2478,p1407,20130716,5910,5910,6016,6016,5852,5878,5914,-32,4,6,354920,0
2479,p1407,20130717,5878,5914,0,0,0,5926,5926,12,12,0,0,0
2480,p1407,20130718,5926,5926,0,0,0,5924,5924,-2,-2,0,0,0
2481,p1407,20130719,5924,5924,0,0,0,5938,5938,14,14,0,0,0
2482,p1407,20130722,5938,5938,0,0,0,5892,5892,-46,-46,0,0,0
2483,p1407,20130723,5892,5892,0,0,0,5906,5906,14,14,0,0,0
2484,p1407,20130724,5906,5906,0,0,0,5872,5872,-34,-34,0,0,0
2485,p1407,20130725,5872,5872,0,0,0,5818,5818,-54,-54,0,0,0
2486,p1407,20130726,5818,5818,0,0,0,5702,5702,-116,-116,0,0,0
2487,p1407,20130729,5702,5702,0,0,0,5666,5666,-36,-36,0,0,0
2488,p1407,20130730,5666,5666,0,0,0,5626,5626,-40,-40,0,0,0
2489,p1407,20130731,5626,5626,0,0,0,5706,5706,80,80,0,0,0
2490,p1407,20130801,5706,5706,0,0,0,5692,5692,-14,-14,0,0,0
2491,p1407,20130802,5692,5692,0,0,0,5724,5724,32,32,0,0,0
2492,p1407,20130805,5724,5724,0,0,0,5710,5710,-14,-14,0,0,0
2493,p1407,20130806,5710,5710,0,0,0,5690,5690,-20,-20,0,0,0
2494,p1407,20130807,5690,5690,0,0,0,5600,5600,-90,-90,0,0,0
2495,p1407,20130808,5600,5600,5650,5650,5640,5640,5644,40,44,16,903200,8
2496,p1407,20130809,5640,5644,5548,5650,5460,5628,5560,-16,-84,28,1557120,4
2497,p1407,20130812,5628,5560,5726,5726,5670,5670,5706,110,146,6,342440,2
2498,p1407,20130813,5670,5706,0,0,0,5932,5932,226,226,0,0,2
2499,p1407,20130814,5932,5932,5864,5864,5864,5864,5864,-68,-68,2,117280,4
2500,p1407,20130815,5864,5864,0,0,0,5864,5864,0,0,0,0,4
2501,p1407,20130816,5864,5864,0,0,0,5956,5956,92,92,0,0,4
2502,p1407,20130819,5956,5956,5922,5922,5922,5922,5922,-34,-34,2,118440,4
2503,p1407,20130820,5922,5922,0,0,0,5950,5950,28,28,0,0,4
2504,p1407,20130821,5950,5950,0,0,0,5912,5912,-38,-38,0,0,4
2505,p1407,20130822,5912,5912,0,0,0,5900,5900,-12,-12,0,0,4
2506,p1407,20130823,5900,5900,0,0,0,5906,5906,6,6,0,0,4
2507,p1407,20130826,5906,5906,0,0,0,6106,6106,200,200,0,0,4
2508,p1407,20130827,6106,6106,0,0,0,6170,6170,64,64,0,0,4
2509,p1407,20130828,6170,6170,0,0,0,6138,6138,-32,-32,0,0,4
2510,p1407,20130829,6138,6138,5896,5896,5896,5896,5896,-242,-242,2,117920,6
2511,p1407,20130830,5896,5896,5866,5866,5824,5824,5840,-72,-56,6,350400,8
2512,p1407,20130902,5824,5840,0,0,0,5882,5882,42,42,0,0,8
2513,p1407,20130903,5882,5882,5966,5966,5966,5966,5966,84,84,2,119320,6
2514,p1407,20130904,5966,5966,0,0,0,5966,5966,0,0,0,0,6
2515,p1407,20130905,5966,5966,0,0,0,6002,6002,36,36,0,0,6
2516,p1407,20130906,6002,6002,5934,5934,5934,5934,5934,-68,-68,2,118680,4
2517,p1407,20130909,5934,5934,5994,5994,5946,5946,5968,12,34,14,835720,4
2518,p1407,20130910,5946,5968,5828,5828,5828,5828,5828,-140,-140,2,116560,6
2519,p1407,20130911,5828,5828,0,0,0,5828,5828,0,0,0,0,6
2520,p1407,20130912,5828,5828,5824,5830,5794,5830,5818,2,-10,8,465440,8
2521,p1407,20130913,5830,5818,0,0,0,5818,5818,0,0,0,0,8
2522,p1407,20130916,5818,5818,0,0,0,5818,5818,0,0,0,0,8
2523,p1407,20130917,5818,5818,5726,5726,5726,5726,5726,-92,-92,4,229040,6
2524,p1407,20130918,5726,5726,0,0,0,5726,5726,0,0,0,0,6
2525,p1407,20130923,5726,5726,0,0,0,5658,5658,-68,-68,0,0,6
2526,p1407,20130924,5658,5658,0,0,0,5658,5658,0,0,0,0,6
2527,p1407,20130925,5658,5658,5610,5738,5610,5700,5682,42,24,6,340960,6
2528,p1407,20130926,5700,5682,5666,5666,5666,5666,5666,-16,-16,2,113320,4
2529,p1407,20130927,5666,5666,0,0,0,5666,5666,0,0,0,0,4
2530,p1407,20130930,5666,5666,5686,5686,5686,5686,5686,20,20,2,113720,4
2531,p1407,20131008,5686,5686,0,0,0,5686,5686,0,0,0,0,4
2532,p1407,20131009,5686,5686,0,0,0,5686,5686,0,0,0,0,4
2533,p1407,20131010,5686,5686,0,0,0,5802,5802,116,116,0,0,4
2534,p1407,20131011,5802,5802,0,0,0,5802,5802,0,0,0,0,4
2535,p1407,20131014,5802,5802,0,0,0,5850,5850,48,48,0,0,4
2536,p1407,20131015,5850,5850,0,0,0,6018,6018,168,168,0,0,4
2537,p1407,20131016,6018,6018,5962,5962,5962,5962,5962,-56,-56,2,119240,2
2538,p1407,20131017,5962,5962,6026,6026,6026,6026,6026,64,64,2,120520,2
2539,p1407,20131018,6026,6026,6052,6052,6050,6050,6050,24,24,4,242040,0
2540,p1407,20131021,6050,6050,0,0,0,6228,6228,178,178,0,0,0
2541,p1407,20131022,6228,6228,0,0,0,6188,6188,-40,-40,0,0,0
2542,p1407,20131023,6188,6188,0,0,0,6190,6190,2,2,0,0,0
2543,p1407,20131024,6190,6190,0,0,0,6188,6188,-2,-2,0,0,0
2544,p1407,20131025,6188,6188,0,0,0,6162,6162,-26,-26,0,0,0
2545,p1407,20131028,6162,6162,0,0,0,6146,6146,-16,-16,0,0,0
2546,p1407,20131029,6146,6146,0,0,0,6146,6146,0,0,0,0,0
2547,p1407,20131030,6146,6146,0,0,0,6302,6302,156,156,0,0,0
2548,p1407,20131031,6302,6302,0,0,0,6336,6336,34,34,0,0,0
2549,p1407,20131101,6336,6336,0,0,0,6402,6402,66,66,0,0,0
2550,p1407,20131104,6402,6402,0,0,0,6352,6352,-50,-50,0,0,0
2551,p1407,20131105,6352,6352,0,0,0,6312,6312,-40,-40,0,0,0
2552,p1407,20131106,6312,6312,0,0,0,6274,6274,-38,-38,0,0,0
2553,p1407,20131107,6274,6274,0,0,0,6272,6272,-2,-2,0,0,0
2554,p1407,20131108,6272,6272,6328,6330,6290,6290,6310,18,38,8,504840,0
2555,p1407,20131111,6290,6310,0,0,0,6292,6292,-18,-18,0,0,0
2556,p1407,20131112,6292,6292,0,0,0,6264,6264,-28,-28,0,0,0
2557,p1407,20131113,6264,6264,0,0,0,6386,6386,122,122,0,0,0
2558,p1407,20131114,6386,6386,0,0,0,6394,6394,8,8,0,0,0
2559,p1407,20131115,6394,6394,0,0,0,6378,6378,-16,-16,0,0,0
2560,p1407,20131118,6378,6378,0,0,0,6350,6350,-28,-28,0,0,0
2561,p1407,20131119,6350,6350,0,0,0,6328,6328,-22,-22,0,0,0
2562,p1407,20131120,6328,6328,0,0,0,6292,6292,-36,-36,0,0,0
2563,p1407,20131121,6292,6292,6484,6484,6442,6442,6462,150,170,24,1551240,0
2564,p1407,20131122,6442,6462,0,0,0,6536,6536,74,74,0,0,0
2565,p1407,20131125,6536,6536,0,0,0,6542,6542,6,6,0,0,0
2566,p1407,20131126,6542,6542,0,0,0,6492,6492,-50,-50,0,0,0
2567,p1407,20131127,6492,6492,0,0,0,6364,6364,-128,-128,0,0,0
2568,p1407,20131128,6364,6364,0,0,0,6418,6418,54,54,0,0,0
2569,p1407,20131129,6418,6418,0,0,0,6430,6430,12,12,0,0,0
2570,p1407,20131202,6430,6430,0,0,0,6432,6432,2,2,0,0,0
2571,p1407,20131203,6432,6432,0,0,0,6362,6362,-70,-70,0,0,0
2572,p1407,20131204,6362,6362,0,0,0,6330,6330,-32,-32,0,0,0
2573,p1407,20131205,6330,6330,0,0,0,6304,6304,-26,-26,0,0,0
2574,p1407,20131206,6304,6304,0,0,0,6278,6278,-26,-26,0,0,0
2575,p1407,20131209,6278,6278,0,0,0,6278,6278,0,0,0,0,0
2576,p1407,20131210,6278,6278,0,0,0,6278,6278,0,0,0,0,0
2577,p1407,20131211,6278,6278,0,0,0,6316,6316,38,38,0,0,0
2578,p1407,20131212,6316,6316,0,0,0,6316,6316,0,0,0,0,0
2579,p1407,20131213,6316,6316,0,0,0,6316,6316,0,0,0,0,0
2580,p1407,20131216,6316,6316,0,0,0,6316,6316,0,0,0,0,0
2581,p1407,20131217,6316,6316,0,0,0,6192,6192,-124,-124,0,0,0
2582,p1407,20131218,6192,6192,0,0,0,6192,6192,0,0,0,0,0
2583,p1407,20131219,6192,6192,0,0,0,6192,6192,0,0,0,0,0
2584,p1407,20131220,6192,6192,0,0,0,6160,6160,-32,-32,0,0,0
2585,p1407,20131223,6160,6160,0,0,0,6160,6160,0,0,0,0,0
2586,p1407,20131224,6160,6160,0,0,0,6128,6128,-32,-32,0,0,0
2587,p1407,20131225,6128,6128,0,0,0,6038,6038,-90,-90,0,0,0
2588,p1407,20131226,6038,6038,0,0,0,6038,6038,0,0,0,0,0
2589,p1407,20131227,6038,6038,0,0,0,6058,6058,20,20,0,0,0
2590,p1407,20131230,6058,6058,0,0,0,6082,6082,24,24,0,0,0
2591,p1407,20131231,6082,6082,0,0,0,6082,6082,0,0,0,0,0
2592,p1408,20130816,5726,5726,5838,5944,5838,5920,5892,194,166,208,12255600,0
2593,p1408,20130819,5920,5892,0,0,0,5892,5892,0,0,0,0,0
2594,p1408,20130820,5892,5892,0,0,0,5920,5920,28,28,0,0,0
2595,p1408,20130821,5920,5920,0,0,0,5882,5882,-38,-38,0,0,0
2596,p1408,20130822,5882,5882,0,0,0,5870,5870,-12,-12,0,0,0
2597,p1408,20130823,5870,5870,0,0,0,5876,5876,6,6,0,0,0
2598,p1408,20130826,5876,5876,0,0,0,6074,6074,198,198,0,0,0
2599,p1408,20130827,6074,6074,0,0,0,6138,6138,64,64,0,0,0
2600,p1408,20130828,6138,6138,0,0,0,6106,6106,-32,-32,0,0,0
2601,p1408,20130829,6106,6106,0,0,0,5866,5866,-240,-240,0,0,0
2602,p1408,20130830,5866,5866,0,0,0,5812,5812,-54,-54,0,0,0
2603,p1408,20130902,5812,5812,0,0,0,5852,5852,40,40,0,0,0
2604,p1408,20130903,5852,5852,0,0,0,5934,5934,82,82,0,0,0
2605,p1408,20130904,5934,5934,0,0,0,5904,5904,-30,-30,0,0,0
2606,p1408,20130905,5904,5904,0,0,0,5940,5940,36,36,0,0,0
2607,p1408,20130906,5940,5940,0,0,0,5874,5874,-66,-66,0,0,0
2608,p1408,20130909,5874,5874,0,0,0,5906,5906,32,32,0,0,0
2609,p1408,20130910,5906,5906,0,0,0,5768,5768,-138,-138,0,0,0
2610,p1408,20130911,5768,5768,0,0,0,5762,5762,-6,-6,0,0,0
2611,p1408,20130912,5762,5762,0,0,0,5754,5754,-8,-8,0,0,0
2612,p1408,20130913,5754,5754,0,0,0,5688,5688,-66,-66,0,0,0
2613,p1408,20130916,5688,5688,0,0,0,5592,5592,-96,-96,0,0,0
2614,p1408,20130917,5592,5592,0,0,0,5592,5592,0,0,0,0,0
2615,p1408,20130918,5592,5592,0,0,0,5592,5592,0,0,0,0,0
2616,p1408,20130923,5592,5592,0,0,0,5526,5526,-66,-66,0,0,0
2617,p1408,20130924,5526,5526,0,0,0,5608,5608,82,82,0,0,0
2618,p1408,20130925,5608,5608,0,0,0,5608,5608,0,0,0,0,0
2619,p1408,20130926,5608,5608,0,0,0,5594,5594,-14,-14,0,0,0
2620,p1408,20130927,5594,5594,0,0,0,5606,5606,12,12,0,0,0
2621,p1408,20130930,5606,5606,0,0,0,5624,5624,18,18,0,0,0
2622,p1408,20131008,5624,5624,0,0,0,5730,5730,106,106,0,0,0
2623,p1408,20131009,5730,5730,0,0,0,5730,5730,0,0,0,0,0
2624,p1408,20131010,5730,5730,0,0,0,5770,5770,40,40,0,0,0
2625,p1408,20131011,5770,5770,0,0,0,5836,5836,66,66,0,0,0
2626,p1408,20131014,5836,5836,0,0,0,5886,5886,50,50,0,0,0
2627,p1408,20131015,5886,5886,0,0,0,6056,6056,170,170,0,0,0
2628,p1408,20131016,6056,6056,0,0,0,6000,6000,-56,-56,0,0,0
2629,p1408,20131017,6000,6000,0,0,0,6064,6064,64,64,0,0,0
2630,p1408,20131018,6064,6064,0,0,0,6088,6088,24,24,0,0,0
2631,p1408,20131021,6088,6088,0,0,0,6268,6268,180,180,0,0,0
2632,p1408,20131022,6268,6268,0,0,0,6228,6228,-40,-40,0,0,0
2633,p1408,20131023,6228,6228,0,0,0,6230,6230,2,2,0,0,0
2634,p1408,20131024,6230,6230,0,0,0,6228,6228,-2,-2,0,0,0
2635,p1408,20131025,6228,6228,0,0,0,6202,6202,-26,-26,0,0,0
2636,p1408,20131028,6202,6202,0,0,0,6186,6186,-16,-16,0,0,0
2637,p1408,20131029,6186,6186,0,0,0,6244,6244,58,58,0,0,0
2638,p1408,20131030,6244,6244,0,0,0,6298,6298,54,54,0,0,0
2639,p1408,20131031,6298,6298,0,0,0,6332,6332,34,34,0,0,0
2640,p1408,20131101,6332,6332,0,0,0,6398,6398,66,66,0,0,0
2641,p1408,20131104,6398,6398,0,0,0,6348,6348,-50,-50,0,0,0
2642,p1408,20131105,6348,6348,0,0,0,6308,6308,-40,-40,0,0,0
2643,p1408,20131106,6308,6308,0,0,0,6270,6270,-38,-38,0,0,0
2644,p1408,20131107,6270,6270,0,0,0,6268,6268,-2,-2,0,0,0
2645,p1408,20131108,6268,6268,0,0,0,6268,6268,0,0,0,0,0
2646,p1408,20131111,6268,6268,0,0,0,6252,6252,-16,-16,0,0,0
2647,p1408,20131112,6252,6252,0,0,0,6226,6226,-26,-26,0,0,0
2648,p1408,20131113,6226,6226,0,0,0,6346,6346,120,120,0,0,0
2649,p1408,20131114,6346,6346,0,0,0,6354,6354,8,8,0,0,0
2650,p1408,20131115,6354,6354,0,0,0,6340,6340,-14,-14,0,0,0
2651,p1408,20131118,6340,6340,0,0,0,6314,6314,-26,-26,0,0,0
2652,p1408,20131119,6314,6314,0,0,0,6292,6292,-22,-22,0,0,0
2653,p1408,20131120,6292,6292,0,0,0,6258,6258,-34,-34,0,0,0
2654,p1408,20131121,6258,6258,6272,6380,6272,6380,6286,122,28,28,1760280,24
2655,p1408,20131122,6380,6286,6498,6498,6498,6498,6498,212,212,2,129960,24
2656,p1408,20131125,6498,6498,0,0,0,6498,6498,0,0,0,0,24
2657,p1408,20131126,6498,6498,6376,6376,6358,6358,6366,-140,-132,52,3311240,20
2658,p1408,20131127,6358,6366,6328,6328,6306,6306,6316,-60,-50,4,252680,16
2659,p1408,20131128,6306,6316,0,0,0,6316,6316,0,0,0,0,16
2660,p1408,20131129,6316,6316,0,0,0,6326,6326,10,10,0,0,16
2661,p1408,20131202,6326,6326,0,0,0,6326,6326,0,0,0,0,16
2662,p1408,20131203,6326,6326,6292,6292,6260,6260,6270,-66,-56,16,1003280,12
2663,p1408,20131204,6260,6270,0,0,0,6240,6240,-30,-30,0,0,12
2664,p1408,20131205,6240,6240,6288,6288,6260,6260,6270,20,30,16,1003440,10
2665,p1408,20131206,6260,6270,6262,6262,6262,6262,6262,-8,-8,4,250480,6
2666,p1408,20131209,6262,6262,0,0,0,6264,6264,2,2,0,0,6
2667,p1408,20131210,6264,6264,0,0,0,6290,6290,26,26,0,0,6
2668,p1408,20131211,6290,6290,0,0,0,6290,6290,0,0,0,0,6
2669,p1408,20131212,6290,6290,0,0,0,6290,6290,0,0,0,0,6
2670,p1408,20131213,6290,6290,0,0,0,6176,6176,-114,-114,0,0,6
2671,p1408,20131216,6176,6176,6078,6182,6078,6182,6130,6,-46,4,245200,6
2672,p1408,20131217,6182,6130,0,0,0,6130,6130,0,0,0,0,6
2673,p1408,20131218,6130,6130,0,0,0,6130,6130,0,0,0,0,6
2674,p1408,20131219,6130,6130,0,0,0,6130,6130,0,0,0,0,6
2675,p1408,20131220,6130,6130,0,0,0,6130,6130,0,0,0,0,6
2676,p1408,20131223,6130,6130,0,0,0,6130,6130,0,0,0,0,6
2677,p1408,20131224,6130,6130,0,0,0,6130,6130,0,0,0,0,6
2678,p1408,20131225,6130,6130,0,0,0,6030,6030,-100,-100,0,0,6
2679,p1408,20131226,6030,6030,0,0,0,6020,6020,-10,-10,0,0,6
2680,p1408,20131227,6020,6020,0,0,0,6068,6068,48,48,0,0,6
2681,p1408,20131230,6068,6068,0,0,0,6096,6096,28,28,0,0,6
2682,p1408,20131231,6096,6096,0,0,0,6096,6096,0,0,0,0,6
2683,p1409,20130917,5722,5770,5714,5738,5684,5732,5720,-38,-50,628,35932680,1054
2684,p1409,20130918,5732,5720,5734,5768,5722,5740,5738,20,18,312,17906360,954
2685,p1409,20130923,5740,5738,5674,5694,5654,5688,5682,-50,-56,718,40800880,1454
2686,p1409,20130924,5688,5682,5708,5754,5696,5752,5738,70,56,2156,123713400,2144
2687,p1409,20130925,5752,5738,5710,5748,5710,5718,5726,-20,-12,1682,96341240,2362
2688,p1409,20130926,5718,5726,5724,5750,5710,5736,5722,10,-4,1036,59297000,2652
2689,p1409,20130927,5736,5722,5720,5738,5682,5690,5704,-32,-18,1584,90363400,2262
2690,p1409,20130930,5690,5704,5686,5708,5680,5686,5694,-18,-10,618,35191360,2172
2691,p1409,20131008,5686,5694,5670,5872,5670,5824,5814,130,120,836,48616440,2466
2692,p1409,20131009,5824,5814,5828,5860,5824,5832,5840,18,26,1932,112858600,3296
2693,p1409,20131010,5832,5840,5844,5910,5836,5902,5870,62,30,2356,138324440,3590
2694,p1409,20131011,5902,5870,5918,5958,5918,5938,5930,68,60,4086,242366560,4734
2695,p1409,20131014,5938,5930,5908,5992,5908,5960,5958,30,28,7694,458471600,9352
2696,p1409,20131015,5960,5958,5940,6000,5938,5980,5962,22,4,2208,131655200,9444
2697,p1409,20131016,5980,5962,5958,6010,5958,5984,5986,22,24,2018,120802160,9828
2698,p1409,20131017,5984,5986,6030,6120,6030,6066,6086,80,100,5866,357060200,11764
2699,p1409,20131018,6066,6086,6050,6114,6040,6106,6078,20,-8,4518,274679160,14408
2700,p1409,20131021,6106,6078,6158,6240,6150,6230,6218,152,140,7998,497349440,16548
2701,p1409,20131022,6230,6218,6226,6236,6162,6182,6188,-36,-30,4964,307210680,15596
2702,p1409,20131023,6182,6188,6226,6264,6200,6236,6228,48,40,13260,825901360,18174
2703,p1409,20131024,6236,6228,6280,6280,6180,6194,6218,-34,-10,12568,781612840,19468
2704,p1409,20131025,6194,6218,6188,6196,6122,6144,6160,-74,-58,8254,508552120,20936
2705,p1409,20131028,6144,6160,6120,6180,6118,6138,6150,-22,-10,10518,646976080,24942
2706,p1409,20131029,6138,6150,6150,6184,6100,6156,6148,6,-2,10320,634521960,28150
2707,p1409,20131030,6156,6148,6210,6390,6210,6356,6306,208,158,39190,2471809440,39372
2708,p1409,20131031,6356,6306,6340,6350,6296,6318,6322,12,16,22572,1427176080,37940
2709,p1409,20131101,6318,6322,6370,6410,6330,6408,6358,86,36,23340,1484231760,41330
2710,p1409,20131104,6408,6358,6390,6410,6358,6386,6380,28,22,22982,1466283640,41746
2711,p1409,20131105,6386,6380,6350,6390,6310,6364,6350,-16,-30,21964,1394815800,44834
2712,p1409,20131106,6364,6350,6346,6372,6320,6340,6344,-10,-6,12942,821237880,44606
2713,p1409,20131107,6340,6344,6310,6368,6304,6324,6334,-20,-10,30530,1934269840,51838
2714,p1409,20131108,6324,6334,6300,6338,6256,6292,6296,-42,-38,19248,1212011080,55560
2715,p1409,20131111,6292,6296,6300,6360,6248,6250,6284,-46,-12,26150,1643743120,50396
2716,p1409,20131112,6250,6284,6272,6292,6216,6290,6250,6,-34,14572,910846400,48924
2717,p1409,20131113,6290,6250,6350,6386,6328,6378,6362,128,112,23920,1521885400,53254
2718,p1409,20131114,6378,6362,6350,6408,6350,6400,6372,38,10,16776,1069241960,53388
2719,p1409,20131115,6400,6372,6372,6404,6336,6342,6370,-30,-2,22274,1419088600,51096
2720,p1409,20131118,6342,6370,6310,6346,6298,6302,6318,-68,-52,18606,1175879960,53496
2721,p1409,20131119,6302,6318,6310,6330,6270,6288,6296,-30,-22,30630,1928879800,52360
2722,p1409,20131120,6288,6296,6284,6340,6272,6338,6296,42,0,30738,1935768240,54822
2723,p1409,20131121,6338,6296,6338,6464,6336,6434,6408,138,112,48554,3111807800,65162
2724,p1409,20131122,6434,6408,6502,6540,6480,6490,6504,82,96,59588,3876680240,74192
2725,p1409,20131125,6490,6504,6498,6544,6460,6500,6504,-4,0,58976,3836952360,76218
2726,p1409,20131126,6500,6504,6480,6496,6352,6360,6414,-144,-90,67994,4361921840,66700
2727,p1409,20131127,6360,6414,6360,6394,6328,6380,6358,-34,-56,48818,3104187320,65756
2728,p1409,20131128,6380,6358,6350,6414,6348,6372,6382,14,24,50140,3200422920,62364
2729,p1409,20131129,6372,6382,6396,6424,6370,6422,6394,40,12,48238,3084529520,65136
2730,p1409,20131202,6422,6394,6422,6424,6336,6350,6368,-44,-26,71228,4536463880,64734
2731,p1409,20131203,6350,6368,6336,6348,6276,6280,6300,-88,-68,77550,4886840040,70172
2732,p1409,20131204,6280,6300,6260,6328,6256,6322,6304,22,4,60264,3799715080,73722
2733,p1409,20131205,6322,6304,6356,6366,6228,6232,6308,-72,4,71852,4532565520,67732
2734,p1409,20131206,6232,6308,6262,6270,6192,6254,6238,-54,-70,70898,4422999640,74076
2735,p1409,20131209,6254,6238,6290,6334,6266,6310,6306,72,68,78400,4944531080,76420
2736,p1409,20131210,6310,6306,6302,6322,6260,6308,6290,2,-16,77936,4903160560,79698
2737,p1409,20131211,6308,6290,6290,6330,6264,6328,6296,38,6,52472,3304029760,77334
2738,p1409,20131212,6328,6296,6316,6348,6260,6278,6308,-18,12,65288,4119340200,77046
2739,p1409,20131213,6278,6308,6250,6250,6114,6136,6182,-172,-126,90260,5581401880,81732
2740,p1409,20131216,6136,6182,6158,6166,6114,6118,6142,-64,-40,63050,3872602120,78508
2741,p1409,20131217,6118,6142,6140,6190,6136,6154,6162,12,20,52416,3229909400,79192
2742,p1409,20131218,6154,6162,6126,6158,6062,6158,6090,-4,-72,83648,5094811240,77964
2743,p1409,20131219,6158,6090,6128,6150,6082,6090,6112,0,22,64552,3946375240,82514
2744,p1409,20131220,6090,6112,6124,6168,6106,6132,6138,20,26,147092,9029080600,113718
2745,p1409,20131223,6132,6138,6142,6164,6060,6136,6122,-2,-16,133858,8197187920,104720
2746,p1409,20131224,6136,6122,6124,6134,6084,6100,6106,-22,-16,106994,6533933400,97598
2747,p1409,20131225,6100,6106,6104,6110,6006,6018,6056,-88,-50,79708,4828028040,89022
2748,p1409,20131226,6018,6056,6012,6046,6004,6032,6026,-24,-30,37336,2250178200,88744
2749,p1409,20131227,6032,6026,6032,6148,6012,6132,6088,106,62,91554,5574406640,94634
2750,p1409,20131230,6132,6088,6110,6192,6110,6146,6160,58,72,104214,6419604720,104572
2751,p1409,20131231,6146,6160,6116,6146,6100,6112,6114,-48,-46,96768,5916685640,113298
2752,p1410,20131023,6048,6048,0,0,0,6086,6086,38,38,0,0,0
2753,p1410,20131024,6086,6086,0,0,0,6078,6078,-8,-8,0,0,0
2754,p1410,20131025,6078,6078,6078,6078,6078,6078,6078,0,0,16,972480,16
2755,p1410,20131028,6078,6078,0,0,0,6078,6078,0,0,0,0,16
2756,p1410,20131029,6078,6078,6170,6196,6106,6160,6146,82,68,1056,64902480,6
2757,p1410,20131030,6160,6146,0,0,0,6302,6302,156,156,0,0,6
2758,p1410,20131031,6302,6302,6300,6318,6282,6282,6300,-20,-2,190,11970680,122
2759,p1410,20131101,6282,6300,6310,6324,6310,6324,6318,24,18,20,1263840,136
2760,p1410,20131104,6324,6318,6410,6414,6354,6354,6400,36,82,18,1152240,120
2761,p1410,20131105,6354,6400,6328,6328,6296,6296,6312,-104,-88,4,252480,120
2762,p1410,20131106,6296,6312,6252,6252,6252,6252,6252,-60,-60,2,125040,122
2763,p1410,20131107,6252,6252,0,0,0,6252,6252,0,0,0,0,122
2764,p1410,20131108,6252,6252,6278,6300,6272,6276,6294,24,42,140,8812720,8
2765,p1410,20131111,6276,6294,6308,6308,6308,6308,6308,14,14,2,126160,8
2766,p1410,20131112,6308,6308,6270,6270,6270,6270,6270,-38,-38,2,125400,10
2767,p1410,20131113,6270,6270,0,0,0,6270,6270,0,0,0,0,10
2768,p1410,20131114,6270,6270,0,0,0,6270,6270,0,0,0,0,10
2769,p1410,20131115,6270,6270,0,0,0,6270,6270,0,0,0,0,10
2770,p1410,20131118,6270,6270,0,0,0,6270,6270,0,0,0,0,10
2771,p1410,20131119,6270,6270,0,0,0,6270,6270,0,0,0,0,10
2772,p1410,20131120,6270,6270,0,0,0,6270,6270,0,0,0,0,10
2773,p1410,20131121,6270,6270,0,0,0,6360,6360,90,90,0,0,10
2774,p1410,20131122,6360,6360,6480,6480,6480,6480,6480,120,120,2,129600,8
2775,p1410,20131125,6480,6480,0,0,0,6480,6480,0,0,0,0,8
2776,p1410,20131126,6480,6480,6402,6402,6402,6402,6402,-78,-78,2,128040,8
2777,p1410,20131127,6402,6402,0,0,0,6402,6402,0,0,0,0,8
2778,p1410,20131128,6402,6402,0,0,0,6402,6402,0,0,0,0,8
2779,p1410,20131129,6402,6402,0,0,0,6414,6414,12,12,0,0,8
2780,p1410,20131202,6414,6414,0,0,0,6414,6414,0,0,0,0,8
2781,p1410,20131203,6414,6414,6290,6376,6288,6338,6322,-76,-92,8,505840,8
2782,p1410,20131204,6338,6322,0,0,0,6326,6326,4,4,0,0,8
2783,p1410,20131205,6326,6326,0,0,0,6330,6330,4,4,0,0,8
2784,p1410,20131206,6330,6330,6226,6226,6226,6226,6226,-104,-104,2,124520,8
2785,p1410,20131209,6226,6226,6370,6370,6268,6268,6318,42,92,4,252760,8
2786,p1410,20131210,6268,6318,0,0,0,6318,6318,0,0,0,0,8
2787,p1410,20131211,6318,6318,0,0,0,6324,6324,6,6,0,0,8
2788,p1410,20131212,6324,6324,0,0,0,6324,6324,0,0,0,0,8
2789,p1410,20131213,6324,6324,0,0,0,6170,6170,-154,-154,0,0,8
2790,p1410,20131216,6170,6170,6182,6182,6182,6182,6182,12,12,2,123640,10
2791,p1410,20131217,6182,6182,0,0,0,6182,6182,0,0,0,0,10
2792,p1410,20131218,6182,6182,0,0,0,6144,6144,-38,-38,0,0,10
2793,p1410,20131219,6144,6144,6102,6182,6102,6182,6142,38,-2,4,245680,10
2794,p1410,20131220,6182,6142,6176,6176,6176,6176,6176,34,34,40,2470400,50
2795,p1410,20131223,6176,6176,6106,6178,6068,6178,6108,2,-68,68,4154200,20
2796,p1410,20131224,6178,6108,6166,6166,6166,6166,6166,58,58,2,123320,20
2797,p1410,20131225,6166,6166,6120,6120,6120,6120,6120,-46,-46,2,122400,20
2798,p1410,20131226,6120,6120,0,0,0,6120,6120,0,0,0,0,20
2799,p1410,20131227,6120,6120,6128,6128,6128,6128,6128,8,8,2,122560,20
2800,p1410,20131230,6128,6128,6142,6184,6142,6184,6162,56,34,4,246520,16
2801,p1410,20131231,6184,6162,0,0,0,6116,6116,-46,-46,0,0,16
2802,p1411,20131118,6360,6360,0,0,0,6360,6360,0,0,0,0,0
2803,p1411,20131119,6360,6360,0,0,0,6338,6338,-22,-22,0,0,0
2804,p1411,20131120,6338,6338,6234,6234,6234,6234,6234,-104,-104,2,124680,2
2805,p1411,20131121,6234,6234,0,0,0,6344,6344,110,110,0,0,2
2806,p1411,20131122,6344,6344,0,0,0,6462,6462,118,118,0,0,2
2807,p1411,20131125,6462,6462,6548,6548,6548,6548,6548,86,86,2,130960,0
2808,p1411,20131126,6548,6548,0,0,0,6470,6470,-78,-78,0,0,0
2809,p1411,20131127,6470,6470,0,0,0,6414,6414,-56,-56,0,0,0
2810,p1411,20131128,6414,6414,0,0,0,6438,6438,24,24,0,0,0
2811,p1411,20131129,6438,6438,0,0,0,6450,6450,12,12,0,0,0
2812,p1411,20131202,6450,6450,0,0,0,6424,6424,-26,-26,0,0,0
2813,p1411,20131203,6424,6424,0,0,0,6332,6332,-92,-92,0,0,0
2814,p1411,20131204,6332,6332,0,0,0,6336,6336,4,4,0,0,0
2815,p1411,20131205,6336,6336,0,0,0,6340,6340,4,4,0,0,0
2816,p1411,20131206,6340,6340,0,0,0,6236,6236,-104,-104,0,0,0
2817,p1411,20131209,6236,6236,0,0,0,6328,6328,92,92,0,0,0
2818,p1411,20131210,6328,6328,6358,6358,6288,6288,6322,-40,-6,4,252920,0
2819,p1411,20131211,6288,6322,0,0,0,6322,6322,0,0,0,0,0
2820,p1411,20131212,6322,6322,0,0,0,6322,6322,0,0,0,0,0
2821,p1411,20131213,6322,6322,0,0,0,6206,6206,-116,-116,0,0,0
2822,p1411,20131216,6206,6206,0,0,0,6156,6156,-50,-50,0,0,0
2823,p1411,20131217,6156,6156,0,0,0,6156,6156,0,0,0,0,0
2824,p1411,20131218,6156,6156,0,0,0,6156,6156,0,0,0,0,0
2825,p1411,20131219,6156,6156,0,0,0,6156,6156,0,0,0,0,0
2826,p1411,20131220,6156,6156,0,0,0,6156,6156,0,0,0,0,0
2827,p1411,20131223,6156,6156,0,0,0,6156,6156,0,0,0,0,0
2828,p1411,20131224,6156,6156,0,0,0,6156,6156,0,0,0,0,0
2829,p1411,20131225,6156,6156,0,0,0,6086,6086,-70,-70,0,0,0
2830,p1411,20131226,6086,6086,0,0,0,6078,6078,-8,-8,0,0,0
2831,p1411,20131227,6078,6078,0,0,0,6096,6096,18,18,0,0,0
2832,p1411,20131230,6096,6096,0,0,0,6122,6122,26,26,0,0,0
2833,p1411,20131231,6122,6122,0,0,0,6122,6122,0,0,0,0,0
2834,p1412,20131217,6248,6248,0,0,0,6216,6216,-32,-32,0,0,0
2835,p1412,20131218,6216,6216,0,0,0,6192,6192,-24,-24,0,0,0
2836,p1412,20131219,6192,6192,0,0,0,6190,6190,-2,-2,0,0,0
2837,p1412,20131220,6190,6190,6208,6208,6148,6148,6178,-42,-12,4,247120,0
2838,p1412,20131223,6148,6178,0,0,0,6176,6176,-2,-2,0,0,0
2839,p1412,20131224,6176,6176,6150,6150,6090,6090,6128,-86,-48,8,490360,2
2840,p1412,20131225,6090,6128,0,0,0,6060,6060,-68,-68,0,0,2
2841,p1412,20131226,6060,6060,0,0,0,6060,6060,0,0,0,0,2
2842,p1412,20131227,6060,6060,0,0,0,6140,6140,80,80,0,0,2
2843,p1412,20131230,6140,6140,0,0,0,6166,6166,26,26,0,0,2
2844,p1412,20131231,6166,6166,0,0,0,6166,6166,0,0,0,0,2